Id,Label,timeset,pageranks,modularity_class,indegree,outdegree,Degree,weighted indegree,weighted outdegree,Weighted Degree,Eccentricity,closnesscentrality,harmonicclosnesscentrality,betweenesscentrality,Authority,Hub
8500010,Basel SBB,,0.000011,9,0,13,13,0,179568,179568,28,0.095904,0.132625,0,0,0
8500020,Muttenz,,0.000012,9,1,2,3,43662,43930,87592,30,0.084055,0.105995,0,0,0
8500022,Frenkendorf-Füllinsdorf,,0.000016,9,1,1,2,20739,20603,41342,30,0.083899,0.105156,2740.819048,0,0
8500023,Liestal,,0.00003,9,3,5,8,52469,52786,105255,29,0.091555,0.122041,9347.652381,0,0
8500104,Court,,0.000029,11,1,1,2,10333,10333,20666,31,0.077704,0.093437,7780.25,0,0
8500028,Tecknau,,0.000025,9,2,3,5,19924,19924,39848,29,0.091481,0.121256,336,0,0
8500105,Moutier,,0.000036,9,2,3,5,18562,36924,55486,30,0.084225,0.105574,11188.92619,0,0
8500109,Delémont,,0.000029,9,3,3,6,28867,30874,59741,30,0.08396,0.105532,6410.55,0,0
8500115,Grellingen,,0.00003,9,1,2,3,21351,21029,42380,33,0.067052,0.076965,3440,0,0
8500116,Duggingen,,0.000024,9,1,1,2,20491,20805,41296,33,0.067033,0.076684,0,0,0
8500118,Dornach-Arlesheim,,0.000049,9,1,1,2,21199,20610,41809,31,0.077362,0.092955,13222,0,0
8500026,Sissach,,0.000041,9,2,5,7,41199,50894,92093,29,0.09176,0.122676,6939.791667,0,0
8500027,Gelterkinden,,0.000018,9,1,2,3,29664,29666,59330,29,0.091399,0.12085,0,0,0
8500037,Trimbach,,0.000048,9,1,2,3,9678,9488,19166,29,0.091185,0.120466,16233,0,0
8500090,Basel Bad Bf,,0.000017,9,2,3,5,35579,14212,49791,28,0.095235,0.129171,1854.703175,0,0
8500136,Basel Dreispitz,,0.000043,9,2,1,3,21173,18959,40132,29,0.091159,0.120195,31042.625,0,0
8500207,Solothurn,,0.000067,9,2,14,16,44028,117800,161828,29,0.096434,0.134711,29843.916667,0,0
8500212,Oensingen,,0.00005,9,2,6,8,66116,80056,146172,29,0.09277,0.124505,13386,0,0
8500217,Olten Hammer,,0.000044,9,1,1,2,19263,19053,38316,29,0.091159,0.120195,12976,0,0
8500021,Pratteln,,0.000017,9,2,3,5,43883,43809,87692,31,0.077602,0.094398,11.166667,0,0
8500300,Kaiseraugst,,0.000016,9,1,1,2,22711,22716,45427,31,0.072669,0.086024,0,0,0
8500218,Olten,,0.000149,9,11,15,26,106061,170063,276124,28,0.100272,0.145296,125772.828968,0,0
8500309,Brugg AG,,0.000038,9,2,7,9,64975,93825,158800,28,0.092712,0.126956,9853.22381,0,0
8500320,Stein-Säckingen,,0.000059,9,3,3,6,32719,31488,64207,28,0.090546,0.121744,11100.090476,0,0
8500329,Koblenz,,0.000011,9,0,5,5,0,40790,40790,28,0.091245,0.124661,0,0,0
8501120,Lausanne,,0.000198,4,7,14,21,119396,135509,254905,28,0.097345,0.136681,171283.691655,0,0
8501609,Brig,,0.00005,4,2,7,9,50350,22374,72724,28,0.093866,0.129874,122986.867216,0,0
8502113,Aarau,,0.000138,9,11,6,17,123173,170630,293803,28,0.091805,0.125125,55857.51158,0,0
8502115,Wildegg,,0.000043,9,2,3,5,28627,28358,56985,28,0.090549,0.121806,1355.98355,0,0
8502119,Lenzburg,,0.000118,9,5,6,11,88445,100333,188778,28,0.092126,0.127913,40065.51645,0,0
8502204,Zug,,0.000042,9,2,6,8,45804,127486,173290,28,0.091326,0.124819,14498.966667,0,0
8502206,Baar,,0.000017,9,1,4,5,64658,64691,129349,28,0.09061,0.122334,338.166667,0,0
8502208,Horgen Oberdorf,,0.000014,9,1,2,3,19620,19620,39240,28,0.090515,0.121418,168,0,0
8502209,Oberrieden Dorf,,0.000017,9,1,1,2,19369,19369,38738,28,0.090485,0.121092,0,0,0
8502215,Muri AG,,0.000065,9,2,4,6,33514,31269,64783,28,0.090659,0.12249,22264.8,0,0
8502229,Urdorf Weihermatt,,0.000065,9,2,1,3,35459,35459,70918,28,0.090485,0.121092,21544,0,0
8500024,Lausen,,0.000016,9,1,1,2,20387,20411,40798,31,0.077573,0.093545,0,0,0
8500025,Itingen,,0.00003,9,2,1,3,20700,20702,41402,30,0.084071,0.105584,3296,0,0
8501037,Morges,,0.000103,4,7,7,14,63892,80851,144743,29,0.090927,0.119345,43045.929737,0,0
8502001,Zofingen,,0.000038,9,3,5,8,47068,63876,110944,29,0.085924,0.113375,5825.183333,0,0
8502010,St. Erhard-Knutwil,,0.000029,9,2,2,4,10390,7292,17682,29,0.084397,0.107684,7231.3,0,0
8502103,Suhr,,0.000039,9,1,2,3,16894,51361,68255,29,0.084141,0.107199,8451,0,0
8502105,Othmarsingen,,0.000022,9,2,5,7,18535,33791,52326,29,0.084329,0.108653,1414.416667,0,0
8502106,Mägenwil,,0.000015,9,1,2,3,13520,15274,28794,29,0.084221,0.107549,0,0,0
8502112,Schönenwerd SO,,0.000043,9,1,1,2,19525,19565,39090,29,0.084114,0.106877,5552,0,0
8500031,Diepflingen,,0.000018,9,1,1,2,10182,10182,20364,34,0.062709,0.070582,48,0,0
8500032,Sommerau,,0.000026,9,1,1,2,10182,10182,20364,33,0.066884,0.076504,3289,0,0
8500033,Rümlingen,,0.000033,9,1,1,2,10182,10182,20364,32,0.071655,0.083686,6528,0,0
8500034,Buckten,,0.000039,9,1,1,2,10182,10182,20364,31,0.077163,0.092648,9765,0,0
8500035,Läufelfingen,,0.000044,9,1,1,2,10182,9678,19860,30,0.083589,0.104293,13000,0,0
8500062,Bottmingen Schloss,,0.000011,2,0,2,2,0,8198,8198,14,0.175268,0.214614,0,0,0
8500254,Wiesenplatz,,0.000022,2,3,7,10,8534,10033,18567,14,0.182058,0.236644,277.82105,0,0
8500897,Barfüsserplatz,,0.000033,2,5,4,9,62898,62897,125795,13,0.186819,0.23348,505.182842,0,0
8500898,Claraplatz,,0.000025,2,3,14,17,48605,62029,110634,13,0.202847,0.27191,691.345077,0,0
8578143,Bahnhof SBB,,0.000062,2,10,17,27,62618,81873,144491,16,0.18538,0.273684,3355.310609,0,0
8500065,"Ettingen, Bahnhof",,0.000011,54,0,1,1,0,7067,7067,44,0.04991,0.095805,0,0,0
8500068,Flüh Bahnhof,,0.00002,54,1,4,5,7067,13731,20798,43,0.052218,0.115581,166,0,0
8500070,Rodersdorf Station,,0.000015,54,1,2,3,570,2097,2667,43,0.050373,0.097397,4.133333,0,0
8500679,"Mariastein, Klosterplatz",,0.000022,54,2,2,4,6320,5665,11985,42,0.052614,0.105043,358.766667,0,0
8500073,Aeschenplatz,,0.000011,2,0,7,7,0,72668,72668,13,0.175285,0.213697,0,0,0
8500079,Heuwaage,,0.000012,2,1,4,5,612,22531,23143,14,0.162236,0.198611,8.282924,0,0
8500146,Bahnhofeing. Gundeld.,,0.000015,2,2,1,3,11135,17276,28411,16,0.124603,0.141829,6,0,0
8500160,IWB,,0.000021,2,1,2,3,17277,29101,46378,15,0.153008,0.185372,170.246038,0,0
8500189,Solothurnerstrasse,,0.000016,2,1,2,3,17277,17277,34554,15,0.157537,0.193274,3.488095,0,0
8500161,Tellplatz,,0.000031,2,2,5,7,28309,28309,56618,14,0.163322,0.204066,588.329516,0,0
8500193,Markthalle,,0.000028,2,3,6,9,35657,48353,84010,14,0.178498,0.230163,856.567167,0,0
8500236,Denkmal,,0.000017,2,2,3,5,10915,10907,21822,14,0.161395,0.197602,52.660512,0,0
8500237,Bankverein,,0.000029,2,5,5,10,62285,62575,124860,13,0.174395,0.217475,778.915159,0,0
8500256,Muttenz Dorf,,0.000019,2,2,2,4,12056,12067,24123,13,0.170974,0.20426,13.861111,0,0
8503000,Zürich HB,,0.000213,9,17,19,36,240105,445066,685171,27,0.09945,0.148232,350492.727392,0,0
8503400,Bülach,,0.000051,9,4,4,8,49352,65499,114851,29,0.084131,0.109848,11532.835714,0,0
8503423,Neuhausen,,0.000078,9,3,1,4,36707,47459,84166,30,0.079107,0.097435,10382.75,0,0
8500096,Dreispitz,,0.000011,2,0,2,2,0,11468,11468,17,0.148635,0.186991,0,0,0
8519559,Depot Allschwilerstrasse,,0.00003,2,3,7,10,698,1325,2023,16,0.176863,0.24163,1683.00214,0,0
8500994,Theater,,0.000044,2,6,11,17,22583,22614,45197,12,0.197661,0.258168,2490.960514,0,0
8578145,Im Wasenboden,,0.000016,2,1,2,3,27352,27354,54706,17,0.147302,0.183691,49.5,0,0
8500100,Tavannes,,0.000011,11,0,2,2,0,28664,28664,35,0.064223,0.074186,0,0,0
8500101,Reconvilier,,0.000016,11,1,1,2,14686,14686,29372,34,0.068332,0.079742,3302,0,0
8500102,Malleray-Bévilard,,0.000024,11,1,2,3,14686,14686,29372,33,0.073322,0.088045,6618,0,0
8500103,Sorvilier,,0.000021,11,1,1,2,10333,10333,20666,32,0.072121,0.084277,4468.25,0,0
8500205,Bellach,,0.000037,9,1,1,2,19166,19166,38332,31,0.080885,0.099242,6545,0,0
8500119,Münchenstein,,0.000053,9,2,2,4,20636,20610,41246,30,0.083823,0.104795,16496,0,0
8500113,Laufen,,0.000027,9,3,2,5,30205,30105,60310,30,0.083652,0.104761,140,0,0
8500126,Porrentruy,,0.000044,9,1,4,5,19978,32980,52958,29,0.086471,0.11065,18797,0,0
8500144,Buix,,0.000048,9,2,1,3,9823,7984,17807,30,0.083532,0.104368,12900,0,0
8500114,Zwingen,,0.000022,9,1,1,2,21621,21351,42972,34,0.062857,0.070861,176,0,0
8500117,Aesch BL,,0.000044,9,3,1,4,21484,21199,42683,32,0.071827,0.083913,9964,0,0
8500120,Courtételle,,0.000042,9,2,1,3,19438,19701,39139,35,0.058048,0.064566,734,0,0
8500121,Courfaivre,,0.000046,9,1,1,2,19701,19942,39643,34,0.061607,0.069403,3986,0,0
8500122,Bassecourt,,0.00005,9,1,1,2,19942,19986,39928,33,0.065631,0.075154,7236,0,0
8500123,Glovelier,,0.000054,9,1,2,3,19986,27977,47963,32,0.07022,0.082215,10484,0,0
8500124,St-Ursanne,,0.000034,9,1,1,2,19978,19978,39956,31,0.073762,0.087095,12345,0,0
8500125,Courgenay,,0.00004,9,1,1,2,19978,19978,39956,30,0.079612,0.097097,15572,0,0
8500127,Courtemaîche,,0.00002,9,1,1,2,9881,9881,19762,33,0.066864,0.076503,124,0,0
8500128,Boncourt,,0.000028,9,1,1,2,9881,9838,19719,32,0.071633,0.083743,3321,0,0
8500135,Pontenet,,0.000031,11,2,2,4,14686,14686,29372,29,0.086462,0.108118,6877.209524,0,0
8500159,Grenchen Nord,,0.000081,11,4,3,7,17480,17499,34979,29,0.091117,0.120942,38683.925,0,0
8503016,Zürich Flughafen,,0.000041,9,4,12,16,112550,112306,224856,28,0.092121,0.130556,16503.700938,0,0
8504221,Neuchâtel,,0.000146,11,4,7,11,52924,126891,179815,29,0.086808,0.109262,248522.969064,0,0
8504229,Tüscherz,,0.000059,11,1,1,2,13600,13600,27200,29,0.085442,0.105884,13188,0,0
8504300,Biel/Bienne,,0.000139,11,8,8,16,71933,113797,185730,28,0.093375,0.123674,118805.14435,0,0
8504303,La Heutte,,0.000051,11,1,1,2,10180,10180,20360,33,0.063419,0.073721,3320,0,0
8500141,Courchavon,,0.000035,9,1,2,3,9838,9867,19705,31,0.077136,0.092892,6516,0,0
8500143,Grandgourt,,0.000026,9,1,1,2,3097,3053,6150,31,0.077114,0.092611,0,0,0
8500147,Heiliggeistkirche,,0.000025,2,2,2,4,28151,28309,56460,15,0.141935,0.168055,360.333333,0,0
8501007,Vernier,,0.000049,4,2,1,3,20529,20560,41089,30,0.082226,0.102308,16120,0,0
8501008,Genève,,0.000084,4,3,9,12,28903,105194,134097,29,0.089565,0.118673,21961,0,0
8501026,Genève-Aéroport,,0.000025,4,2,3,5,43905,42759,86664,29,0.089332,0.116597,9921.75581,0,0
8501103,Vallorbe,,0.000016,4,1,5,6,6872,21356,28228,29,0.08908,0.116437,3179.5,0,0
8501118,Renens VD,,0.000147,4,5,1,6,70936,71758,142694,29,0.088735,0.114496,66183.554902,0,0
8500899,Messeplatz,,0.00002,2,3,10,13,49209,51214,100423,13,0.190236,0.248693,246.184827,0,0
8519560,Depot Dreispitz,,0.000021,2,3,4,7,328,328,656,17,0.161094,0.218827,333.649512,0,0
8519562,Depot Wiesenplatz,,0.000039,2,6,7,13,2264,2264,4528,17,0.170692,0.239041,1530.739585,0,0
8500162,Tramelan-Dessous,,0.000016,11,1,2,3,13978,13978,27956,37,0.050866,0.057212,23,0,0
8500167,Les Breuleux-Eglise,,0.000033,11,1,2,3,9516,10493,20009,34,0.059892,0.069301,4184.5,0,0
8500164,Tramelan-Chalet,,0.000017,11,1,1,2,9199,9516,18715,36,0.053545,0.060031,846.5,0,0
8500165,Le Pied-d'Or,,0.000026,11,1,1,2,9516,9516,19032,35,0.05654,0.064188,2516.5,0,0
8500172,La Chaux-des-Breuleux,,0.000043,11,1,1,2,9516,9516,19032,34,0.059798,0.068327,4178.5,0,0
8500169,Muriaux,,0.000034,11,1,1,2,7999,13925,21924,33,0.063563,0.073939,1357,0,0
8500173,Les Breuleux,,0.000061,11,2,1,3,10507,10479,20986,33,0.063563,0.073939,11685,0,0
8500170,Tramelan,,0.000031,11,2,1,3,14281,9446,23727,36,0.053469,0.05967,852.5,0,0
8500171,Les Reussilles,,0.000038,11,1,1,2,9446,9516,18962,35,0.056456,0.063654,2516.5,0,0
8500174,Le Noirmont,,0.000092,11,2,2,4,24404,14369,38773,32,0.067837,0.081,16339,0,0
8500177,Les Bois,,0.000056,11,1,2,3,11296,11296,22592,32,0.067772,0.08094,3516,0,0
8500184,La Chaux-de-Fonds-Est,,0.000058,11,2,2,4,10958,10986,21944,30,0.078123,0.099104,6632,0,0
8500175,Le Creux-des-Biches,,0.00005,11,1,1,2,11200,11296,22496,34,0.059748,0.068267,266,0,0
8500176,Le Boéchet,,0.000053,11,1,1,2,11296,11296,22592,33,0.063507,0.073876,1892,0,0
8500178,La Ferrière,,0.000035,11,1,1,2,10930,10930,21860,32,0.067707,0.080178,164,0,0
8500179,La Cibourg,,0.00004,11,1,2,3,10930,10928,21858,31,0.07258,0.088826,1784,0,0
8500181,La Chaux-d'Abel,,0.000035,11,1,1,2,10930,10930,21860,31,0.072502,0.088029,1659,0,0
8500180,La Large-Journée,,0.000028,11,1,1,2,10900,10930,21830,32,0.067639,0.079773,43,0,0
8500191,Saignelégier,,0.000094,11,1,2,3,13925,11139,25064,30,0.078076,0.099037,24274,0,0
8500199,Combe-Tabeillon,,0.000061,11,1,1,2,7999,7249,15248,30,0.077896,0.097954,6604,0,0
8504237,Les Hauts-Geneveys,,0.000062,11,1,2,3,28488,27698,56186,30,0.082046,0.102017,157847.256519,0,0
8504250,"Les Hauts-Geneveys, gare",,0.000037,48,1,3,4,627,17321,17948,30,0.084036,0.109809,134241.25977,0,0
8504310,St-Imier,,0.000093,11,2,2,4,17852,17602,35454,30,0.077979,0.098743,53504.580386,0,0
8504312,Renan BE,,0.000054,11,1,1,2,10335,10335,20670,30,0.077896,0.097954,1651,0,0
8500186,Alle,,0.00002,9,1,1,2,13067,11472,24539,2,0.666667,0.75,62,0,0
8500187,Vendlincourt,,0.000028,9,1,1,2,11472,8033,19505,1,1,1,32,0,0
8500190,Les Emibois,,0.000098,11,3,1,4,13965,13925,27890,31,0.072463,0.087974,22664,0,0
8500192,Le Bémont JU,,0.000051,11,1,1,2,7998,7999,15997,34,0.059513,0.067535,192,0,0
8517417,Lachmatt,,0.000043,2,1,3,4,12067,12067,24134,17,0.157869,0.20565,2488,0,0
8500682,EuroAirport,,0.000011,2,0,1,1,0,16810,16810,17,0.156805,0.201045,0,0,0
8507228,Wänglismatten,,0.000011,2,0,1,1,0,6227,6227,17,0.156805,0.201045,0,0,0
8507520,Grosspeteranlage,,0.000011,2,0,1,1,0,2005,2005,17,0.156805,0.201045,0,0,0
8500194,Pré-Petitjean,,0.000054,11,1,1,2,7999,7999,15998,33,0.063241,0.07286,1798,0,0
8500195,La Combe,,0.000057,11,1,1,2,7999,7999,15998,32,0.067469,0.079307,3402,0,0
8500196,Bollement,,0.000059,11,1,1,2,7999,7999,15998,31,0.072307,0.087362,5004,0,0
8500200,Pieterlen,,0.000011,9,0,1,1,0,19169,19169,32,0.074914,0.088985,0,0,0
8500201,Lengnau BE,,0.00002,9,1,1,2,19169,19169,38338,31,0.080956,0.099513,3275,0,0
8500202,Grenchen Süd,,0.000028,9,1,2,3,19169,30166,49335,30,0.08806,0.113845,6548,0,0
8500206,Solothurn West,,0.000052,9,2,1,3,28258,33028,61286,30,0.087977,0.113347,16777.916667,0,0
8500203,Bettlach,,0.000023,9,1,1,2,19166,19166,38332,33,0.069661,0.080633,9,0,0
8500204,Selzach,,0.00003,9,1,1,2,19166,19166,38332,32,0.074854,0.088804,3278,0,0
8500210,Wangen an der Aare,,0.000031,9,1,1,2,19108,19094,38202,31,0.078294,0.094492,6530,0,0
8500211,Niederbipp,,0.000041,9,2,1,3,37434,55775,93209,30,0.084918,0.106834,9792,0,0
8500260,Crémines-Zoo,,0.000015,9,1,1,2,8944,9092,18036,8,0.222222,0.339732,0,0,0
8503225,Ziegelbrücke,,0.000092,9,5,6,11,57890,33363,91253,27,0.101331,0.136751,43347.05,0,0
8503508,Dietikon,,0.000138,9,10,5,15,99433,76183,175616,27,0.094697,0.125155,49095.585534,0,0
8503001,Zürich Altstetten,,0.00002,9,1,7,8,111070,110408,221478,29,0.089841,0.127118,2049.99697,0,0
8503504,Baden,,0.000139,9,5,5,10,106882,93703,200585,27,0.09689,0.129271,57127.00653,0,0
8504100,Fribourg/Freiburg,,0.000218,11,7,9,16,51517,84331,135848,28,0.089462,0.125752,192869.528752,0,0
8504101,Düdingen,,0.000031,11,1,4,5,31713,25246,56959,27,0.09272,0.123381,314,0,0
8504103,Flamatt,,0.000046,11,3,4,7,18144,38605,56749,27,0.092655,0.123296,4553,0,0
8504115,Thörishaus Dorf,,0.000058,11,2,2,4,36505,37583,74088,27,0.092356,0.121476,7307,0,0
8504117,Oberwangen,,0.000035,11,1,2,3,19777,19776,39553,27,0.092315,0.121384,18,0,0
8504194,Laupen BE,,0.000046,11,1,1,2,18065,18036,36101,27,0.092153,0.12033,2788,0,0
8504410,Zollikofen,,0.000066,11,4,4,8,22101,79511,101612,27,0.095703,0.128562,39705.66695,0,0
8504411,Münchenbuchsee,,0.000025,11,1,2,3,34195,33581,67776,27,0.092541,0.122105,1564,0,0
8504414,Lyss,,0.000113,11,5,4,9,61181,60047,121228,27,0.092435,0.12264,25807.738681,0,0
8504441,Studen BE,,0.000045,11,1,1,2,18960,18350,37310,27,0.092153,0.12033,2788,0,0
8504483,Ins,,0.000198,11,7,2,9,53918,22390,76308,27,0.0925,0.121989,87809.024584,0,0
8504486,Gümmenen,,0.000079,11,2,2,4,19405,19375,38780,27,0.092416,0.121806,52786.224792,0,0
8504489,Bern Bümpliz Nord,,0.000055,11,2,3,5,19122,34719,53841,27,0.092273,0.121591,2957.141667,0,0
8504495,Bern Stöckacker,,0.000083,11,2,1,3,27190,26715,53905,27,0.092153,0.12033,1394,0,0
8505000,Luzern,,0.000193,9,14,17,31,103179,167427,270606,27,0.096673,0.145202,111472.219048,0,0
8506121,Romanshorn,,0.000074,18,2,8,10,55825,81795,137620,27,0.095524,0.132593,40527.357143,0,0
8506302,St. Gallen,,0.000389,18,12,7,19,144946,123402,268348,27,0.09361,0.128196,225557.261905,0,0
8507000,Bern,,0.000574,11,25,18,43,277624,347277,624901,26,0.101435,0.146903,818867.861017,0,0
8507006,Münsingen,,0.000061,11,3,2,5,27085,27069,54154,26,0.082246,0.116019,3373,0,0
8507009,Uttigen,,0.000047,11,1,1,2,19065,19065,38130,26,0.081894,0.113472,1166,0,0
8507094,Uetendorf Allmend,,0.000073,11,2,1,3,19352,19352,38704,26,0.081894,0.113472,7567,0,0
8503221,Siebnen-Wangen,,0.000048,9,2,3,5,33578,39075,72653,28,0.09265,0.118549,5336.2,0,0
8507100,Thun,,0.000169,11,5,7,12,80472,93441,173913,25,0.089045,0.137891,29777.744794,0,0
8508003,Hindelbank,,0.000094,11,2,3,5,19794,19770,39564,25,0.085805,0.121807,1788,0,0
8508004,Lyssach,,0.000037,11,1,1,2,19471,19555,39026,25,0.085632,0.11893,0,0,0
8508064,Bätterkinden,,0.000088,11,3,1,4,19361,20128,39489,4,0.4,0.520833,1492,0,0
8508005,Burgdorf,,0.000149,11,7,7,14,58156,69311,127467,24,0.093478,0.145989,228927.74881,0,0
8508084,Kirchberg-Alchenflüh,,0.000042,11,1,1,2,14598,17870,32468,12,0.149068,0.188892,58,0,0
8500208,Luterbach-Attisholz,,0.000015,9,1,1,2,19253,19107,38360,33,0.067731,0.077658,30,0,0
8500209,Deitingen,,0.000024,9,1,1,2,19107,19108,38215,32,0.072629,0.085116,3281,0,0
8500286,Attiswil,,0.000056,9,1,1,2,18590,18590,37180,4,0.4,0.520833,28,0,0
8502000,Aarburg-Oftringen,,0.000024,9,2,3,5,36611,36567,73178,30,0.081663,0.104722,895.466667,0,0
8508008,Herzogenbuchsee,,0.000054,11,2,1,3,18639,18601,37240,25,0.082263,0.113046,13757.5,0,0
8500213,Oberbuchsiten,,0.000018,9,1,1,2,19261,19263,38524,33,0.06687,0.076466,80,0,0
8500214,Egerkingen,,0.000026,9,1,1,2,19263,19263,38526,32,0.07164,0.083635,3307,0,0
8500215,Hägendorf,,0.000033,9,1,1,2,19263,18836,38099,31,0.077144,0.092574,6532,0,0
8500216,Wangen bei Olten,,0.000039,9,1,1,2,18836,19263,38099,30,0.083567,0.104171,9755,0,0
8500305,Frick,,0.000043,9,3,2,5,29346,29361,58707,29,0.084875,0.108282,6531.257143,0,0
8501030,Nyon,,0.000059,4,4,3,7,37632,62600,100232,30,0.08377,0.10492,19820.151527,0,0
8501031,Gland,,0.000042,4,3,3,6,21123,20389,41512,30,0.083442,0.103743,313.146332,0,0
8501035,Allaman,,0.000039,4,3,2,5,20076,38206,58282,30,0.083396,0.103338,626.39143,0,0
8501036,St-Prex,,0.000027,4,1,1,2,18427,18427,36854,30,0.083373,0.103057,0,0,0
8501506,Sion,,0.000072,4,3,6,9,38871,38685,77556,29,0.086624,0.113581,95639.867216,0,0
8501509,Sierre/Siders,,0.000039,4,2,4,6,35851,35459,71310,30,0.079645,0.099172,3182,0,0
8501601,Leuk,,0.000059,4,3,2,5,27169,27146,54315,30,0.079574,0.098474,6060,0,0
8501604,Raron,,0.000046,4,1,1,2,17673,17673,35346,30,0.079502,0.097924,5592,0,0
8502007,Sursee,,0.000058,9,2,6,8,38669,57791,96460,29,0.086836,0.117706,18939.55,0,0
8502021,Emmenbrücke,,0.000075,9,3,3,6,50160,50153,100313,31,0.081965,0.109113,17401,0,0
8502028,Emmenbrücke Gersag,,0.000076,9,3,4,7,39102,39135,78237,30,0.08425,0.112622,17202,0,0
8502042,Hochdorf Schönau,,0.000069,9,4,2,6,20063,20382,40445,29,0.087902,0.117969,21053.22619,0,0
8502230,Zug Chollermüli,,0.00002,9,2,3,5,35085,35085,70170,28,0.08825,0.119768,544.190476,0,0
8502306,Hünenberg Chämleten,,0.000017,9,1,2,3,17041,17041,34082,28,0.088205,0.119274,0,0,0
8503010,Zürich Enge,,0.000042,9,3,3,6,57293,57293,114586,29,0.086108,0.117308,3692.496825,0,0
8503202,Thalwil,,0.00007,9,5,8,13,74916,73510,148426,28,0.093137,0.131589,12182.435714,0,0
8503284,Biberbrugg,,0.000075,9,3,6,9,55027,54245,109272,28,0.089527,0.125479,14309.561111,0,0
8504023,Romont FR,,0.000055,11,2,5,7,13109,42730,55839,29,0.083063,0.111488,25693,0,0
8500220,Dotzigen,,0.000011,11,0,1,1,0,12352,12352,29,0.078111,0.093589,0,0,0
8500221,Büren an der Aare,,0.00002,11,1,1,2,12352,12352,24704,28,0.084669,0.105437,1400,0,0
8504404,Aarberg,,0.000052,11,1,1,2,9553,9553,19106,28,0.084669,0.105437,4476,0,0
8504412,Schüpfen,,0.000022,11,1,2,3,21746,21920,43666,28,0.084724,0.106076,1095,0,0
8504413,Suberg-Grossaffoltern,,0.00002,11,1,1,2,18975,18977,37952,28,0.084669,0.105437,0,0,0
8588063,Jakobsberg,,0.000047,2,9,7,16,17088,17088,34176,10,0.213457,0.262198,689.387806,0,0
8588768,Dreirosenbrücke,,0.000152,2,6,6,12,40710,40642,81352,10,0.219902,0.273732,5173.286639,0,0
8588769,Feldbergstrasse,,0.000046,2,2,3,5,30985,30967,61952,11,0.179255,0.213278,129.688095,0,0
8500984,Arisdorf Olsbergerstrasse,,0.000024,2,2,2,4,11330,12252,23582,13,0.184804,0.224529,823.67062,0,0
8500238,"Bulle, Verdel",,0.000011,13,0,1,1,0,27601,27601,21,0.130955,0.153939,0,0,0
8504863,"Marsens, village",,0.000076,126,4,4,8,19258,19258,38516,34,0.084276,0.123904,13336.573821,0,0
8504872,"Riaz, poste",,0.000021,126,2,4,6,16891,16891,33782,34,0.083728,0.121937,275.677597,0,0
8504873,"La Roche FR, village",,0.000021,126,2,4,6,12690,16545,29235,33,0.09005,0.13801,1185.24826,0,0
8504881,"Fribourg/Freiburg, gare routière",,0.000192,126,12,28,40,134124,192879,327003,32,0.098377,0.172509,110071.626017,0,0
8504898,"Grangettes, village",,0.000034,126,1,1,2,5896,5896,11792,21,0.130955,0.153939,591,0,0
8504908,"Gumefens, Lac",,0.000047,126,1,2,3,12744,12744,25488,21,0.13628,0.162219,652.333333,0,0
8504909,"Magnedens, bif. Fribourg",,0.000045,126,2,2,4,9788,9788,19576,21,0.142136,0.173078,527.166667,0,0
8504911,"Villarvolard, village",,0.000033,126,1,3,4,7191,7191,14382,18,0.134786,0.162535,2303.348485,0,0
8578152,Kronenplatz,,0.00002,2,3,4,7,20013,20022,40035,9,0.222222,0.261778,351.988253,0,0
8578352,Schlossstrasse,,0.000072,2,4,5,9,26174,26175,52349,11,0.199433,0.24584,8878.513643,0,0
8581062,Brausebad,,0.000095,2,10,9,19,40380,40382,80762,10,0.23236,0.297235,8573.555866,0,0
8588071,Peter Merian,,0.00002,2,2,2,4,168,168,336,10,0.199559,0.227127,0,0,0
8588766,Bläsiring,,0.000072,2,9,2,11,13251,13246,26497,11,0.18191,0.213006,271.800036,0,0
8500255,"Aesch BL, Dorf",,0.000015,54,1,1,2,7254,7146,14400,13,0.163793,0.245446,17.8,0,0
8500697,"Hofstetten SO, Mariasteinstr.",,0.000015,54,1,1,2,113,103,216,13,0.163793,0.245446,17.8,0,0
8500261,Langendorf,,0.000036,9,3,1,4,14043,11073,25116,7,0.25,0.370408,413,0,0
8500262,Lommiswil,,0.000042,9,1,1,2,11073,9594,20667,6,0.285714,0.408333,360,0,0
8500263,Im Holz,,0.000046,9,1,1,2,9594,9594,19188,5,0.333333,0.456667,305,0,0
8500264,Oberdorf SO,,0.00005,9,1,1,2,9594,9594,19188,4,0.4,0.520833,248,0,0
8500265,Gänsbrunnen,,0.000054,9,1,1,2,9594,9092,18686,3,0.5,0.611111,189,0,0
8500266,Corcelles BE,,0.000056,9,1,1,2,9092,9092,18184,2,0.666667,0.75,128,0,0
8500267,Crémines,,0.000059,9,1,1,2,9092,9092,18184,1,1,1,65,0,0
8500272,Solothurn Sternen,,0.000022,9,2,1,3,18591,18590,37181,11,0.166667,0.274534,140,0,0
8500273,St. Katharinen,,0.00003,9,1,1,2,18590,18590,37180,10,0.181818,0.292897,130,0,0
8500274,Feldbrunnen,,0.000036,9,1,1,2,18590,18590,37180,9,0.2,0.31433,118,0,0
8500275,Bei den Weihern,,0.000042,9,1,1,2,18590,18590,37180,8,0.222222,0.339732,104,0,0
8500280,Solothurn Baseltor,,0.000046,9,1,1,2,18590,18590,37180,7,0.25,0.370408,88,0,0
8500283,Riedholz,,0.00005,9,1,1,2,18590,18590,37180,6,0.285714,0.408333,70,0,0
8500285,Flumenthal,,0.000054,9,1,1,2,18590,18590,37180,5,0.333333,0.456667,50,0,0
8500287,Wiedlisbach,,0.000066,9,2,1,3,19341,19090,38431,3,0.5,0.611111,84,0,0
8500288,Oberbipp,,0.000067,9,1,1,2,19090,19092,38182,2,0.666667,0.75,58,0,0
8500289,Buchli,,0.000068,9,1,1,2,19092,19092,38184,1,1,1,30,0,0
8508193,Aarwangen Vorstadt,,0.000064,9,2,1,3,18450,17705,36155,1,1,1,749,0,0
8500292,Klus,,0.000018,9,1,1,2,13729,13729,27458,2,0.666667,0.75,40,0,0
8500293,Thalbrücke,,0.000026,9,1,1,2,13729,13729,27458,1,1,1,21,0,0
8500301,Rheinfelden,,0.00003,9,3,2,5,40370,40358,80728,30,0.078336,0.095987,3432.514286,0,0
8500302,Möhlin,,0.000023,9,1,4,5,23075,23075,46150,29,0.084497,0.107511,2942.257143,0,0
8500304,Eiken,,0.000018,9,1,1,2,11704,11704,23408,30,0.07826,0.095329,171.5,0,0
8500303,Mumpf,,0.000016,9,1,2,3,21226,21226,42452,30,0.077897,0.094572,6,0,0
8500313,Rheinfelden Augarten,,0.000046,9,4,1,5,22215,22215,44430,29,0.083056,0.104737,2684.5,0,0
8500322,Laufenburg,,0.000028,9,1,1,2,9737,9492,19229,1,1,1,0,0,0
8503006,Zürich Oerlikon,,0.00003,9,4,12,16,228327,228337,456664,29,0.085857,0.119386,13426.996898,0,0
8503312,Oberglatt ZH,,0.000052,9,2,3,5,41075,41826,82901,30,0.077895,0.09754,6616.685714,0,0
8503313,Niederglatt ZH,,0.000026,9,1,1,2,19097,19097,38194,30,0.077646,0.095858,0,0,0
8503405,Zweidlen,,0.000028,9,1,1,2,17949,17955,35904,35,0.054855,0.060093,2233,0,0
8503408,Rekingen AG,,0.000037,9,2,1,3,18707,18706,37413,34,0.058004,0.064025,3543,0,0
8503306,Dietlikon,,0.000075,9,2,5,7,53680,34537,88217,28,0.090964,0.121569,16656.506349,0,0
8503411,Koblenz Dorf,,0.000052,9,1,2,3,28612,28110,56722,31,0.070085,0.080779,7464,0,0
8500380,"Gunzgen, Zentrum",,0.000011,94,0,2,2,0,33492,33492,23,0.112894,0.138985,0,0,0
8500381,"Hägendorf, Bodenmatt",,0.000016,94,1,1,2,19066,19066,38132,23,0.112403,0.134743,0,0,0
8500382,"Härkingen, Pflug",,0.000029,94,2,1,3,33492,33492,66984,22,0.126014,0.156524,404,0,0
8500383,"Kappel SO, Kreuz",,0.000035,94,1,4,5,33492,47879,81371,21,0.143469,0.19306,603,0,0
8577907,"Hägendorf, Teufelsschlucht",,0.000033,94,1,2,3,5555,5555,11110,22,0.120198,0.167801,477,0,0
8572352,"Olten, Bahnhof",,0.000113,94,9,12,21,145834,172233,318067,22,0.158067,0.259369,6962.3,0,0
8577908,"Hägendorf, Bahnhof",,0.000032,94,2,4,6,18332,19790,38122,21,0.13278,0.195207,499,0,0
8577994,"Lostorf, Dorfplatz",,0.000018,94,1,4,5,22577,27258,49835,19,0.166129,0.242647,544.638095,0,0
8578000,"Stüsslingen, Jura",,0.000045,94,2,4,6,16764,13276,30040,21,0.141227,0.215538,466.047619,0,0
8578002,Rohr b. Olten,,0.000036,94,2,3,5,8324,5852,14176,21,0.138968,0.204518,204.047619,0,0
8578003,"Stüsslingen, Burengasse",,0.000031,94,2,2,4,1908,4108,6016,21,0.137733,0.196232,0,0,0
8578023,"Härkingen, Lamm",,0.000033,94,1,1,2,19066,19066,38132,21,0.130081,0.17177,408,0,0
8500385,"Neuendorf, Kirche",,0.000018,94,1,1,2,19066,19559,38625,22,0.13442,0.161815,226,0,0
8500386,"Niederbuchsiten, Sonne",,0.000027,94,1,2,3,19559,19559,39118,21,0.15451,0.196743,419,0,0
8500387,"Rickenbach SO, Dorf",,0.000022,94,1,4,5,19066,33973,53039,20,0.172383,0.233998,242.666667,0,0
8500986,"Wolfwil, Zentrum",,0.000029,94,2,2,4,7489,7404,14893,21,0.144224,0.183873,392,0,0
8500992,"Fulenbach, Oberdorf",,0.000023,94,1,4,5,7195,7360,14555,20,0.160891,0.219661,219,0,0
8500598,"Olten, Postplatz",,0.000011,94,0,3,3,0,86472,86472,62,0.04542,0.090336,0,0,0
8502605,"Olten, Fustligweg",,0.000037,94,1,1,2,15493,15493,30986,23,0.137102,0.19095,582,0,0
8502614,"Wangen b. Olten, Danzmatt",,0.000018,94,1,1,2,13933,14677,28610,23,0.137102,0.19095,385.133333,0,0
8502712,"Oftringen, Kreuzplatz",,0.000082,94,4,6,10,63292,63341,126633,59,0.049535,0.105124,11880.666667,0,0
8504345,"Wisen SO, Adliken",,0.00002,94,1,1,2,5705,5705,11410,23,0.137102,0.19095,194,0,0
8508862,"Kestenholz, Dörfli",,0.000044,94,4,5,9,25742,25840,51582,20,0.16681,0.229573,822.833333,0,0
8510229,"Schönenwerd SO, Bahnhof Nord",,0.000016,94,1,2,3,7205,7971,15176,23,0.147753,0.213886,135.333333,0,0
8577990,"Obergösgen, Dorf",,0.000063,94,3,5,8,56648,59556,116204,20,0.137184,0.204565,1466.666667,0,0
8578016,"Obergösgen, Bollenfeld",,0.000053,94,1,2,3,16837,16837,33674,20,0.095188,0.149486,469.333333,0,0
8578024,"Gunzgen, Unterdorf",,0.000098,94,8,3,11,45702,47878,93580,20,0.147975,0.213644,2218.783333,0,0
8500388,"Wisen SO, Kirche",,0.000011,94,0,1,1,0,5705,5705,24,0.121118,0.156967,0,0,0
8500480,"Röthenbach b. H., Post",,0.000011,88,0,3,3,0,12189,12189,13,0.158759,0.213904,0,0,0
8508172,"Melchnau, Gjuch",,0.000014,88,1,2,3,3734,15959,19693,13,0.159259,0.202363,42,0,0
8508961,"Bützberg, Wyssenried",,0.000028,88,1,2,3,21249,21249,42498,12,0.169697,0.226093,148.166667,0,0
8576898,"Wangen a.d.Aare, Aarenbrücke",,0.000056,88,1,2,3,6948,6948,13896,17,0.10396,0.158969,672,0,0
8500494,"Solothurn, Amthausplatz",,0.000011,56,0,1,1,0,2134,2134,15,0.114286,0.188438,0,0,0
8500550,"Brugg AG, Brücke",,0.000011,57,0,6,6,0,18721,18721,30,0.067989,0.090634,0,0,0
8500554,"Bözberg, Kirchbözberg",,0.000012,57,1,1,2,5802,5465,11267,31,0.062896,0.075487,0,0,0
8500556,"Mettau, Linde",,0.000012,57,1,4,5,4995,8331,13326,29,0.071442,0.091665,722.635576,0,0
8500557,"Mettau, Post",,0.000014,57,1,3,4,5129,5728,10857,30,0.066897,0.083167,2,0,0
8500555,"Lauffohr, Dorf",,0.000012,57,1,2,3,2920,11726,14646,31,0.064007,0.077036,2,0,0
8500564,"Rüfenach AG, Dorf",,0.000029,57,1,3,4,5937,5937,11874,31,0.064001,0.077732,2462.063519,0,0
8500568,"Remigen, Abzw. Ueberthal",,0.000019,57,1,1,2,5327,5327,10654,31,0.063907,0.075876,0,0,0
8500572,"Villigen, Husberg",,0.000025,57,1,1,2,8333,7844,16177,31,0.063907,0.075876,1161,0,0
8500552,"Rüfenach AG, Hinterrein",,0.000012,57,1,2,3,4367,5937,10304,33,0.057653,0.068822,3.5,0,0
8500558,"Mönthal, Unterdorf",,0.000016,57,1,1,2,5327,5327,10654,33,0.057607,0.068029,0,0,0
8500559,"Umiken, Mühlehalde",,0.000029,57,4,4,8,10942,11281,22223,30,0.067061,0.08439,1256.15,0,0
8500560,"Oberhofen AG, Ausserdorf",,0.000024,57,3,3,6,5815,5815,11630,29,0.071325,0.090205,2829.95,0,0
8500784,"Hottwil, Wendeplatz",,0.000026,57,2,1,3,5612,5603,11215,29,0.069816,0.084656,568.5,0,0
8500777,"Gansingen, Dorfplatz",,0.000054,57,3,4,7,5815,5815,11630,28,0.075093,0.0967,7892.418241,0,0
8500561,"Remigen, Zentrum",,0.000043,57,4,2,6,11294,11294,22588,32,0.061076,0.074508,2637.3,0,0
8500563,"Riniken, Gemeindehaus",,0.000041,57,1,2,3,5479,5479,10958,30,0.06565,0.079673,2475.036481,0,0
8500569,"Gansingen, Oberbüren",,0.000035,57,2,2,4,5081,5081,10162,29,0.069962,0.085783,1769.118241,0,0
8500776,"Bürersteig, Passhöhe",,0.000026,57,1,1,2,4995,4995,9990,29,0.069905,0.084977,0,0,0
8500562,"Riniken, Post",,0.000035,57,2,1,3,5479,5479,10958,31,0.061656,0.072341,1348.036481,0,0
8500767,"Bözberg, Gemeindehaus",,0.000039,57,1,2,3,5584,5584,11168,30,0.065497,0.079046,3395.4,0,0
8500785,"Wil AG, Mitteldorfstrasse",,0.000036,57,2,4,6,8481,10659,19140,28,0.07499,0.096208,3523.835576,0,0
8572486,"Lauffohr, Platte",,0.000069,57,1,2,3,18249,14148,32397,30,0.06214,0.071027,18628,0,0
8500565,"Bözberg, Neustalden",,0.000017,57,1,2,3,5802,5908,11710,32,0.058053,0.067324,17.4,0,0
8500570,"Bözberg, Ursprung",,0.000018,57,1,1,2,5802,5465,11267,32,0.058004,0.0665,0,0,0
8500566,"Stilli, Villigerstrasse",,0.000016,57,1,1,2,7898,8333,16231,32,0.060117,0.06972,2,0,0
8500571,"Veltheim AG, Unterdorf",,0.000011,58,0,1,1,0,4545,4545,7,0.227848,0.302513,0,0,0
8500574,"Veltheim AG, Wildenstein",,0.00002,58,1,3,4,4545,4854,9399,6,0.278689,0.402941,17,0,0
8500979,"Schinznach Dorf, Post",,0.000017,58,1,2,3,2432,2432,4864,6,0.266667,0.365625,0,0,0
8502557,"Auenstein, Kirche",,0.000024,58,2,2,4,726,6062,6788,6,0.294118,0.398889,12,0,0
8500576,"Windisch, Zentrum",,0.000011,22,0,5,5,0,20026,20026,24,0.090015,0.112359,0,0,0
8500577,"Windisch, Löwen",,0.000013,22,1,1,2,4131,4132,8263,28,0.065619,0.073245,0,0,0
8500578,"Windisch, Reformierte Kirche",,0.000024,22,2,3,5,7887,8255,16142,27,0.070157,0.08028,1005.5,0,0.000001
8502706,"Büblikon, Reusstal",,0.00002,22,1,1,2,7274,7391,14665,24,0.085521,0.099283,1010,0,0
8502775,"Birmenstorf AG, Strählgass",,0.000019,22,2,3,5,19145,19145,38290,23,0.096283,0.116592,356.200531,0.000001,0.000006
8572521,"Birrhard, Gemeindehaus",,0.000063,22,1,2,3,5171,5172,10343,4,0.454545,0.616667,101,0,0.00003
8572523,"Windisch, Kurve",,0.000048,22,1,1,2,4123,4123,8246,3,0.5,0.611111,53,0,0
8500579,"Bözberg, Egenwil",,0.000034,57,2,1,3,5571,5584,11155,31,0.061522,0.071919,2271.4,0,0
8500583,"Frick, Bahnhof",,0.000011,57,0,4,4,0,17122,17122,31,0.064228,0.084674,0,0,0
8500976,"Zeihen, Hohbächli",,0.000011,57,0,1,1,0,5696,5696,33,0.056755,0.067499,0,0,0
8500977,"Densbüren, Gemeindehaus",,0.000031,57,2,1,3,8035,7970,16005,33,0.056755,0.067499,2382,0,0
8500585,"Ittenthal, Dorfmitte",,0.000011,57,0,1,1,0,3549,3549,31,0.06367,0.079518,0,0,0
8500982,"Ueken, Gemeindehaus",,0.000031,57,1,2,3,8127,8169,16296,31,0.063676,0.080081,5920,0,0
8500983,"Kaisten, Gemeindehaus",,0.000036,57,3,6,9,9658,14280,23938,30,0.067942,0.090738,9114.5,0,0
8572396,"Frick, Oberdorf",,0.000065,57,2,2,4,8613,8528,17141,34,0.053125,0.064826,15282,0,0
8500588,"Rheinsulz, Dorf",,0.000011,57,0,2,2,0,3728,3728,30,0.06527,0.07813,0,0,0
8572403,"Laufenburg, Bahnhof",,0.000092,57,6,6,12,24768,27259,52027,28,0.074832,0.096868,35669.5,0,0
8500589,"Sulz AG, Bütz",,0.000016,57,1,1,2,3536,3465,7001,29,0.06968,0.084714,593.5,0,0
8500953,"Riniken, Bruggerstrasse",,0.000029,57,1,5,6,5479,5479,10958,28,0.074968,0.096823,7371.068241,0,0
8503685,"Kleindöttingen, Burlen",,0.000039,57,1,3,4,10810,10580,21390,27,0.079641,0.100424,10586.644158,0,0.000002
8572402,"Laufenburg, Blauen",,0.000038,57,2,1,3,13272,13390,26662,29,0.06968,0.084714,29458,0,0
8500591,"Asp AG, Abzw.",,0.000013,57,1,2,3,8018,8041,16059,34,0.053792,0.063377,2,0,0
8500592,"Küttigen, Abzw. Giebel",,0.000017,57,1,1,2,7920,7914,15834,34,0.053749,0.062591,0,0,0
8500596,"Boningen, Kreuzplatz",,0.000011,94,0,2,2,0,6989,6989,22,0.127168,0.157369,0,0,0
8500685,"Oensingen, Bauamt",,0.000016,94,1,1,2,5767,6267,12034,22,0.126607,0.153092,0,0,0
8500597,"Ramiswil, Dorf",,0.000011,94,0,1,1,0,6094,6094,25,0.104167,0.153069,0,0,0
8500599,Salhöhe,,0.000011,57,0,1,1,0,3876,3876,9,0.216216,0.295561,0,0,0
8578651,"Erlinsbach, Sagi",,0.000049,57,1,1,2,14921,14921,29842,9,0.216216,0.295561,455,0,0
8500653,Ocourt,,0.000011,52,0,1,1,0,1353,1353,12,0.173913,0.24897,0,0,0
8500655,"Bärschwil, Dorf",,0.000011,54,0,2,2,0,6452,6452,41,0.052545,0.102761,0,0,0
8500689,"Liesberg, Dorfplatz",,0.000017,54,1,2,3,3864,3864,7728,40,0.054742,0.113258,2,0,0
8500656,"Epiquerez, village",,0.000011,52,0,1,1,0,1963,1963,14,0.139241,0.204851,0,0,0
8500657,"Montenol, école",,0.00002,52,1,1,2,1963,2431,4394,13,0.154412,0.22292,21,0,0
8500658,"Epauvillers, poste",,0.000028,52,1,1,2,2431,2431,4862,12,0.173913,0.24897,40,0,0
8500673,"Nenzlingen, Unterdorf",,0.000011,54,0,3,3,0,5370,5370,37,0.061249,0.131615,0,0,0
8500686,"Dittingen, Himmelrich",,0.000014,54,1,2,3,2606,6044,8650,38,0.058645,0.124774,3,0,0
8500688,"Liesberg, Riederwald",,0.000016,54,1,2,3,302,5499,5801,40,0.055033,0.114651,156,0,0
8500958,"Wahlen b. Laufen, Petersplatz",,0.000034,54,2,1,3,6645,6878,13523,40,0.054101,0.105042,293.666667,0,0
8510077,"Metzerlen, Allmendhalle",,0.000029,54,1,2,3,5794,5140,10934,40,0.056466,0.122769,1024,0,0
8500757,"Erschwil, Dorf",,0.000034,54,1,4,5,9907,9894,19801,27,0.089552,0.164157,369.333333,0,0
8572177,"Dittingen, Industriezone Ried",,0.000037,54,2,4,6,9972,9055,19027,37,0.050621,0.1143,1765.666667,0,0
8572178,"Zwingen, Laufenstrasse",,0.000019,54,1,3,4,4491,5370,9861,37,0.050207,0.106939,51,0,0
8500674,"Balsthal, Bahnhof",,0.00002,94,1,5,6,6094,14972,21066,24,0.115595,0.192614,169,0,0
8500770,"Beinwil SO, Reh",,0.000041,54,2,3,5,2332,2332,4664,24,0.109109,0.184188,679,0,0
8500762,"Holderbank SO, Dorfplatz",,0.000014,94,1,2,3,7362,7362,14724,24,0.10181,0.165334,6,0,0
8500774,"Mümliswil, Bank",,0.000026,94,2,3,5,6334,6493,12827,23,0.114044,0.188873,767,0,0
8500989,"Waldenburg, Hauenstein",,0.000032,94,1,2,3,7255,7255,14510,23,0.104693,0.166301,174,0,0
8572193,"Beinwil SO, Oberbuchen",,0.00007,54,1,2,3,937,937,1874,23,0.104693,0.166301,2784,0,0
8572314,"Balsthal, Post",,0.000071,94,5,2,7,8945,8971,17916,23,0.108723,0.179133,1888,0,0
8572321,"Ramiswil, Mühle",,0.000063,94,1,2,3,6493,3138,9631,8,0.202899,0.254082,399,0,0
8500676,"Perrefitte, poste",,0.000011,1,0,3,3,0,4023,4023,18,0.146927,0.214653,0,0,0
8500680,"Moutier, Hôtel de Ville",,0.000014,1,1,2,3,2027,4441,6468,18,0.145646,0.206557,0,0,0
8571944,"Châtelat, bif. sur le Pichoux",,0.000035,1,1,3,4,2060,1863,3923,7,0.310345,0.432937,58.666667,0,0
8500677,"Damphreux, Sous la Côte",,0.000011,50,0,1,1,0,5264,5264,23,0.122124,0.184587,0,0,0
8500695,"Metzerlen, Challstrasse",,0.000027,54,2,3,5,6627,6679,13306,42,0.05239,0.107575,94.766667,0,0
8500954,"Röschenz, Dorfplatz",,0.000018,54,1,1,2,662,663,1325,42,0.052012,0.096931,0,0,0
8500683,"Windisch, Dägerli",,0.000019,22,2,1,3,5133,5172,10305,26,0.075103,0.084317,1993,0,0
8500684,"Niederwil SO, Feuerwehrmagazin",,0.00002,56,1,1,2,2134,5729,7863,14,0.123656,0.207086,23,0,0
8572176,"Laufen, Ricola/Spilag",,0.000024,54,1,1,2,6204,6204,12408,38,0.048599,0.092321,1560.666667,0,0
8500690,"Möhlin, Post",,0.000011,2,0,2,2,0,4112,4112,16,0.113313,0.138525,0,0,0
8500789,"Möhlin, Volg-Riburg",,0.000016,2,1,3,4,3766,4577,8343,16,0.113567,0.14338,13,0,0
8557111,"Rheinfelden, Salzbodenstrasse",,0.000011,2,0,1,1,0,7221,7221,16,0.111205,0.128391,0,0,0
8500693,"St. Pantaleon, Degenmatt",,0.000011,2,0,2,2,0,5534,5534,17,0.12103,0.14617,0,0,0
8500972,"Büren SO, Dorf",,0.000016,2,1,1,2,3953,3952,7905,17,0.12072,0.143673,0,0,0
8507317,"Flüh, Sternenbergstrasse",,0.000043,54,3,2,5,5718,6364,12082,41,0.05452,0.113098,885.133333,0,0
8500698,"Hubersdorf, Dietrich",,0.000028,56,1,2,3,5729,5729,11458,13,0.134969,0.245745,44,0,0
8500699,"Günsberg, Glutzenberg",,0.000023,56,1,2,3,1471,1473,2944,12,0.147887,0.272435,30,0,0
8500750,"Balm b. Günsberg, Dorf",,0.000033,56,2,1,3,5157,5192,10349,12,0.141844,0.236057,30,0,0
8500700,"Saignelégier, La Theurre",,0.000011,1,0,1,1,0,1425,1425,10,0.199203,0.247071,0,0,0
8500702,"Troistorrents, Es-Cortaz",,0.000011,103,0,1,1,0,620,620,19,0.083565,0.142794,0,0,0
8500703,"Troistorrents, Les Mayettes",,0.00002,103,1,1,2,620,620,1240,18,0.088146,0.147788,29,0,0
8500704,"Morgins, Rière",,0.000028,103,1,1,2,620,620,1240,17,0.093333,0.15336,56,0,0
8500706,"Val-d'Illiez, L'Ayer",,0.000011,0,0,1,1,0,562,562,8,0.229167,0.335823,0,0,0
8500707,"Val-d'Illiez, Les Fornets",,0.00002,0,1,2,3,562,562,1124,7,0.27027,0.425952,10,0,0
8500708,"Val-d'Illiez, Les Jeurs",,0.000019,0,1,1,2,327,327,654,7,0.25,0.362169,0,0,0
8500709,"Val-d'Illiez, Lisa",,0.000036,0,2,2,4,562,562,1124,6,0.296296,0.45625,24,0,0
8500710,Moosalp,,0.000011,40,0,3,3,0,1597,1597,26,0.117552,0.174921,0,0,0
8501650,"Leuk, Bahnhof",,0.000123,40,7,4,11,46710,47444,94154,26,0.125729,0.197868,4530,0,0
8501717,"Visp, Lonzawerke",,0.00004,40,2,7,9,1406,5778,7184,25,0.130198,0.219447,3658.066667,0,0
8501964,"Zeneggen, Tola",,0.000011,40,0,3,3,0,2468,2468,17,0.133981,0.176156,0,0,0
8500730,"Dully, Bourg d'Amont",,0.000011,32,0,2,2,0,4486,4486,9,0.219595,0.273339,0,0,0
8500738,"Gilly, village",,0.000038,32,1,1,2,5431,5158,10589,9,0.213287,0.25711,183,0,0
8501870,"Aubonne, gare",,0.000046,32,2,6,8,12917,13458,26375,40,0.045919,0.068827,19346,0,0
8505917,"Gimel, place de L'Union",,0.000067,32,2,3,5,10942,12332,23274,9,0.240602,0.311316,493,0,0
8500731,"Tartegnin, village",,0.000016,32,1,1,2,833,5158,5991,12,0.134737,0.159668,3,0,0
8500732,"Vinzel, village",,0.000024,32,1,1,2,5158,5431,10589,11,0.153285,0.179933,65,0,0
8500733,"Luins, village",,0.000031,32,1,1,2,5431,5431,10862,10,0.178161,0.209351,125,0,0
8500734,"Bougy-Villars, centre",,0.000011,32,0,2,2,0,2174,2174,42,0.042211,0.056913,0,0,0
8501855,"St-George, village",,0.000031,125,1,3,4,7244,11838,19082,42,0.046387,0.067774,11706,0,0
8501862,"Signal-de-Bougy, Parc Pré Vert",,0.000016,32,1,1,2,488,804,1292,42,0.042182,0.05624,0,0,0
8500736,"Mont-sur-Rolle, Bugnaux",,0.000011,32,0,1,1,0,3989,3989,14,0.114809,0.138642,0,0,0
8500737,"Mont-sur-Rolle, église",,0.00002,32,1,1,2,3989,3988,7977,13,0.12782,0.152219,68,0,0
8500739,"Les Cerniers, restaurant",,0.000011,103,0,1,1,0,545,545,19,0.083026,0.122109,0,0,0
8500740,"Champoussin, village",,0.000026,0,1,1,2,235,235,470,5,0.315789,0.422222,12,0,0
8501891,"Les Crosets, télécabine",,0.000026,0,1,1,2,327,327,654,5,0.315789,0.422222,12,0,0
8500743,"Choëx, école",,0.00002,103,1,1,2,545,545,1090,18,0.088531,0.127325,44,0,0
8500744,"Morgins, Fenebet",,0.000035,103,1,1,2,620,620,1240,16,0.099265,0.159662,81,0,0
8500745,"Les Giettes, anc. poste",,0.000028,103,1,1,2,545,545,1090,17,0.094923,0.133393,86,0,0
8500746,"Les Giettes, La Loëx",,0.000035,103,1,1,2,545,545,1090,16,0.102439,0.140579,126,0,0
8500748,"Troistorrents, Thiésaz",,0.00004,103,1,1,2,620,620,1240,15,0.106122,0.166907,104,0,0
8500749,"Choëx, Troillet",,0.00004,103,1,1,2,545,545,1090,15,0.111413,0.149274,164,0,0
8500751,"Bellelay, poste",,0.00002,1,2,4,6,508,5937,6445,17,0.156352,0.223231,160.666667,0,0
8500758,"Les Genevez JU, poste",,0.000015,1,1,3,4,3129,5560,8689,16,0.163355,0.232832,186,0,0
8500885,"Les Genevez JU, bif.Le Prédame",,0.000069,1,1,4,5,4888,4788,9676,18,0.146789,0.253516,957.666667,0,0
8504397,Sornetan,,0.000015,1,1,1,2,2060,2060,4120,9,0.206186,0.266091,0,0,0
8500752,"Breitenbach, Dorfplatz",,0.000014,54,1,3,4,925,10030,10955,29,0.085506,0.138673,128,0,0
8500754,"Brislach, Dorf",,0.000015,54,1,1,2,9458,9458,18916,29,0.077128,0.115646,0,0,0
8500957,"Grindel, Mitte",,0.000023,54,2,1,3,6452,6522,12974,41,0.051639,0.091917,3,0,0
8500753,Bretzwil Dorf,,0.000011,2,0,2,2,0,2896,2896,18,0.110095,0.133162,0,0,0
8500850,Bubendorf Zentrum,,0.000016,2,1,3,4,321,39840,40161,18,0.109987,0.134502,2.5,0,0
8500851,Ziefen Zentrum,,0.000015,2,1,1,2,24751,24751,49502,18,0.109567,0.129607,0,0,0
8500755,"Büsserach, Schulhaus",,0.000028,54,2,1,3,9907,9907,19814,28,0.082853,0.132139,259.333333,0,0
8500756,Les Cerlatez,,0.00002,1,1,4,5,1425,1425,2850,9,0.243781,0.331932,49,0,0
8500759,"Goumois, douane",,0.000015,1,1,1,2,645,1186,1831,12,0.174545,0.223752,0,0,0
8500769,"Les Pommerats, village",,0.000028,1,2,2,4,1428,1428,2856,11,0.207048,0.284947,93,0,0
8500888,"Les Reussilles, Sous-la-Sagne",,0.000039,1,1,1,2,2857,2857,5714,15,0.114634,0.154327,419,0,0
8571925,"Tramelan, Chalet",,0.000063,1,1,1,2,3981,3981,7962,12,0.161765,0.229674,512,0,0
8572179,"Zwingen, Schulhaus",,0.000034,54,4,2,6,6456,5620,12076,36,0.052098,0.102114,1918.666667,0,0
8572184,"Breitenbach, Ebne",,0.000039,54,1,1,2,9457,9458,18915,32,0.057866,0.082882,2217,0,0
8500883,"Lajoux JU, Les Vacheries",,0.000062,1,2,1,3,4649,4788,9437,20,0.116402,0.165014,744,0,0
8500760,"Günsberg, Dorfplatz",,0.000048,56,2,3,5,5766,5728,11494,11,0.157025,0.300524,95,0,0
8507332,"Niederwil SO, Dorf",,0.000025,56,1,2,3,2868,2868,5736,11,0.15,0.261664,0,0,0
8508776,"Oberbalmberg, Kurhaus",,0.000035,56,2,1,3,1470,1473,2943,11,0.142857,0.218233,0,0,0
8500763,"Langenbruck, Dorf",,0.000017,94,1,1,2,7255,7255,14510,25,0.088294,0.125886,6,0,0
8500764,"Beinwil SO, Neuhüsli",,0.000018,54,1,1,2,2332,2330,4662,26,0.091653,0.13327,370,0,0
8500765,"Nunningen, Post",,0.000011,53,0,1,1,0,5674,5674,9,0.212766,0.285675,0,0,0
8500766,"Beinwil SO, Oberbeinwil",,0.000026,54,1,2,3,2330,2331,4661,25,0.1,0.157052,475,0,0
8500768,Passwang,,0.000022,54,1,1,2,936,937,1873,25,0.099188,0.149389,0,0,0
8500950,"Umiken, Oberdorf",,0.000064,57,4,3,7,9607,11281,20888,29,0.069921,0.08675,6428.418241,0,0
8503890,"Bözberg, Gallenkirch",,0.000029,57,1,1,2,3085,3071,6156,37,0.043944,0.049555,0,0,0
8500874,"Le Bémont JU, Grand-Creux",,0.000054,1,1,2,3,3427,3413,6840,21,0.123311,0.207619,511,0,0
8500878,"Glovelier, église",,0.000054,1,2,2,4,6128,6128,12256,19,0.142285,0.225767,635,0,0
8571933,"Saignelégier, Centre Loisirs",,0.000054,1,1,1,2,1425,1425,2850,8,0.265306,0.335668,254,0,0
8500772,"Wegenstetten, Oberdorf",,0.000011,55,0,1,1,0,3033,3033,10,0.166667,0.219252,0,0,0
8500775,"Seewen SO, Herrenmatt",,0.000011,53,0,1,1,0,4571,4571,5,0.315789,0.422222,0,0,0
8572131,"Grellingen, Neutal",,0.000023,53,1,1,2,5674,5674,11348,5,0.315789,0.422222,60,0,0
8572437,"Laufenburg, Kreisschule",,0.000056,57,3,3,6,945,943,1888,28,0.072551,0.089992,10301.5,0,0
8500778,"Kilchberg BL, Gemeindehaus",,0.000011,55,0,1,1,0,5158,5158,11,0.157895,0.221418,0,0,0
8500779,"Zeglingen, Unterdorf",,0.00002,55,1,3,4,5158,5509,10667,10,0.181818,0.282788,32,0,0
8500780,"Oltingen, Postplatz",,0.000017,55,1,2,3,370,449,819,10,0.164894,0.23501,1,0,0
8572305,"Oltingen, Lehmatt",,0.000057,55,1,2,3,449,449,898,4,0.461538,0.597222,38,0,0
8572309,"Rünenberg, Frohe Aussicht",,0.000059,55,1,1,2,5158,5158,10316,2,0.666667,0.75,30,0,0
8500781,"Rünenberg, Mitteldorf",,0.000024,55,2,2,4,5126,5256,10382,9,0.189873,0.26668,69.5,0,0
8500782,"Wenslingen, Vorderdorf",,0.000028,55,2,1,3,481,449,930,9,0.184713,0.241393,14.5,0,0
8500966,"Kienberg, Hirschen",,0.000034,55,1,2,3,7390,7390,14780,8,0.223077,0.309401,60,0,0
8500783,"Magden, Post",,0.000011,2,0,1,1,0,2218,2218,17,0.129422,0.15348,0,0,0
8500854,Augst,,0.000016,2,1,6,7,16181,30288,46469,13,0.170241,0.207845,323.933333,0,0
8572239,Arisdorf Schulhaus,,0.000069,2,1,3,4,12252,12252,24504,13,0.154242,0.189955,3790.752381,0,0
8572441,"Etzgen, Rheintalstrasse",,0.000075,57,6,4,10,9354,9058,18412,27,0.076998,0.095198,63003.538724,0,0.000002
8500786,"Windisch, Habsburgstrasse",,0.000011,22,0,1,1,0,4832,4832,14,0.141667,0.227543,0,0,0
8572251,"Rheinfelden, Töpferweg",,0.000021,2,1,2,3,4409,4409,8818,6,0.3125,0.41,49,0,0
8572252,"Rheinfelden, Regionalspital",,0.00002,2,1,2,3,4299,4112,8411,6,0.304348,0.403571,6,0,0
8572256,"Möhlin, Hölzlistrasse",,0.000019,2,1,2,3,108,1098,1206,5,0.371429,0.464103,3.775,0,0
8572258,"Möhlin, Dammstrasse",,0.000041,2,4,2,6,5216,5389,10605,5,0.375,0.475,58.725,0,0
8500799,Seltisberg Zentrum Schule,,0.000011,2,0,1,1,0,17972,17972,17,0.120452,0.142628,0,0,0
8500852,Reigoldswil Dorfplatz,,0.000033,2,3,3,6,37914,38396,76310,17,0.122695,0.153184,888.183122,0,0
8500855,Bubendorf Bad,,0.000025,2,2,2,4,39694,46135,85829,17,0.121908,0.149884,152.316878,0,0
8500857,Titterten Gemeindehaus,,0.000031,2,2,3,5,11145,11159,22304,17,0.129469,0.162318,205.889256,0,0
8500859,Liestal Stadion,,0.00003,2,2,4,6,46149,63323,109472,16,0.137751,0.17894,484.920008,0,0
8500853,Muttenz Waldhaus,,0.000012,2,1,2,3,25420,28103,53523,14,0.151683,0.178549,140.666667,0,0
8500960,Hersberg Dorf,,0.000013,2,1,1,2,9332,11082,20414,14,0.156328,0.179397,0,0,0
8572248,"Olsberg, Chloster",,0.000045,2,1,1,2,2232,278,2510,14,0.134362,0.156012,940,0,0
8577508,"Rheinfelden, Salmen-Park",,0.000023,2,1,2,3,14974,14974,29948,14,0.134825,0.16048,940,0,0
8578347,Augst Schwarzacker,,0.000025,2,1,1,2,11743,11743,23486,14,0.134362,0.156012,1497,0,0
8506070,Reigoldswil Bündten,,0.000035,2,3,4,7,13149,13149,26298,16,0.137708,0.178459,1193.752641,0,0
8572212,Liestal Bahnhof,,0.000156,2,11,12,23,151301,157890,309191,15,0.157674,0.222167,6497.071141,0,0
8500858,Liestal Radacker,,0.000013,2,1,1,2,16129,16447,32576,16,0.136546,0.17047,47,0,0
8500971,Lupsingen Dorf,,0.00002,2,1,1,2,17972,17972,35944,16,0.136546,0.17047,340,0,0
8500985,"Nuglar, Dorfplatz",,0.000029,2,2,2,4,5533,5534,11067,16,0.136893,0.172902,682,0,0
8503662,"Liestal, Bahnhof Süd",,0.000023,2,1,1,2,3326,3326,6652,16,0.136546,0.17047,0,0,0
8503676,Pratteln Schwimmbad,,0.000016,2,1,1,2,11922,11922,23844,16,0.136546,0.17047,195.733333,0,0
8504806,Lausen Bahnhof Süd,,0.000017,2,1,1,2,17174,17174,34348,16,0.136546,0.17047,0,0,0
8506067,Lausen Ziegelmatt,,0.00002,2,1,1,2,23903,23903,47806,16,0.136546,0.17047,340,0,0
8510216,Ziefen Untertal,,0.000017,2,1,1,2,24751,24751,49502,16,0.136546,0.17047,0,0,0
8500860,"Montfaucon, Péchillard",,0.000011,1,0,1,1,0,3427,3427,27,0.075973,0.109887,0,0,0
8500861,"Lajoux JU, poste",,0.000015,1,1,2,3,4668,4788,9456,18,0.141199,0.193171,120,0,0
8500881,"Lajoux JU, Cras-des-Mottes",,0.000047,1,2,2,4,2794,2933,5727,21,0.107087,0.158797,598,0,0
8500863,"Montfaucon, poste",,0.00002,1,1,2,3,3427,3402,6829,26,0.081192,0.122859,79,0,0
8500864,"Glovelier, la Roche",,0.000019,1,1,1,2,3171,3195,6366,26,0.080247,0.111614,0,0,0
8500865,"St-Brais, village",,0.000036,1,2,1,3,3426,3425,6851,25,0.08613,0.119937,231,0,0
8500866,Les Sairains,,0.000041,1,1,1,2,3425,3427,6852,24,0.093023,0.130733,304,0,0
8500867,"Saulcy, village",,0.000017,1,1,1,2,2933,2933,5866,20,0.126095,0.180619,138,0,0
8500875,"Glovelier, La Morée",,0.000034,1,1,1,2,3181,3195,6376,20,0.126095,0.180619,368,0,0
8500868,Enson-la-Fin,,0.000046,1,1,1,2,3427,3427,6854,23,0.101215,0.145528,375,0,0
8500869,Le Chésal,,0.00005,1,1,1,2,3427,3427,6854,22,0.111111,0.167697,444,0,0
8500873,"Langenbruck, Dürrenberg",,0.000025,94,1,1,2,7255,7255,14510,24,0.095756,0.14107,91,0,0
8500877,"Soubey, village",,0.000035,52,1,1,2,2431,2431,4862,11,0.2,0.292274,57,0,0
8500988,"St-Ursanne, Pont St-Jean/ville",,0.00002,52,1,1,2,1353,3822,5175,11,0.2,0.292274,19,0,0
8500879,"Saulcy, Bonembez",,0.000034,1,1,2,3,2933,2933,5866,22,0.099291,0.150541,494,0,0
8500880,"Saulcy, bif. La Racine",,0.000025,1,1,1,2,2891,2752,5643,22,0.098011,0.13823,0,0,0
8500882,"Lajoux JU, laiterie",,0.000037,1,2,1,3,4746,4607,9353,21,0.105678,0.146242,45,0,0
8500884,Le Prédame,,0.000068,1,2,1,3,4888,4888,9776,19,0.129741,0.194438,914.666667,0,0
8571942,"Bellelay, Route de Moron",,0.000058,1,1,2,3,2834,2834,5668,14,0.150215,0.247051,254.333333,0,0
8571926,"Les Reussilles, gare",,0.000069,1,2,5,7,4282,4279,8561,11,0.188596,0.311629,565,0,0
8572021,"Bassecourt, gare",,0.000023,1,1,1,2,943,945,1888,11,0.175,0.239698,0,0,0
8500886,"Les Genevez JU, Les Vacheries",,0.000026,1,1,1,2,2857,2710,5567,17,0.096647,0.133556,371,0,0
8500887,"Les Genevez JU, Cernil-Bousset",,0.000033,1,1,1,2,2710,2857,5567,16,0.104803,0.142666,396,0,0
8500889,"Tramelan, place du Marché",,0.00006,1,3,1,4,3982,3981,7963,14,0.126722,0.169988,484,0,0
8578157,Neuweilerstrasse,,0.000014,2,1,1,2,12087,12086,24173,12,0.15463,0.17432,0,0,0
8587001,Allschwil Dorf,,0.000068,2,4,5,9,14256,14254,28510,11,0.194444,0.241386,1450.957881,0,0
8588773,Universitätsspital,,0.000097,2,5,3,8,34200,34195,68395,10,0.220361,0.265465,1446.674033,0,0
8588774,Kaserne,,0.000035,2,2,3,5,13252,13252,26504,10,0.208537,0.245213,160.829021,0,0
8588775,Marktplatz,,0.000109,2,8,4,12,51407,51386,102793,10,0.220207,0.268007,3833.757346,0,0
8588778,Münchensteinerstrasse,,0.00005,2,2,6,8,11586,11546,23132,8,0.27422,0.328023,930.222711,0,0
8588780,Schifflände,,0.000176,2,6,16,22,86632,75791,162423,9,0.274542,0.363292,5692.416515,0,0
8589292,Allmendstrasse,,0.000022,2,2,4,6,11384,12726,24110,8,0.237557,0.288923,183.269571,0,0
8589289,Parkallee,,0.000043,2,1,2,3,5727,5727,11454,9,0.217672,0.25954,142.263492,0,0
8589306,Drei Linden,,0.000029,2,4,3,7,9729,10099,19828,8,0.233256,0.278913,635.081401,0,0
8589308,Ensisheimerstrasse,,0.000032,2,1,1,2,8141,8141,16282,9,0.202405,0.230343,113,0,0
8578144,Kannenfeldplatz,,0.000024,2,4,4,8,47738,47683,95421,17,0.154393,0.207844,180.279043,0,0
8588767,Ciba,,0.000097,2,11,1,12,15460,15551,31011,11,0.181087,0.208633,84.974948,0,0
8500926,"Oetwil a.d.L., Schweizäcker",,0.000011,22,0,1,1,0,12050,12050,16,0.134277,0.15721,0,0,0.000805
8502508,"Spreitenbach, Raiacker",,0.000011,22,0,3,3,0,31003,31003,16,0.134744,0.160888,0,0,0.000868
8583214,"Birmensdorf ZH, Ristet",,0.000023,85,1,2,3,4860,9285,14145,16,0.143629,0.173603,17060.861426,0.000071,0.002229
8583870,"Birmensdorf ZH, Bahnhof Süd",,0.000064,85,3,3,6,13629,9868,23497,16,0.146939,0.184626,29146.960901,0.001425,0.030089
8587018,Kindhausen AG,,0.000011,22,0,3,3,0,16738,16738,16,0.134384,0.159529,0,0,0.000855
8500949,"Simplon, Monte Leone",,0.000011,40,0,1,1,0,1615,1615,26,0.104673,0.139641,0,0,0
8572448,"Gansingen, Unterbüren",,0.000037,57,1,2,3,5081,5081,10162,37,0.043951,0.050337,6118,0,0
8503891,"Bözberg, Linn",,0.000071,57,3,2,5,5907,5894,11801,36,0.045919,0.0528,1243.75,0,0
8572449,"Remigen, Stig",,0.000032,57,2,1,3,5357,5357,10714,36,0.045914,0.052147,7074,0,0
8500963,"Ormalingen, Unterdorf",,0.00002,55,1,2,3,3033,11699,14732,9,0.193939,0.268242,32,0,0
8500996,Gelterkinden Post,,0.000059,55,3,2,5,9239,9886,19125,8,0.21875,0.302594,139,0,0
8500964,"Rothenfluh, Hirschengasse",,0.000019,55,1,1,2,8239,7390,15629,10,0.162304,0.210817,6,0,0
8500965,"Anwil, Dorf",,0.000027,55,1,1,2,7390,7390,14780,9,0.1875,0.244458,34,0,0
8500997,"Hemmiken, Dorf",,0.000045,55,2,1,3,3963,3879,7842,8,0.212598,0.276764,54,0,0
8500978,"Herznach, Post",,0.000048,57,3,2,5,13788,14182,27970,32,0.060119,0.073933,4766,0,0
8500981,"Himmelried, Dorf",,0.00002,53,1,2,3,5674,5950,11624,8,0.256757,0.367231,19,0,0
8572128,"Himmelried, vorderer Igraben",,0.000049,53,1,1,2,5674,5674,11348,8,0.245283,0.34826,65,0,0
8502685,"Rombach, Rombacherhof",,0.000053,57,2,2,4,23176,23245,46421,36,0.049951,0.067366,3837,0,0
8572393,"Herznach, Oberherznach",,0.000044,57,1,1,2,7970,7970,15940,37,0.045932,0.052554,5496,0,0
8572400,"Kaisten, Kaisterberg",,0.000026,57,1,1,2,6150,6150,12300,30,0.065195,0.076668,18944,0,0
8572415,"Kaisten, Unterdorf",,0.000024,57,1,5,6,13395,13395,26790,36,0.048199,0.061143,2904,0,0
8572361,"Fulenbach, Aaretränke",,0.000051,94,1,1,2,6986,6989,13975,17,0.099792,0.133401,819,0,0
8572235,Liestal Abzw. Hersberg,,0.00005,2,1,3,4,12200,12200,24400,15,0.119216,0.139783,1740,0,0
8572237,Arisdorf Weieren,,0.000046,2,2,1,3,11278,11278,22556,15,0.118524,0.134086,302,0,0
8578159,Letten,,0.000021,2,1,2,3,5727,5727,11454,12,0.166944,0.198431,201,0,0
8572240,Giebenach Lindenplatz,,0.000042,2,3,4,7,14603,14603,29206,16,0.148167,0.188163,1952.07816,0,0
8578168,Felix Platter-Spital,,0.000036,2,5,4,9,23124,23298,46422,16,0.167973,0.2208,950.379708,0,0
8578169,Thomaskirche,,0.000024,2,2,2,4,19553,19608,39161,16,0.15101,0.182306,178.399206,0,0
8578195,Kriegacker,,0.000028,2,1,1,2,2706,2706,5412,16,0.138483,0.164152,588,0,0
8578305,Birsfelden Sternenfeld,,0.000022,2,1,1,2,28051,28051,56102,16,0.138483,0.164152,3145.833463,0,0
8578146,Friedrich-Miescher-Str.,,0.000018,2,1,2,3,16071,16071,32142,11,0.190148,0.224338,45.833333,0,0
8578148,EuroAirport Verwaltung,,0.000021,2,2,2,4,15847,15847,31694,11,0.189536,0.222902,7.666667,0,0
8578174,Gartenstrasse,,0.000054,2,2,3,5,17234,17068,34302,11,0.196923,0.237674,833.236847,0,0
8578340,Schulstrasse,,0.000048,2,2,3,5,11851,11851,23702,12,0.188142,0.228919,3858.64688,0,0
8580373,Spalentor,,0.000067,2,5,5,10,36613,37173,73786,11,0.195719,0.244257,1258.065388,0,0
8588770,Grosspeterstrasse,,0.000062,2,6,5,11,10915,10915,21830,10,0.206294,0.249249,496.056278,0,0
8501000,Zimeysa,,0.000011,4,0,2,2,0,20559,20559,33,0.066045,0.075613,0,0,0
8501001,La Plaine,,0.000016,4,1,2,3,16753,16753,33506,32,0.070692,0.082626,1613.5,0,0
8501002,Russin,,0.000022,4,2,1,3,20309,20198,40507,32,0.070671,0.082342,1613.5,0,0
8501003,Satigny,,0.000036,4,2,2,4,20448,20559,41007,31,0.076022,0.091198,9678,0,0
8501006,Meyrin,,0.000026,4,1,1,2,20309,20279,40588,31,0.076,0.090916,0,0,0
8501021,Genthod-Bellevue,,0.000052,4,1,1,2,35955,34892,70847,32,0.071856,0.084087,19296,0,0
8501022,Versoix,,0.000063,4,2,2,4,35599,36662,72261,31,0.077395,0.093574,22505,0,0
8501023,Coppet,,0.000046,4,2,6,8,56603,56475,113078,30,0.082124,0.103114,7497.794805,0,0
8501200,Vevey,,0.000098,4,4,6,10,52732,86786,139518,30,0.082838,0.104836,24871,0,0
8501403,St-Maurice,,0.000022,4,2,6,8,22184,37945,60129,30,0.080738,0.100505,2363.224359,0,0
8501011,Les Tuileries,,0.000019,4,1,1,2,35953,35955,71908,38,0.050286,0.054396,426,0,0
8501012,Creux-de-Genthod,,0.000027,4,1,1,2,35955,35955,71910,37,0.052933,0.057651,3576,0,0
8501013,Pont-Céard,,0.000034,4,1,1,2,35955,35955,71910,36,0.055874,0.061367,6724,0,0
8501014,Mies,,0.00004,4,1,1,2,35955,35955,71910,35,0.059162,0.06566,9870,0,0
8501015,Tannay,,0.000045,4,1,1,2,35955,35955,71910,34,0.062863,0.070692,13014,0,0
8501020,Chambésy,,0.000049,4,1,1,2,35955,35955,71910,33,0.067059,0.076706,16156,0,0
8501033,Rolle,,0.000023,4,1,2,3,19647,19839,39486,30,0.081729,0.100842,0.7,0,0
8516274,Chêne-Bourg,,0.000071,4,1,2,3,38628,38628,77256,1,1,1,150,0,0
8501042,Etoy,,0.000023,4,1,2,3,18427,18427,36854,30,0.081591,0.100489,261,0,0
8501048,Lonay-Préverenges,,0.000035,4,1,1,2,8969,8969,17938,30,0.081527,0.100006,6340,0,0
8501117,Bussigny,,0.000088,4,2,1,3,32315,32315,64630,30,0.081527,0.100006,47552,0,0
8501124,Cully,,0.000056,4,3,2,5,18525,18525,37050,31,0.076588,0.092751,9456,0,0
8501127,St-Saphorin,,0.000045,4,1,1,2,9794,9794,19588,31,0.076524,0.092239,6076,0,0
8501400,Aigle,,0.000081,4,5,10,15,69774,79053,148827,30,0.081983,0.104933,37662.357143,0,0
8501402,Bex,,0.000018,4,1,4,5,20138,27661,47799,31,0.076966,0.094459,2793,0,0
8504144,Yverdon-Champ Pittet,,0.000075,11,2,2,4,17729,17729,35458,31,0.074525,0.087797,23625.5,0,0
8504181,Givisiez,,0.000101,11,4,2,6,38364,32445,70809,31,0.074509,0.087773,52836.7,0,0
8501045,Denges-Echandens,,0.000021,4,1,1,2,8969,8969,17938,32,0.070137,0.081056,176,0,0
8501047,Morges-St-Jean,,0.000029,4,1,1,2,8969,8969,17938,31,0.075403,0.089356,3259,0,0
8501053,La Vuarpillière,,0.000028,4,1,3,4,25194,25194,50388,5,0.363636,0.472917,1312,0,0
8501055,Les Pralies,,0.000019,4,1,2,3,7248,9493,16741,8,0.245902,0.36119,83,0,0
8501058,La Joy-Clinique,,0.000039,4,1,1,2,16336,16432,32768,5,0.324324,0.394444,29,0,0
8501054,La Gottaz,,0.000023,4,1,1,2,17084,17084,34168,13,0.131579,0.223625,1305,0,0
8501059,Les Plantaz,,0.000052,4,2,3,5,25150,25194,50344,4,0.44,0.560606,867,0,0
8501056,Sus-Châtel,,0.000027,4,2,1,3,16490,16432,32922,7,0.21875,0.285884,173,0,0
8501057,La Chèvrerie-Monteret,,0.000034,4,1,1,2,16432,16336,32768,6,0.26,0.325641,102,0,0
8501061,La Givrine,,0.00004,4,1,1,2,9478,9493,18971,8,0.236842,0.35754,14,0,0
8501065,Le Muids,,0.000046,4,1,1,2,16378,15796,32174,5,0.333333,0.456667,22,0,0
8501060,La Cure,,0.000034,4,2,1,3,9479,9478,18957,9,0.208333,0.31623,93,0,0
8501062,St-Cergue,,0.000059,4,2,2,4,18721,18581,37302,7,0.275862,0.449107,368,0,0
8501069,L'Asse,,0.000068,4,1,1,2,25179,7248,32427,1,1,1,6,0,0
8501063,Arzier,,0.000036,4,1,1,2,16378,16378,32756,7,0.25,0.370408,194,0,0
8501064,Bassins,,0.000042,4,1,1,2,16378,16378,32756,6,0.285714,0.408333,109,0,0
8501066,Genolier,,0.000065,4,2,1,3,24514,25150,49664,4,0.4,0.520833,285,0,0
8501067,Givrins,,0.000066,4,1,1,2,25150,25150,50300,3,0.5,0.611111,194,0,0
8501068,Trélex,,0.000067,4,1,1,2,25150,25179,50329,2,0.666667,0.75,101,0,0
8501080,Le Marais,,0.000031,4,1,1,2,17084,17084,34168,12,0.141414,0.235294,1232,0,0
8501081,Chigny,,0.000037,4,1,1,2,17084,17084,34168,11,0.152941,0.248538,1157,0,0
8501082,Chardonney-Château,,0.000042,4,1,1,2,17084,17084,34168,10,0.166667,0.263757,1080,0,0
8501083,Reverolle,,0.000047,4,1,1,2,17084,17084,34168,9,0.183333,0.28153,1001,0,0
8501084,Le Manège,,0.000011,4,0,1,1,0,6206,6206,36,0.055004,0.060634,0,0,0
8501085,Ballens-Froideville,,0.000051,4,1,1,2,17084,17084,34168,8,0.204082,0.302738,920,0,0
8501087,Mauraz,,0.00002,4,1,1,2,6206,6206,12412,35,0.058187,0.064926,3189,0,0
8501088,Tuilerie,,0.000028,4,1,2,3,6206,6437,12643,34,0.061763,0.070129,6376,0,0
8501089,Villars-Bozon,,0.000023,4,1,2,3,6206,8366,14572,3,0.5,0.611111,18,0,0
8501093,Yens,,0.000061,4,1,1,2,17074,7100,24174,4,0.4,0.486111,576,0,0
8501094,Apples,,0.000073,4,2,2,4,14578,25450,40028,3,0.555556,0.666667,493,0,0
8501090,Prélionne,,0.000054,4,1,1,2,17084,17084,34168,7,0.230769,0.328836,837,0,0
8501091,Vufflens-le-Château,,0.000057,4,1,1,2,17084,17084,34168,6,0.266667,0.3625,752,0,0
8501092,Bussy-Chardonney,,0.000059,4,1,1,2,17084,17074,34158,5,0.318182,0.409524,665,0,0
8501095,Ballens,,0.000042,4,1,1,2,17084,17084,34168,1,1,1,102,0,0
8501097,Pampigny-Sévery,,0.000051,4,2,1,3,9254,8346,17600,2,0.666667,0.75,204,0,0
8501098,Montricher,,0.000055,4,1,1,2,8346,4125,12471,1,1,1,103,0,0
8501100,Le Pont,,0.000011,4,0,2,2,0,9860,9860,30,0.081821,0.101259,0,0,0
8501104,Le Day,,0.000018,4,2,3,5,21159,21003,42162,35,0.05814,0.065101,7.5,0,0
8501105,Bretonnières,,0.000016,4,1,1,2,9892,9892,19784,35,0.058006,0.0641,0,0,0
8501107,Arnex,,0.000038,4,1,1,2,12618,12618,25236,33,0.065576,0.074427,9522,0,0
8501106,Croy-Romainmôtier,,0.000032,4,3,1,4,12618,12618,25236,34,0.061558,0.068831,6352,0,0
8501108,La Sarraz,,0.000046,4,2,1,3,12644,11890,24534,32,0.070156,0.081188,12700,0,0
8501112,Chavornay,,0.000038,4,2,3,5,11364,25201,36565,32,0.070252,0.08211,15890,0,0
8501114,Eclépens,,0.000029,4,1,1,2,11148,11148,22296,32,0.070156,0.081188,3173,0,0
8501110,Ependes VD,,0.000023,4,1,2,3,231,11364,11595,33,0.065679,0.075204,9540,0,0
8501111,Essert-Pittet,,0.000021,4,1,1,2,11133,11133,22266,33,0.06566,0.074913,0,0,0
8501113,Bavois,,0.000022,4,1,1,2,11133,11148,22281,33,0.065576,0.074427,6,0,0
8501115,Cossonay-Penthalaz,,0.000086,4,3,2,5,32405,32330,64735,31,0.075425,0.089643,41242,0,0
8501116,Vufflens-la-Ville,,0.000047,4,1,1,2,18952,18937,37889,31,0.075403,0.089356,0,0,0
8501122,Lutry,,0.00003,4,1,2,3,18298,18289,36587,32,0.071183,0.083679,3154,0,0
8501123,Villette VD,,0.000024,4,1,1,2,9794,9794,19588,32,0.071161,0.083377,0,0,0
8501198,Château-d'Oex La Palaz,,0.000011,4,0,2,2,0,9728,9728,30,0.078553,0.096603,0,0,0
8501203,Clarens,,0.00004,4,2,1,3,19050,19049,38099,30,0.078015,0.094918,5968,0,0
8501230,Glion-Alpes,,0.000011,4,0,1,1,0,8922,8922,30,0.078015,0.094918,0,0,0
8504011,Grandvaux,,0.000038,4,1,1,2,19275,19275,38550,32,0.066922,0.079347,2577,0,0
8504007,Moreillon,,0.000029,4,2,2,4,10761,10761,21522,31,0.071748,0.08809,5236,0,0
8504012,Puidoux,,0.000069,4,3,2,5,37850,37850,75700,31,0.071694,0.087952,7378,0,0
8504030,Villars-sur-Glâne,,0.000053,11,1,1,2,15377,15377,30754,29,0.082146,0.10637,15180,0,0
8504086,Bulle,,0.000141,11,4,1,5,36532,17710,54242,29,0.082146,0.10637,105855.5,0,0
8504200,Yverdon-les-Bains,,0.00015,4,10,4,14,58243,57017,115260,30,0.080306,0.097588,213491.635731,0,0
8504201,Grandson,,0.000043,4,1,2,3,23168,14004,37172,38,0.048899,0.05289,2728,0,0
8501121,Pully,,0.000023,4,1,1,2,18298,18298,36596,33,0.066473,0.076242,222,0,0
8501125,Epesses,,0.000035,4,1,1,2,9794,9794,19588,33,0.066406,0.07592,230,0,0
8501126,Rivaz,,0.00004,4,1,1,2,9794,9794,19588,32,0.071106,0.083103,3154,0,0
8501151,Les Charbonnières,,0.000019,4,2,1,3,9860,9860,19720,8,0.222222,0.339732,24,0,0
8501152,Le Séchey,,0.000027,4,1,1,2,9860,9860,19720,7,0.25,0.370408,28,0,0
8501153,Le Lieu,,0.000034,4,1,1,2,9860,9860,19720,6,0.285714,0.408333,30,0,0
8501154,Les Esserts-de-Rive,,0.00004,4,1,1,2,9860,9860,19720,5,0.333333,0.456667,30,0,0
8501155,Le Rocheray,,0.000044,4,1,1,2,9860,9860,19720,4,0.4,0.520833,28,0,0
8501156,Le Solliat-La Golisse,,0.000049,4,1,1,2,9860,9860,19720,3,0.5,0.611111,24,0,0
8501157,Le Sentier-L'Orient,,0.000052,4,1,1,2,9860,9860,19720,2,0.666667,0.75,18,0,0
8501159,Le Brassus,,0.000055,4,1,1,2,9860,9860,19720,1,1,1,10,0,0
8501160,Lausanne-Chauderon,,0.000011,10,0,1,1,0,21736,21736,16,0.136821,0.163014,0,0,0
8501162,Union-Prilly,,0.00002,10,1,2,3,21736,44715,66451,15,0.157731,0.19815,203,0,0
8588839,"Renens VD, av. du 14 Avril",,0.000039,5,3,6,9,46852,105279,152131,16,0.152038,0.209844,1584.24841,0,0
8591939,"Crissier, Zinguerie",,0.00007,5,3,6,9,70026,70025,140051,15,0.202775,0.263649,2200.033566,0,0
8591979,"Lausanne, Alpes",,0.000043,10,3,8,11,71475,71600,143075,13,0.195846,0.270082,2762.065352,0,0
8591988,"Lausanne, Bel-Air",,0.000063,10,6,6,12,153613,180208,333821,15,0.168539,0.224057,7205.116235,0,0
8591996,"Lausanne, Bois-Gentil",,0.000031,10,1,2,3,62546,62511,125057,15,0.167116,0.209153,506.959832,0,0
8591999,"Lausanne, Bonne-Espérance",,0.000037,10,2,4,6,87832,87660,175492,15,0.170971,0.224108,6138.329296,0,0
8592000,"Lausanne, Bossons",,0.000029,10,1,3,4,35671,35682,71353,14,0.192547,0.252014,1507.994223,0,0
8501163,Prilly-Chasseur,,0.000019,3,1,1,2,21736,29576,51312,14,0.128,0.215723,32,0,0
8501164,Cery-Fleur-de-Lys,,0.000027,3,1,1,2,29576,21905,51481,13,0.137615,0.226824,45,0,0
8501165,Jouxtens-Mézery,,0.000034,3,1,1,2,21905,23014,44919,12,0.148936,0.239515,56,0,0
8501166,Romanel-sur-Lausanne,,0.00004,3,1,1,2,23014,32042,55056,11,0.1625,0.254276,65,0,0
8501168,Vernand-Camarès,,0.000045,3,1,1,2,32042,32042,64084,10,0.179104,0.271858,72,0,0
8501169,Cheseaux,,0.000049,3,1,1,2,32042,32042,64084,9,0.2,0.293543,77,0,0
8501170,Bel-Air LEB,,0.000053,3,1,1,2,32042,32042,64084,8,0.227273,0.321786,80,0,0
8501171,Etagnières,,0.000056,3,1,1,2,32042,32042,64084,7,0.264706,0.362169,81,0,0
8501172,Assens,,0.000058,3,1,1,2,32042,32042,64084,6,0.32,0.43125,80,0,0
8501173,Echallens,,0.00006,3,1,3,4,32042,33139,65181,5,0.411765,0.611905,77,0,0
8501178,Grésaley,,0.000049,3,1,2,3,18539,17306,35845,1,1,1,8,0,0
8501181,Lausanne-Flon,,0.000049,3,2,1,3,31815,21736,53551,1,1,1,0,0,0
8501174,Sur Roche,,0.000028,3,1,1,2,18373,18539,36912,5,0.3,0.413889,48,0,0
8501175,Sugnens,,0.000035,3,1,1,2,18539,18539,37078,4,0.357143,0.466667,41,0,0
8501176,Fey,,0.00004,3,1,1,2,18539,18539,37078,3,0.444444,0.541667,32,0,0
8501177,Bercher,,0.000045,3,1,1,2,18539,18539,37078,2,0.6,0.666667,21,0,0
8501179,Pont-de-Drapel,,0.000011,4,0,1,1,0,10354,10354,32,0.070488,0.082736,0,0,0
8501191,Orbe,,0.000022,4,1,1,2,4701,4701,9402,2,0.666667,0.75,12,0,0
8501194,Les Granges (Orbe),,0.000029,4,1,1,2,4701,4701,9402,1,1,1,7,0,0
8501387,Les Cases,,0.000065,4,1,2,3,9790,9805,19595,40,0.043611,0.048497,3517,0,0
8501199,La Roulaz,,0.00002,4,1,2,3,10354,10354,20708,31,0.075807,0.092106,2916,0,0
8501229,Monthey-En Place,,0.000011,4,0,4,4,0,18089,18089,31,0.075876,0.093148,0,0,0
8501300,Montreux,,0.000084,4,5,6,11,65363,72716,138079,29,0.084588,0.108458,55441,0,0
8501303,Villeneuve VD,,0.000049,4,2,2,4,25536,25525,51061,31,0.075819,0.092115,5959,0,0
8501304,Roche VD,,0.000032,4,1,1,2,9855,9864,19719,31,0.075795,0.091804,0,0,0
8501201,La Tour-de-Peilz,,0.000025,4,1,2,3,19239,19120,38359,31,0.072414,0.085505,238,0,0
8501202,Burier,,0.000021,4,1,1,2,18879,18809,37688,31,0.072392,0.085199,0,0,0
8501207,"Lausanne, Montelly",,0.000011,5,0,2,2,0,98013,98013,32,0.072519,0.102555,0,0,0
8501208,"Lausanne, Provence",,0.000016,5,1,1,2,69092,69093,138185,39,0.049938,0.074924,207.5,0,0
8501209,"Lausanne, Malley",,0.000024,5,1,5,6,69093,124537,193630,38,0.052524,0.086482,1564.5,0,0
8501217,"Chavannes-R., Crochy",,0.000034,5,1,1,2,68882,68881,137763,21,0.100289,0.117161,909.166667,0,0
8510421,"Crissier, Chicorée",,0.000015,5,1,2,3,7244,10033,17277,17,0.13607,0.17425,105.827248,0,0
8582065,"Morrens VD, Grande Salle",,0.000041,10,1,1,2,8368,8367,16735,17,0.127053,0.155768,2059.5,0,0
8583748,"Villars-Ste-Croix, En Coulaye",,0.000021,5,2,2,4,19024,19023,38047,17,0.137319,0.177055,131.077248,0,0
8501210,"Lausanne, Bourdonnette",,0.000015,5,1,4,5,69089,132295,201384,37,0.052566,0.079978,2413.456119,0,0
8504652,"Echichens, village",,0.000011,5,0,2,2,0,29919,29919,37,0.050615,0.071554,0,0,0
8504656,"Romanel-sur-Morges, poste",,0.000011,5,0,2,2,0,9221,9221,37,0.050318,0.070323,0,0,0
8506410,"St-Prex, Pont Rouge",,0.000026,5,1,3,4,3747,6259,10006,37,0.050653,0.073098,5026,0,0
8506417,"Romanel-sur-M., Moulin-du-Choc",,0.000016,5,1,1,2,2134,2134,4268,37,0.050281,0.069616,0,0,0
8570069,"Morges, La Tour",,0.000091,5,8,2,10,53871,73095,126966,37,0.0506,0.071676,9995.727561,0,0
8570070,Marcelin (Morges),,0.000057,5,3,3,6,43852,44086,87938,37,0.050583,0.072049,3426.772439,0,0
8570072,"Monnaz, Tresy",,0.000034,5,1,3,4,5872,5897,11769,37,0.050539,0.072056,1448,0,0
8570080,"Apples, Hôtel de Commune",,0.000054,5,1,1,2,4962,4991,9953,37,0.050281,0.069616,7884,0,0
8570082,"Tolochenaz, La Plantaz",,0.000054,5,1,2,3,44219,44226,88445,37,0.050318,0.070323,28917,0,0
8570083,"Tolochenaz, pl. Audrey Hepburn",,0.00006,5,3,2,5,31520,31524,63044,37,0.05032,0.070915,197.111544,0,0
8591986,"Lausanne, Beau-Rivage",,0.000014,10,1,1,2,42409,42408,84817,18,0.106825,0.130186,77,0,0
8501211,"Chavannes-R., UNIL-Chamberonne",,0.000014,5,1,1,2,69088,69089,138177,27,0.077021,0.090037,46.525,0,0
8501212,"Chavannes-R., UNIL-Mouline",,0.000023,5,1,1,2,69089,69091,138180,26,0.083173,0.099137,345.525,0,0
8501213,"Ecublens VD, UNIL-Sorge",,0.00003,5,1,3,4,69091,102686,171777,25,0.090419,0.113065,642.525,0,0
8501214,"Ecublens VD, EPFL",,0.000019,5,1,2,3,67718,69421,137139,24,0.084486,0.10397,199.5,0,0
8530749,"Renens VD, gare",,0.00003,5,1,1,2,68884,67170,136054,16,0.107004,0.127748,30.5,0,0
8588845,"Crissier, Timonet",,0.000054,5,1,5,6,76837,76838,153675,16,0.146742,0.198805,1520.5,0,0
8501215,"Ecublens VD, Bassenges",,0.000019,5,1,1,2,68869,68884,137753,23,0.084059,0.095893,369.166667,0,0
8501216,"Ecublens VD, Cerisaie",,0.000027,5,1,1,2,68884,68882,137766,22,0.091445,0.105148,640.166667,0,0
8501218,"Ecublens VD, Epenex",,0.000044,5,2,2,4,99545,98994,198539,20,0.111067,0.134279,1228.916667,0,0
8501221,"Muraz (Collombey), Paquaire",,0.000011,103,0,1,1,0,4609,4609,18,0.108782,0.133979,0,0,0
8501448,Champéry,,0.00002,4,2,2,4,9248,9262,18510,7,0.23913,0.318615,660.5,0,0
8501452,St-Triphon-Gare,,0.000026,4,2,2,4,15835,15821,31656,6,0.259259,0.337302,670,0,0
8501458,Villy,,0.000044,4,3,1,4,16007,15993,32000,8,0.228571,0.305878,1342.5,0,0
8501258,La Forclaz VS,,0.000011,39,0,2,2,0,1826,1826,23,0.119539,0.150843,0,0,0
8501293,"La Sage, Villaz",,0.000016,39,1,2,3,1487,1487,2974,23,0.119356,0.15014,1,0,0
8501746,"Euseigne, village",,0.000011,39,0,1,1,0,2469,2469,23,0.119145,0.148427,0,0,0
8501747,Ferpècle,,0.000017,39,1,1,2,179,179,358,23,0.119145,0.148427,0,0,0
8501750,"Arolla, poste",,0.000011,39,0,1,1,0,1349,1349,23,0.119145,0.148427,0,0,0
8501260,Gilamont,,0.000025,4,1,1,2,24632,23262,47894,14,0.12605,0.221533,1785,0,0
8501262,Hauteville,,0.000032,4,1,1,2,23262,24632,47894,13,0.134615,0.232647,1680,0,0
8501263,Château-d'Hauteville,,0.000038,4,1,1,2,24632,24632,49264,12,0.144444,0.245119,1573,0,0
8501264,St-Légier-Village,,0.000043,4,1,1,2,24632,24632,49264,11,0.155844,0.259232,1464,0,0
8501265,La Chiésaz,,0.000048,4,1,1,2,24632,24632,49264,10,0.169231,0.275361,1353,0,0
8501266,Château-de-Blonay,,0.000051,4,1,1,2,24632,24632,49264,9,0.185185,0.294008,1240,0,0
8501267,"Orbe, poste",,0.000011,35,0,7,7,0,28585,28585,30,0.072782,0.104821,0,0,0
8501980,"Vuarrengel, Laiterie",,0.000011,35,0,1,1,0,5489,5489,30,0.07224,0.098179,0,0,0
8501981,"Grandson, Corcelettes",,0.000011,35,0,1,1,0,8847,8847,30,0.07224,0.098179,0,0,0
8502505,"Mauborget, Les Pièces",,0.000011,35,0,1,1,0,822,822,30,0.07224,0.098179,0,0,0
8504152,"Combremont-le-Grand, village",,0.000024,13,2,3,5,4780,7201,11981,36,0.073233,0.100107,6214.544444,0,0
8504159,"Sassel, village",,0.000025,13,2,5,7,5014,5014,10028,35,0.075693,0.104869,6382.366667,0,0
8504458,"Cheseaux-N., gymnase d'Yverdon",,0.000011,35,0,1,1,0,29529,29529,30,0.07224,0.098179,0,0,0
8504759,"Pailly, village",,0.00002,35,1,2,3,3912,3912,7824,30,0.072467,0.099374,1590,0,0
8503604,"Orbe, Taborneires",,0.000012,35,1,1,2,2363,4886,7249,45,0.045548,0.063574,0,0,0
8504774,"Yverdon-les-Bains, gare",,0.000069,35,8,20,28,53491,164208,217699,29,0.077816,0.11918,16911.51569,0,0
8507686,"Mathod, Bras d'Or",,0.000025,35,2,1,3,4540,4356,8896,46,0.043569,0.058703,244,0,0
8570246,"Orbe, Les Mosaïques",,0.000059,35,1,1,2,4455,4690,9145,22,0.109025,0.145892,1257,0,0
8570247,"Orbe, Montchoisi",,0.000062,35,2,2,4,15982,15852,31834,21,0.12178,0.176672,1439,0,0
8570200,"Chavornay, gare",,0.000032,35,1,3,4,4437,18421,22858,25,0.094119,0.123502,1068,0,0
8570237,"Orbe, collège",,0.000035,35,2,2,4,9583,9461,19044,43,0.049794,0.077013,2622,0,0
8570248,"Orbe, hôpital",,0.000039,35,2,5,7,21103,21077,42180,20,0.136724,0.217131,1601.611905,0,0
8577202,"Orbe, Chantemerle",,0.000017,35,1,1,2,5253,5142,10395,6,0.304348,0.37381,0,0,0
8579115,"Montcherand, haut du village",,0.000055,35,2,4,6,6155,6155,12310,6,0.343284,0.452174,365.666667,0,0
8579905,"L'Abergement, village",,0.000023,35,1,1,2,2006,2006,4012,6,0.304348,0.37381,0,0,0
8579906,"Ballaigues, Maillefer",,0.000066,35,3,2,5,5723,5723,11446,6,0.322581,0.403333,2990.333333,0,0
8579910,"Vallorbe, Eterpaz",,0.000103,35,1,3,4,9215,6779,15994,6,0.333333,0.452083,648,0,0
8579911,"Vallorbe, collège",,0.00004,35,1,2,3,794,755,1549,6,0.319149,0.415556,0,0,0
8579912,"Vallorbe, place de la Liberté",,0.000057,35,2,1,3,6463,2813,9276,6,0.304348,0.37381,0,0,0
8501268,"Colombier VD, poste",,0.000011,5,0,3,3,0,11464,11464,38,0.048363,0.066145,0,0,0
8501269,"Vullierens, village",,0.000014,5,1,4,5,9078,9078,18156,38,0.048334,0.06632,3,0,0
8504655,"Monnaz, village",,0.000014,5,1,3,4,844,5873,6717,38,0.048251,0.065408,1,0,0
8509379,"Cossonay-Ville, Chavannes",,0.000033,5,2,1,3,7421,7419,14840,38,0.048197,0.063881,2652,0,0
8510446,"Morges, Longeraie",,0.000018,5,2,1,3,12727,12733,25460,38,0.048197,0.063881,1,0,0
8510538,"Vullierens, Abbaye",,0.000017,5,2,1,3,1029,1029,2058,38,0.048197,0.063881,0,0,0
8507283,"Gollion, L'Arzillier",,0.000023,5,1,1,2,3025,3027,6052,39,0.046014,0.058518,1327,0,0
8501270,"Törbel, Furen",,0.000014,40,1,2,3,581,3214,3795,16,0.133663,0.237059,27,0,0
8571119,"Törbel, Ueberfeld",,0.000068,40,1,2,3,3140,3140,6280,8,0.261905,0.413745,165,0,0
8501271,"Saxé, Café des Amis",,0.000011,39,0,4,4,0,7623,7623,23,0.112769,0.143181,0,0,0
8501272,"Branson, village",,0.000013,39,1,1,2,7479,7220,14699,24,0.101208,0.120321,0,0,0
8501273,"Fully, Pont de la Louye",,0.000024,39,2,2,4,7256,7259,14515,23,0.112391,0.13993,527,0,0
8501274,"Fully, poste",,0.000024,39,2,1,3,7259,7268,14527,23,0.112201,0.138295,0,0,0
8501277,Lully VD,,0.000011,5,0,2,2,0,32362,32362,39,0.046567,0.063138,0,0,0
8501278,"Denens, Cigognes",,0.000016,5,1,1,2,8224,8224,16448,40,0.044108,0.055521,15.5,0,0
8501280,St-Légier-Gare,,0.000055,4,1,1,2,24632,24632,49264,8,0.204545,0.315873,1125,0,0
8501281,Blonay,,0.000057,4,1,1,2,24632,8883,33515,7,0.228571,0.341964,1008,0,0
8501282,Prélaz-sur-Blonay,,0.00006,4,1,1,2,8883,8925,17808,6,0.259259,0.37381,889,0,0
8501283,Tusinge,,0.000062,4,1,1,2,8925,8925,17850,5,0.3,0.413889,768,0,0
8501284,Les Chevalleyres,,0.000063,4,1,1,2,8925,7001,15926,4,0.357143,0.466667,645,0,0
8501285,Fayaux,,0.000065,4,1,1,2,7001,7001,14002,3,0.444444,0.541667,520,0,0
8501286,Ondallaz-L'Alliaz,,0.000066,4,1,1,2,7001,7001,14002,2,0.6,0.666667,393,0,0
8501287,Lally,,0.000067,4,1,2,3,7001,7001,14002,1,1,1,264,0,0
8501288,Les Pléiades,,0.000039,4,1,1,2,6005,6005,12010,1,1,1,0,0,0
8501289,"Duillier, centre communal",,0.000011,125,0,1,1,0,7047,7047,48,0.037215,0.047283,0,0,0
8501292,"Martigny, gare",,0.000044,39,3,6,9,7376,11491,18867,22,0.126141,0.168165,2100,0,0
8501294,"Leytron, anc. poste",,0.000017,39,1,6,7,7886,10490,18376,22,0.123969,0.165493,196.083333,0,0
8501983,"Saillon, Collombeyres",,0.000029,39,2,2,4,7574,7567,15141,22,0.133166,0.176592,683.452381,0,0
8501994,"Sion, poste/gare",,0.000104,39,11,15,26,31525,41365,72890,21,0.152956,0.230258,14618.488095,0,0
8504650,Mazembroz,,0.000035,39,3,4,7,7977,7623,15600,21,0.114066,0.165095,297.666667,0,0
8570702,"Vétroz, La Millière",,0.000081,39,4,4,8,10171,10643,20814,20,0.12236,0.179553,3245.166667,0,0
8570704,Ballavaud,,0.000035,39,1,5,6,9978,9978,19956,18,0.149013,0.218534,2146.5,0,0
8501328,"Ardon, centre",,0.000019,39,2,3,5,6871,9978,16849,21,0.135771,0.183469,2241.619048,0,0
8501736,"Saillon, les Bains",,0.000019,39,2,1,3,7497,7538,15035,23,0.117734,0.145583,1,0,0
8501334,"Ovronnaz, centre",,0.000013,39,1,3,4,2553,2553,5106,18,0.128535,0.177666,51,0,0
8571010,"Saillon, les Moilles",,0.000069,39,2,2,4,7542,7567,15109,19,0.123779,0.163958,1869.5,0,0
8571012,"Saillon, St-Laurent",,0.000045,39,1,2,3,7538,7537,15075,18,0.126689,0.17137,150,0,0
8571013,"Leytron, caves Provins",,0.000071,39,5,2,7,11004,8922,19926,18,0.138605,0.189496,2049.47619,0,0
8501296,"Coinsins, Auberge",,0.00002,125,1,1,2,7047,7048,14095,47,0.038632,0.050473,1745,0,0
8501297,"Riex, fontaine",,0.000011,13,0,1,1,0,3306,3306,25,0.077756,0.089281,0,0,0
8501298,"Daillens, village",,0.000011,5,0,1,1,0,3783,3783,30,0.066621,0.076584,0,0,0
8501299,"Penthaz, village",,0.000011,5,0,2,2,0,9932,9932,28,0.080942,0.103114,0,0,0
8505529,"Bussigny, St-Germain",,0.000011,5,0,2,2,0,15081,15081,30,0.067706,0.082806,0,0,0
8507540,"Cugy VD, Grillon",,0.000018,5,1,1,2,8368,8368,16736,28,0.07827,0.094304,3963.747177,0,0
8507628,"Romanel-sur-Lausanne, gare",,0.000011,5,0,2,2,0,320,320,28,0.078716,0.097123,0,0,0
8507655,"Bioley-Orjulaz, chapelle",,0.000011,5,0,1,1,0,3669,3669,28,0.07827,0.094304,0,0,0
8501302,Veytaux-Chillon,,0.00003,4,1,1,2,9628,9628,19256,32,0.070498,0.082745,2918,0,0
8501500,Martigny,,0.000087,4,5,7,12,36387,59265,95652,30,0.080246,0.102237,49327.724359,0,0
8501505,Ardon,,0.000046,4,1,1,2,17657,17643,35300,30,0.079745,0.098774,11244,0,0
8501301,Territet,,0.000023,4,1,1,2,9628,9628,19256,33,0.065877,0.07553,125,0,0
8501308,Glion-Collège,,0.000023,4,1,2,3,8757,9087,17844,10,0.19403,0.330433,1625,0,0
8501357,Haut-de-Caux,,0.000021,4,1,1,2,8600,7747,16347,10,0.181818,0.274636,0,0,0
8501324,"Gasenried, Chäschermatte",,0.000011,6,0,2,2,0,1753,1753,11,0.216667,0.31038,0,0,0
8501958,"St. Niklaus VS, Riedacker",,0.000038,6,1,1,2,557,557,1114,11,0.1875,0.261289,90,0,0
8501325,"St. Niklaus VS, Sand",,0.000016,6,1,2,3,557,618,1175,14,0.176056,0.295777,10,0,0
8501724,"St. Niklaus VS, Wichel",,0.000039,6,1,1,2,557,557,1114,14,0.159091,0.252909,63,0,0
8501326,"St. Niklaus VS, Zen-Achern",,0.000017,6,1,1,2,540,557,1097,17,0.119403,0.187561,6,0,0
8501327,"Arbaz, poste",,0.000011,39,0,2,2,0,2139,2139,23,0.119904,0.15174,0,0,0
8501739,Col-du-Sanetsch,,0.000011,39,0,3,3,0,118,118,23,0.119599,0.152973,0,0,0
8501756,"Savièse, Chandolin centre",,0.000014,39,1,1,2,29,29,58,23,0.118203,0.146747,0,0,0
8570742,"Savièse, Drône centre",,0.000068,39,2,2,4,1418,1435,2853,28,0.071343,0.095056,2521.5,0,0
8570770,"Sion, Brasserie",,0.000066,39,4,2,6,4887,4819,9706,28,0.071207,0.094816,960.5,0,0
8501332,"Nax, centre",,0.000011,39,0,3,3,0,2222,2222,22,0.138703,0.186478,0,0,0
8501342,"St-Léonard, centre",,0.000011,39,0,2,2,0,1895,1895,22,0.133148,0.176485,0,0,0
8501741,"Veysonnaz, station",,0.000016,39,1,4,5,1839,3019,4858,22,0.136351,0.184378,478,0,0
8501742,"Basse-Nendaz, village",,0.000011,39,0,2,2,0,1136,1136,22,0.13448,0.178809,0,0,0
8501770,"Les Haudères, centre",,0.000056,39,5,4,9,5644,5644,11288,22,0.134988,0.182132,2475,0,0
8501775,"Les Mayens-de-Sion, Ouest",,0.000023,39,1,1,2,2389,2507,4896,22,0.132906,0.174758,477,0,0
8501785,"Savièse, St-Germain centre",,0.00003,39,3,3,6,1494,1456,2950,22,0.13378,0.179116,1461,0,0
8501795,"Crans-s.-S., poste",,0.000041,39,4,4,8,9457,9461,18918,22,0.149249,0.199936,2608.35,0,0
8501859,"Chippis, poste",,0.000025,39,2,2,4,1464,10085,11549,22,0.138101,0.186054,544.5,0,0
8570701,"Vétroz, poste",,0.00006,39,1,1,2,9902,9902,19804,21,0.109598,0.145769,1014,0,0
8501329,"Gstaad, Wispile",,0.000011,42,0,1,1,0,3683,3683,18,0.10957,0.14546,0,0,0
8501330,"Leysin, place du Marché",,0.000011,36,0,3,3,0,932,932,7,0.276923,0.353505,0,0,0
8501345,Devant-de-l'Etivaz,,0.00003,36,1,2,3,841,841,1682,9,0.20625,0.289502,66,0,0
8501792,Col des Mosses,,0.000064,36,2,2,4,895,895,1790,7,0.26506,0.34816,170.5,0,0
8501799,"La Lécherette, village",,0.000038,36,1,3,4,841,841,1682,7,0.276316,0.388549,30.5,0,0
8501331,"Uvrier, sud",,0.000011,39,0,1,1,0,157,157,22,0.103437,0.143225,0,0,0
8502628,"Lens, place de la Scie",,0.000025,39,2,3,5,4111,4111,8222,22,0.124248,0.1692,1094.625,0,0
8570928,"Nax, Villettaz",,0.000043,39,1,1,2,2006,2006,4012,21,0.109037,0.146155,2492,0,0
8570929,Fontany,,0.000051,39,2,3,5,3490,4863,8353,20,0.121279,0.177169,2518,0,0
8501333,"Gland, Grand-Champ",,0.000011,32,0,2,2,0,6856,6856,9,0.158537,0.233776,0,0,0
8505428,"Gland, UICN",,0.000016,32,1,1,2,3424,3423,6847,9,0.153374,0.203127,0,0,0
8571014,"Riddes, gare",,0.000072,39,5,5,10,9304,11495,20799,17,0.143133,0.210502,1526.602381,0,0
8501341,"Albinenleitern, Flaschen",,0.000011,40,0,1,1,0,5986,5986,9,0.211921,0.259313,0,0,0
8501651,"Leuk, Stadt",,0.000037,40,1,5,6,30994,30994,61988,7,0.316239,0.429344,448,0,0
8501714,"Vercorin, poste",,0.000011,39,0,1,1,0,1049,1049,23,0.121567,0.151463,0,0,0
8501343,"Les Moulins, Les Chabloz",,0.000014,36,1,1,2,640,841,1481,11,0.152838,0.199867,2,0,0
8501344,"La Lécherette,cont.de la Borne",,0.000023,36,1,1,2,841,841,1682,10,0.175258,0.230987,35,0,0
8501346,"Les Mosses, église",,0.000027,36,2,2,4,831,831,1662,9,0.222222,0.30723,56,0,0
8501702,"Les Mosses, Les Charmilles",,0.000037,36,1,2,3,841,841,1682,9,0.19084,0.266587,68,0,0
8501347,"Les Moulins, village",,0.000035,36,2,3,5,841,1006,1847,9,0.194969,0.295264,67.5,0,0
8501348,"Les Moulins, Pont-de-Pierre",,0.000021,36,1,2,3,906,906,1812,10,0.185185,0.26955,32.5,0,0
8501349,"Les Moulins, La Rosettaz",,0.00003,36,2,2,4,879,879,1758,9,0.187097,0.265969,44,0,0
8507925,"Les Moulins, Les Crêts",,0.000069,36,3,2,5,940,941,1881,7,0.230769,0.330291,93,0,0
8507931,"L'Etivaz, four à pain",,0.000045,36,1,2,3,841,841,1682,6,0.307692,0.407292,59,0,0
8557099,"Leysin, Centres Sportifs",,0.000071,36,3,4,7,932,932,1864,5,0.394737,0.53,239.5,0,0
8501360,Montreux-Les Planches,,0.000038,4,2,1,3,8234,8727,16961,9,0.203704,0.298088,1397,0,0
8501361,Toveyre,,0.000043,4,1,1,2,8727,8757,17484,8,0.232558,0.330119,1280,0,0
8501362,Valmont,,0.000048,4,1,1,2,8757,8727,17484,7,0.272727,0.380688,1161,0,0
8501363,Le Tremblex,,0.000051,4,1,2,3,8727,8727,17454,6,0.333333,0.49375,1040,0,0
8501364,Les Echets,,0.000033,4,1,2,3,4708,4708,9416,5,0.388889,0.540476,655,0,0
8501369,Rochers-de-Naye,,0.000048,4,1,1,2,3977,3857,7834,2,0.666667,0.75,8,0,0
8501365,Crêt-d'y-Bau,,0.000025,4,1,1,2,4120,3857,7977,6,0.285714,0.408333,528,0,0
8501366,Paccot,,0.000032,4,1,1,2,3857,3857,7714,5,0.333333,0.456667,401,0,0
8501367,Jaman,,0.000038,4,1,1,2,3857,3977,7834,4,0.4,0.520833,272,0,0
8501368,La Perche,,0.000043,4,1,1,2,3977,3977,7954,3,0.5,0.611111,141,0,0
8501370,Glion,,0.000087,4,3,1,4,8464,8727,17191,1,1,1,137,0,0
8501374,Fontanivent,,0.000023,4,1,1,2,16503,16443,32946,46,0.03471,0.037472,5846,0,0
8501375,Chernex,,0.00003,4,1,1,2,16443,16263,32706,45,0.035944,0.038991,8298,0,0
8501376,Chamby,,0.000037,4,1,1,2,16263,16278,32541,44,0.03727,0.040718,10748,0,0
8501377,Les Avants,,0.000042,4,1,2,3,16278,15954,32232,43,0.038697,0.042831,13196,0,0
8501379,Les Sciernes,,0.000035,4,1,2,3,9865,9638,19503,42,0.040222,0.044623,2573,0,0
8501378,Allières,,0.000029,4,1,1,2,9565,9865,19430,43,0.038681,0.042343,129,0,0
8501380,Montreux-Collège,,0.000044,4,2,2,4,9568,9519,19087,42,0.040209,0.044543,15390,0,0
8501383,Planchamp,,0.000041,4,1,1,2,9133,9358,18491,42,0.040166,0.043881,5138,0,0
8501381,Vuarennes,,0.00003,4,1,1,2,9073,9133,18206,44,0.037206,0.040169,264,0,0
8501382,Châtelard VD,,0.000036,4,1,1,2,9133,9133,18266,43,0.038629,0.041909,2702,0,0
8501384,Sonzier,,0.00008,4,3,2,5,16263,16203,32466,41,0.04183,0.046253,30276,0,0
8501385,Sendy-Sollard,,0.000045,4,1,2,3,9298,9088,18386,40,0.043633,0.048551,31491,0,0
8501388,Les Combes,,0.000043,4,2,3,5,9163,9428,18591,40,0.043602,0.048753,865,0,0
8501386,Jor,,0.000064,4,2,1,3,9604,9790,19394,41,0.041804,0.045856,1089,0,0
8501390,Belmont-sur-Montreux,,0.00007,4,3,2,5,9165,2804,11969,39,0.04555,0.050663,40313,0,0
8501393,La Chaudanne-Les Moulins,,0.000058,11,1,1,2,9681,9666,19347,40,0.043539,0.047722,5126,0,0
8501394,Château-d'Oex,,0.000073,11,2,2,4,10137,10152,20289,39,0.045503,0.050529,9671,0,0
8501399,Gstaad,,0.000057,11,1,3,4,9428,13901,23329,39,0.04548,0.050675,10216,0,0
8501391,La Tine,,0.000053,11,2,1,3,9641,9651,19292,42,0.040081,0.043353,288,0,0
8501392,Rossinière,,0.000056,11,1,1,2,9651,9681,19332,41,0.041738,0.045395,2708,0,0
8501395,Les Granges-Gérignoz,,0.000042,11,1,1,2,9443,9428,18871,43,0.038535,0.041511,580,0,0
8501396,Flendruz,,0.000046,11,1,1,2,9428,9428,18856,42,0.040063,0.043343,2992,0,0
8501397,Rougemont,,0.00005,11,1,1,2,9428,9428,18856,41,0.041719,0.045394,5402,0,0
8501398,Saanen,,0.000054,11,1,1,2,9428,9428,18856,40,0.043518,0.047747,7810,0,0
8504070,Montbovon,,0.000088,11,3,2,5,10423,10680,21103,38,0.047569,0.052691,66411,0,0
8507270,Gruben,,0.000064,11,2,1,3,9553,11583,21136,25,0.076135,0.125184,2202.5,0,0
8501457,Monthey-Hôpital,,0.000034,4,1,2,3,9262,9262,18524,7,0.265625,0.373669,31,0,0
8501405,Vernayaz,,0.000023,4,1,2,3,17309,16804,34113,31,0.074449,0.090801,2842,0,0
8501421,Monthey,,0.000031,4,1,2,3,18829,17824,36653,31,0.074425,0.090771,3662,0,0
8501428,St-Gingolph (Suisse),,0.000051,4,1,1,2,9343,8459,17802,31,0.074309,0.090098,14170,0,0
8501447,Roches Grises,,0.000023,4,1,3,4,7502,7502,15004,7,0.316667,0.430326,1359,0,0
8501404,Evionnaz,,0.000014,4,1,1,2,17406,17309,34715,32,0.069313,0.081732,135,0,0
8501420,Massongex,,0.000024,4,2,1,3,18041,18829,36870,32,0.069293,0.081707,959,0,0
8501422,Collombey,,0.000024,4,1,1,2,9388,9388,18776,36,0.054259,0.059891,695,0,0
8501423,Vionnaz,,0.000031,4,1,1,2,9388,9388,18776,35,0.057352,0.063968,3394,0,0
8501424,Vouvry,,0.000038,4,1,1,2,9388,9388,18776,34,0.06082,0.068732,6091,0,0
8501425,Les Evouettes,,0.000043,4,1,1,2,9388,9175,18563,33,0.064736,0.0744,8786,0,0
8501426,Bouveret,,0.000047,4,1,1,2,9175,9343,18518,32,0.069192,0.081318,11479,0,0
8501446,Villars-sur-Ollon Golf,,0.000015,4,1,1,2,4107,7502,11609,8,0.25,0.315893,1474,0,0
8501491,Les Posses,,0.000031,4,1,1,2,7806,7806,15612,10,0.174419,0.249868,31,0,0
8501494,Arveyes,,0.000052,4,1,1,2,7738,7973,15711,7,0.272727,0.35496,58,0,0
8501453,La Cour,,0.000033,4,3,1,4,9395,9253,18648,7,0.232558,0.287976,1216.5,0,0
8501454,Fayot,,0.000039,4,1,2,3,9253,9239,18492,6,0.287879,0.364912,1100.5,0,0
8501464,Troistorrents,,0.000036,4,1,1,2,9262,9261,18523,6,0.285714,0.361667,38,0,0
8501456,Chemex,,0.000027,4,1,1,2,9101,9262,18363,8,0.219512,0.292725,151,0,0
8501459,St-Triphon-Village,,0.00005,4,2,2,4,19644,11975,31619,7,0.277778,0.391746,1228.5,0,0
8501460,Croix-du-Nant,,0.000047,4,2,2,4,7393,9262,16655,6,0.304348,0.421429,453.5,0,0
8501462,Collombey-Muraz,,0.000033,4,1,1,2,15821,15836,31657,6,0.26087,0.341667,6,0,0
8501461,Ollon VD,,0.000052,4,2,2,4,13844,15993,29837,7,0.282609,0.400733,569,0,0
8501726,Corbier,,0.000053,4,2,1,3,15688,15836,31524,7,0.25,0.370408,21,0,0
8501463,Monthey-Ville,,0.000059,4,2,2,4,16364,16363,32727,5,0.323529,0.437879,319.5,0,0
8501466,Champéry-Village,,0.00006,4,1,3,4,9253,9253,18506,4,0.5,0.635417,595.5,0,0
8501465,Val-d'Illiez,,0.000058,4,2,1,3,9399,9253,18652,5,0.36,0.438889,733.5,0,0
8530366,Pont du Rhône,,0.000077,4,1,1,2,15821,8720,24541,4,0.4,0.520833,22,0,0
8530430,Route de Morgins,,0.00009,4,1,1,2,9262,9262,18524,2,0.666667,0.75,11,0,0
8501468,Aigle-Château,,0.000018,4,1,2,3,7904,7611,15515,8,0.230769,0.339021,2394,0,0
8501469,Les Fontanelles,,0.000018,4,1,1,2,6701,6033,12734,8,0.220779,0.30014,0,0,0
8501470,Verschiez,,0.000034,4,2,2,4,6943,7594,14537,7,0.266667,0.386607,2160,0,0
8501471,Plambuit,,0.000025,4,1,3,4,7419,7649,15068,7,0.288462,0.43619,952,0,0
8501472,Exergillod,,0.000018,4,1,2,3,7480,7222,14702,7,0.27451,0.395918,0,0,0
8501473,Les Planches (Aigle),,0.000026,4,2,2,4,6780,7174,13954,7,0.288889,0.413553,690,0,0
8501479,Les Diablerets,,0.000037,4,1,2,3,8002,8002,16004,5,0.4,0.535417,22,0,0
8501485,Fontanney,,0.000054,4,1,2,3,10354,10354,20708,7,0.275862,0.449107,40,0,0
8501474,Le Sépey,,0.000022,4,1,1,2,7130,6365,13495,6,0.255319,0.338889,558.5,0,0
8501475,Les Echenards,,0.000029,4,1,2,3,6365,7727,14092,5,0.314286,0.433333,430.5,0,0
8517484,Aigle-Parc Aventure,,0.000049,4,1,1,2,7611,6701,14312,5,0.333333,0.456667,727.5,0,0
8501476,Les Aviolats,,0.000023,4,1,1,2,6813,8002,14815,7,0.25641,0.342619,288,0,0
8501477,Vers-l'Eglise,,0.000031,4,1,1,2,8002,8002,16004,6,0.310345,0.401852,156,0,0
8501480,Rennaz (Leysin),,0.000026,4,2,1,3,10368,10354,20722,11,0.175676,0.273324,665,0,0
8501481,Leysin-Village,,0.000033,4,1,1,2,10354,10354,20708,10,0.196721,0.306581,544,0,0
8501482,Leysin-Feydey,,0.000039,4,1,2,3,10354,10206,20560,9,0.22449,0.378391,421,0,0
8501483,Leysin-Grand-Hôtel,,0.000028,4,1,1,2,8144,8127,16271,9,0.208333,0.31623,0,0,0
8501484,Aigle-Dépôt,,0.000051,4,2,1,3,10189,10354,20543,8,0.236842,0.35754,169,0,0
8501554,Aigle-Place-du-Marché,,0.00009,4,6,2,8,18239,17263,35502,6,0.318182,0.492857,1016.5,0,0
8501487,Bex-Place-du-Marché,,0.000021,4,2,1,3,7267,7422,14689,10,0.183673,0.265101,1083,0,0
8501488,Bévieux,,0.000029,4,1,2,3,7422,7627,15049,9,0.2125,0.327334,964,0,0
8501727,La Clairière,,0.000077,4,2,2,4,7464,7748,15212,5,0.388889,0.540476,340,0,0
8501490,Fontannaz-Seulaz,,0.000023,4,1,1,2,7392,7806,15198,11,0.156863,0.232641,154,0,0
8501492,Gryon,,0.000044,4,2,1,3,7904,7963,15867,9,0.197183,0.272307,314,0,0
8501493,La Barboleuse,,0.000048,4,1,1,2,7963,7738,15701,8,0.22807,0.303938,187,0,0
8501495,Villars-sur-Ollon,,0.000061,4,2,2,4,11590,9707,21297,6,0.34375,0.465152,884,0,0
8501499,Col-de-Bretaye,,0.000047,4,1,1,2,7502,3885,11387,6,0.307692,0.410417,16,0,0
8501497,Col-de-Soud,,0.000037,4,1,1,2,6128,7502,13630,8,0.222222,0.316786,288,0,0
8501498,Bouquetins,,0.000042,4,1,1,2,7502,7502,15004,7,0.257143,0.35291,153,0,0
8501561,Vernayaz MC,,0.000021,4,1,1,2,7739,10255,17994,5,0.333333,0.420833,0,0,0
8501573,Martigny-Croix,,0.000029,4,1,1,2,8238,8238,16476,4,0.375,0.458333,6,0,0
8501575,Bovernier,,0.000046,4,2,1,3,8474,8519,16993,3,0.5,0.566667,10,0,0
8501501,Charrat-Fully,,0.000021,4,1,1,2,17099,17626,34725,34,0.060532,0.068013,584,0,0
8501502,Saxon,,0.000029,4,1,1,2,17626,17441,35067,33,0.06441,0.073473,3252,0,0
8501503,Riddes,,0.000036,4,1,1,2,17441,17598,35039,32,0.06882,0.080057,5918,0,0
8501504,Chamoson-St-Pierre-de-Clages,,0.000041,4,1,1,2,17598,17657,35255,31,0.073879,0.088219,8582,0,0
8501507,St-Léonard,,0.000021,4,1,1,2,18159,18135,36294,31,0.073794,0.088273,0,0,0
8501605,Visp,,0.000102,4,5,3,8,40525,70025,110550,29,0.086337,0.112009,30941,0,0
8501510,Châteauneuf-Conthey,,0.000029,4,2,2,4,17907,16816,34723,31,0.073757,0.088265,380,0,0
8501600,Salgesch,,0.000032,4,2,1,3,17068,17673,34741,31,0.073733,0.087939,0,0,0
8501515,"Feschel, Dorf",,0.000011,40,0,1,1,0,3212,3212,28,0.101723,0.135298,0,0,0
8501516,"Varen, Frayen",,0.000011,40,0,2,2,0,12876,12876,27,0.115344,0.15625,0,0,0
8501517,"Leuk, Abzw. Guttet",,0.00002,40,1,2,3,3212,20370,23582,27,0.112873,0.161551,306,0,0
8501519,"Leuk, Thel",,0.000027,40,1,2,3,6912,6912,13824,27,0.112343,0.159873,306,0,0
8501526,"Susten, Briannen",,0.000035,40,1,1,2,4447,4447,8894,27,0.112015,0.1571,909,0,0
8501527,"Susten, Gampinen",,0.000011,40,0,1,1,0,11507,11507,27,0.112015,0.1571,0,0,0
8501648,"Erschmatt, Dorf",,0.000035,40,1,1,2,3947,3947,7894,27,0.112015,0.1571,909,0,0
8501649,"Guttet, Dorf",,0.000023,40,1,1,2,3459,3459,6918,27,0.112015,0.1571,0,0,0
8501790,"Vissoie, poste",,0.000035,39,2,4,6,4804,7508,12312,18,0.126277,0.17507,1062.166667,0,0
8501518,"Leuk, Brentjong",,0.000019,40,1,1,2,6912,6912,13824,28,0.101295,0.134272,4,0,0
8501520,"Bratsch, Dorf",,0.000011,40,0,1,1,0,3947,3947,30,0.08453,0.104373,0,0,0
8501521,"Leuk, Rotafen",,0.00002,40,1,1,2,3947,3947,7894,29,0.092034,0.116579,305,0,0
8501522,"Leuk, Lichten",,0.000028,40,1,1,2,3947,3947,7894,28,0.10103,0.133069,608,0,0
8501523,"Susten, Durannen",,0.000011,40,0,1,1,0,4447,4447,30,0.08453,0.104373,0,0,0
8501524,"Susten, Ober Feithieren",,0.00002,40,1,1,2,4447,4447,8894,29,0.092034,0.116579,305,0,0
8501525,"Susten, Unter Feithieren",,0.000028,40,1,1,2,4447,4447,8894,28,0.10103,0.133069,608,0,0
8501528,"Praz-de-Fort, Branche en-Haut",,0.000011,104,0,1,1,0,955,955,9,0.194175,0.25621,0,0,0
8501529,"Orsières, Chez-les-Reuses",,0.000011,104,0,1,1,0,1395,1395,9,0.194175,0.25621,0,0,0
8501531,Issert,,0.00002,104,1,1,2,955,1271,2226,8,0.228916,0.301817,19,0,0
8501532,"Orsières, Prassurny",,0.00002,104,1,1,2,1395,1394,2789,8,0.228916,0.301817,19,0,0
8501534,Som-la-Proz,,0.000045,104,2,3,5,2665,2666,5331,7,0.28125,0.404233,72,0,0
8501884,La Fouly VS,,0.000024,104,1,1,2,955,995,1950,7,0.223881,0.29619,0,0,0
8501541,"Crans-s.-S., Scandia",,0.000011,39,0,1,1,0,11101,11101,25,0.114405,0.140659,0,0,0
8501542,"Crans-s.-S., téléphérique",,0.00002,39,1,4,5,11101,34203,45304,24,0.128923,0.170838,493,0,0
8501543,"Montana, Ycoor",,0.000015,39,1,8,9,27092,31122,58214,23,0.140131,0.18591,826,0,0
8501545,"Montana, Barzettes",,0.000013,39,1,5,6,14126,15662,29788,21,0.093315,0.159777,29.05,0,0
8501586,"Chermignon, d en Haut",,0.000027,39,1,2,3,8785,8785,17570,21,0.089467,0.135224,205.833333,0,0
8501587,"Crans-s.-S., Grand-Place",,0.000029,39,3,3,6,10757,10757,21514,20,0.096743,0.159607,483.016667,0,0
8570818,"Crans-s.-S., Le Pas de l'Ours",,0.000065,39,2,2,4,9461,9461,18922,12,0.170849,0.220501,3729.183333,0,0
8579409,"Sierre/Siders,Place de la gare",,0.000066,39,4,6,10,20983,20983,41966,19,0.103723,0.178888,1702.533333,0,0
8579410,"Sierre, Le Bourgeois",,0.000043,39,2,5,7,19148,19148,38296,20,0.098228,0.172598,3138.466667,0,0
8579471,"Montana, poste",,0.000071,39,1,3,4,24996,24996,49992,20,0.093207,0.157949,3439,0,0
8501588,"Miège, église",,0.000015,39,2,2,4,7485,11990,19475,20,0.094848,0.144337,98.283333,0,0
8501546,"Crans-s.-S., La Delége",,0.000011,39,0,2,2,0,4107,4107,23,0.13034,0.162745,0,0,0
8501599,"Montana, Centre Valaisan",,0.000013,39,1,1,2,4625,4625,9250,23,0.130103,0.160993,0,0,0
8501751,"Botyre (Ayent), centre",,0.000016,39,1,1,2,3872,3872,7744,23,0.130103,0.160993,0,0,0
8579456,"Veyras, Pontet",,0.00004,39,1,2,3,12198,12198,24396,24,0.072184,0.108258,1053,0,0
8510480,"Montana, Marigny",,0.000013,39,1,2,3,741,1481,2222,23,0.074743,0.108018,7.6,0,0
8579458,"Veyras, Muzot",,0.000036,39,1,4,5,23771,23771,47542,22,0.082605,0.134929,747.1,0,0
8579468,"Montana, Comba",,0.000058,39,1,1,2,11989,11989,23978,23,0.074013,0.100885,1435,0,0
8501547,"Chermignon, d en Bas",,0.000019,39,3,1,4,8580,8785,17365,22,0.082491,0.115322,6.833333,0,0
8501557,"Huémoz, poste",,0.000011,103,0,1,1,0,1734,1734,18,0.081448,0.114526,0,0,0
8501558,"Huémoz, Les Combes",,0.00002,103,1,1,2,1734,1734,3468,17,0.087028,0.11984,53,0,0
8501562,Salvan,,0.00004,4,2,2,4,12771,10246,23017,4,0.4375,0.559524,1029,0,0
8501563,Les Marécottes,,0.000028,4,1,2,3,7552,10246,17798,4,0.461538,0.597222,123.333333,0,0
8501564,Le Trétien,,0.00004,4,2,2,4,10868,9275,20143,3,0.555556,0.666667,617.833333,0,0
8501565,Finhaut,,0.00004,4,2,2,4,8923,9241,18164,3,0.571429,0.708333,102,0,0
8501566,Le Châtelard VS,,0.000045,4,2,2,4,9803,9241,19044,2,0.75,0.833333,350.166667,0,0
8501568,Le Châtelard-Frontière,,0.000047,4,2,1,3,8812,9241,18053,2,0.666667,0.75,1.666667,0,0
8501572,Martigny-Bourg,,0.000021,4,1,1,2,8283,8238,16521,5,0.304348,0.397619,146,0,0
8501576,Sembrancher,,0.000061,4,2,3,5,12245,24815,37060,2,0.8,0.875,596,0,0
8501577,La Douay,,0.000028,4,1,1,2,8238,8238,16476,1,1,1,0,0,0
8501579,Le Châble VS,,0.000028,4,1,1,2,12481,8755,21236,1,1,1,150,0,0
8501581,Lauenensee,,0.000011,42,0,1,1,0,1021,1021,17,0.119309,0.159858,0,0,0
8501585,"St. Niklaus VS, Rossen",,0.000026,6,1,1,2,557,557,1114,16,0.129944,0.201819,27,0,0
8501589,Mollens VS,,0.000019,39,2,1,3,11989,11989,23978,20,0.094412,0.139972,21.783333,0,0
8507446,"Sierre, Hôpital ouest",,0.000042,39,1,2,3,8785,8785,17570,20,0.097741,0.154159,477.666667,0,0
8570943,"Sierre, Beaulieu",,0.000052,39,3,3,6,20474,20474,40948,20,0.098458,0.161028,701.866667,0,0
8501597,"Montana, village",,0.000031,39,2,1,3,8785,8785,17570,22,0.082478,0.111988,93.666667,0,0
8501598,"Montana, Maison Général Guisan",,0.000037,39,1,1,2,8785,8785,17570,21,0.089445,0.128033,286.666667,0,0
8501602,Turtmann,,0.000036,4,1,1,2,17658,17673,35331,32,0.068639,0.079634,314,0,0
8501603,Gampel-Steg,,0.000041,4,1,1,2,17673,17673,35346,31,0.073671,0.087646,2954,0,0
8501636,Eyholz,,0.00004,4,1,4,5,12111,12478,24589,21,0.091418,0.159254,3475,0,0
8501950,Preglia,,0.000017,4,1,1,2,2836,2836,5672,24,0.09232,0.124899,0,0,0
8501797,"Gondo, Kirche",,0.000026,40,2,2,4,1615,1668,3283,23,0.10687,0.161888,1666,0,0
8501951,Varzo,,0.000031,4,2,1,3,5488,5488,10976,23,0.10081,0.141844,112,0,0
8501952,Iselle di Trasquera,,0.000055,4,3,3,6,5822,4830,10652,22,0.111111,0.171544,11532,0,0
8507471,Eggerberg,,0.000032,4,2,1,3,8103,8280,16383,22,0.088346,0.143234,0,0,0
8501634,Muttbach-Belvédère,,0.000011,28,0,1,1,0,144,144,35,0.043315,0.075178,0,0,0
8501635,Gletsch,,0.00002,28,1,1,2,144,202,346,34,0.044783,0.07983,91,0,0
8501671,Fürgangen-Bellwald Talstation,,0.000062,28,1,1,2,6660,6660,13320,23,0.069369,0.095376,924,0,0
8501689,Zermatt,,0.000063,4,1,2,3,36890,5369,42259,14,0.149451,0.201612,475,0,0
8501729,Fiesch Feriendorf,,0.000072,28,1,2,3,8056,8056,16112,16,0.118243,0.158662,1332,0,0
8505165,Andermatt,,0.000094,28,3,3,6,23096,13846,36942,13,0.17268,0.246084,6980.666667,0,0
8509179,Disentis/Mustér,,0.000146,28,4,6,10,17636,10769,28405,12,0.202166,0.313486,4729.666667,0,0
8579535,"Leuk, Abzw. Erschmatt",,0.000076,40,4,4,8,24317,24317,48634,6,0.404762,0.536275,218,0,0
8579539,"Leukerbad, Briggu",,0.00005,40,2,2,4,19444,19444,38888,6,0.371429,0.483333,91,0,0
8579541,"Guttet, Amarona",,0.000027,40,1,1,2,3459,3459,6918,6,0.333333,0.438889,0,0,0
8587880,"Leuk, Feriendorf Thel",,0.000031,40,1,1,2,3453,3453,6906,6,0.333333,0.438889,6.5,0,0
8501735,"Albinen, Tschingeren",,0.000021,40,1,1,2,13458,13458,26916,7,0.3,0.36627,16,0,0
8501992,"Guttet-Feschel, Wiler",,0.000026,40,1,1,2,3459,3459,6918,7,0.3,0.36627,18,0,0
8509487,"Leuk, Hewald",,0.000022,40,1,1,2,3453,3453,6906,7,0.3,0.36627,21,0,0
8501652,"Albinen, Dorf",,0.000026,40,2,2,4,9439,9439,18878,8,0.260504,0.332834,269,0,0
8501655,"Inden, Russengraben",,0.000033,40,1,1,2,13458,13458,26916,8,0.245902,0.297817,60,0,0
8501653,"Inden, Rumeling",,0.000017,40,1,1,2,13458,13458,26916,10,0.172973,0.212512,34,0,0
8501654,"Inden, Dorf",,0.000026,40,1,1,2,13458,13458,26916,9,0.202614,0.24456,48,0,0
8501656,"Leukerbad, Busterminal",,0.00005,40,2,4,6,19444,25784,45228,7,0.315217,0.413547,328,0,0
8579538,"Leukerbad, Birchen",,0.000034,40,1,1,2,13458,13458,26916,7,0.285714,0.357823,19,0,0
8594505,"Leukerbad, Diana",,0.000046,40,1,1,2,3171,3171,6342,5,0.333333,0.456667,20,0,0
8501660,"Gletsch, Post",,0.000011,108,0,3,3,0,448,448,19,0.118919,0.201686,0,0,0
8505549,Sidelenbach (Furka),,0.000014,108,1,1,2,257,257,514,19,0.114236,0.161456,0,0,0
8505899,Furka Passhöhe,,0.000047,108,2,3,5,384,384,768,17,0.138952,0.218118,297,0,0
8573147,"Realp, Post",,0.000044,108,2,2,4,257,257,514,4,0.421053,0.53125,512,0,0
8579361,"Obergesteln, Dorfplatz",,0.000059,108,2,1,3,448,448,896,4,0.4,0.46875,940,0,0
8501661,Oberwald,,0.000036,28,2,2,4,5708,6804,12512,33,0.046368,0.089644,2286,0,0
8501662,Obergesteln,,0.000026,28,1,1,2,6660,6660,13320,32,0.046537,0.073189,1716,0,0
8501663,Ulrichen,,0.000033,28,1,1,2,6660,6660,13320,31,0.048241,0.074834,1636,0,0
8501664,Geschinen,,0.000039,28,1,1,2,6660,6660,13320,30,0.050089,0.076615,1554,0,0
8501665,Münster VS,,0.000044,28,1,1,2,6660,6660,13320,29,0.052103,0.078551,1470,0,0
8501666,Reckingen VS,,0.000049,28,1,1,2,6660,6660,13320,28,0.054305,0.080669,1384,0,0
8501667,Gluringen,,0.000052,28,1,1,2,6660,6660,13320,27,0.056723,0.082999,1296,0,0
8501668,Biel (Goms),,0.000055,28,1,1,2,6660,6660,13320,26,0.059391,0.085578,1206,0,0
8501669,Blitzingen,,0.000058,28,1,1,2,6660,6660,13320,25,0.062352,0.088456,1114,0,0
8501670,Niederwald,,0.00006,28,1,1,2,6660,6660,13320,24,0.065657,0.091694,1020,0,0
8501672,Fiesch,,0.000072,28,2,1,3,7367,7823,15190,22,0.073572,0.09961,1962,0,0
8501673,Lax,,0.000072,28,1,1,2,7823,8056,15879,21,0.07837,0.104551,1862,0,0
8501674,Grengiols,,0.000072,28,1,1,2,8056,8056,16112,20,0.0839,0.110422,1760,0,0
8501675,Betten Talstation,,0.000072,28,1,1,2,8056,8056,16112,19,0.090347,0.11757,1656,0,0
8501676,Mörel,,0.000072,28,1,1,2,8056,8056,16112,18,0.097959,0.126596,1550,0,0
8501677,Bitsch,,0.000072,28,1,1,2,8056,8056,16112,17,0.107089,0.138778,1442,0,0
8501683,Stalden-Saas,,0.000048,4,2,1,3,14091,13859,27950,20,0.08371,0.10965,1039,0,0
8501684,Kalpetran,,0.000052,4,1,1,2,13859,13844,27703,19,0.090123,0.116429,950,0,0
8501685,St. Niklaus VS,,0.000055,4,1,1,2,13844,13844,27688,18,0.097693,0.124744,859,0,0
8501686,Herbriggen,,0.000058,4,1,1,2,13844,13859,27703,17,0.106767,0.135257,766,0,0
8501687,Randa,,0.00006,4,1,1,2,13859,13859,27718,16,0.117845,0.149138,671,0,0
8501688,Täsch,,0.000062,4,1,1,2,13859,36890,50749,15,0.131679,0.168813,574,0,0
8505119,Göschenen,,0.000035,28,2,3,5,8281,23787,32068,26,0.082856,0.143098,8137.666667,0,0
8505164,Hospental,,0.000055,28,1,1,2,10644,10644,21288,14,0.149123,0.194259,1408,0,0
8501700,Bains-de-l'Etivaz,,0.000024,36,1,1,2,841,841,1682,11,0.146739,0.199266,34,0,0
8501701,"L'Etivaz, Le Bouraz",,0.000031,36,1,1,2,841,841,1682,10,0.165605,0.222665,52,0,0
8501758,"La Comballaz, centre",,0.000038,36,2,2,4,831,831,1662,8,0.224299,0.304315,102,0,0
8501748,"Rothwald, Schutzhaus",,0.00002,40,1,1,2,1615,1615,3230,25,0.116388,0.166552,223,0,0
8501753,"Brig, Bahnhof",,0.000033,40,2,9,11,3130,39195,42325,24,0.131128,0.217573,3019.133333,0,0
8501999,"Brigerbad, Thermalbad",,0.000014,40,1,2,3,1078,1307,2385,17,0.141427,0.182384,24,0,0
8501990,"Agarn, Dorf",,0.000042,40,2,7,9,15954,15954,31908,15,0.191453,0.290285,816.933333,0,0
8505721,"Visp, Litterna",,0.000039,40,3,2,5,5167,5042,10209,15,0.182886,0.240276,266.378788,0,0
8510352,"Glis, Pfarreiheim",,0.000043,40,3,3,6,13283,13394,26677,15,0.196721,0.266814,463.127273,0,0
8557146,"Baltschieder, Hofmatte",,0.000026,40,2,2,4,373,1842,2215,15,0.172468,0.229041,162,0,0
8571021,"Visp, Spital",,0.000036,40,3,1,4,2693,2693,5386,15,0.171157,0.221902,162,0,0
8571049,"Zeneggen, Bänna",,0.00005,40,1,5,6,2624,2478,5102,15,0.174298,0.246704,596,0,0
8571062,"Bürchen, Zenhäusern",,0.000067,40,2,2,4,3529,3508,7037,15,0.173077,0.229012,1439,0,0
8571065,"Bürchen, Station",,0.000049,40,1,2,3,3159,3161,6320,15,0.174847,0.231715,409,0,0
8571067,"Bürchen, Egga",,0.000076,40,2,3,5,1234,1234,2468,15,0.175,0.237043,824,0,0
8571071,"Bürchen, Rest. Panorama",,0.000048,40,1,1,2,1016,1016,2032,15,0.171157,0.221902,324,0,0
8571075,"Visp, Bahnhof Süd",,0.000211,40,11,8,19,15758,22345,38103,14,0.204589,0.304703,5103.248485,0,0
8501718,"Stalden VS, Stahlen",,0.000017,40,1,1,2,3142,3142,6284,23,0.079511,0.15043,30,0,0
8501721,"St. Niklaus VS, Bodmen",,0.000033,6,1,1,2,557,557,1114,15,0.142857,0.221662,46,0,0
8530523,La Ruaz,,0.000064,4,1,1,2,7407,7187,14594,2,0.666667,0.75,12,0,0
8501733,Changins,,0.000028,125,1,2,3,7048,7048,14096,46,0.040161,0.054633,3488,0,0
8501850,"Bassins, Tillette",,0.000023,125,1,1,2,6926,7123,14049,46,0.040139,0.05409,0,0,0
8501734,"Montricher, village",,0.000011,33,0,3,3,0,7450,7450,7,0.333333,0.507738,0,0,0
8501892,"Berolle, église",,0.000014,33,1,2,3,3456,3387,6843,8,0.255814,0.398593,0.5,0,0
8507533,"Montricher,Fondation Michalski",,0.00002,33,2,2,4,3251,3253,6504,7,0.30303,0.459286,5,0,0
8570111,"Montricher, gare",,0.000025,33,2,1,3,4062,4061,8123,7,0.28125,0.399206,4.5,0,0
8501737,"Miex, Le Flon",,0.000011,103,0,2,2,0,1147,1147,11,0.179412,0.232879,0,0,0
8570590,"Chessel, village",,0.000048,103,1,2,3,4875,4875,9750,12,0.175793,0.234948,559,0,0
8570593,"Vouvry, poste",,0.000036,103,2,1,3,5285,5285,10570,11,0.176991,0.220094,553,0,0
8501738,"Moiry VS, barrage",,0.000011,39,0,2,2,0,747,747,20,0.103035,0.133396,0,0,0
8501791,"Zinal, centre",,0.000017,39,1,1,2,302,302,604,6,0.276923,0.338889,7.833333,0,0
8501798,"Savièse, Granois",,0.00002,39,1,1,2,59,59,118,13,0.168,0.260619,63,0,0
8501740,"Veysonnaz, bif. Clèbes",,0.000011,39,0,2,2,0,3133,3133,23,0.120301,0.151547,0,0,0
8570875,"Veysonnaz, La Fantanette",,0.000074,39,3,5,8,2172,2171,4343,20,0.138833,0.197388,2236.333333,0,0
8570884,"Les Agettes, garage",,0.000041,39,2,3,5,2674,2716,5390,20,0.135709,0.185816,196,0,0
8582711,"Sion, Tourbillon",,0.000142,39,5,5,10,8546,5923,14469,2,0.727273,0.8125,2390,0,0
8583738,"Baar (Nendaz), La Mury",,0.000035,39,1,1,2,1087,484,1571,1,1,1,0,0,0
8570858,"Brignon (Nendaz), Château",,0.000035,39,1,1,2,1087,1087,2174,22,0.109948,0.136774,459,0,0
8570855,"Salins, Arvillard",,0.000043,39,1,4,5,4085,4085,8170,21,0.125147,0.172786,1504,0,0
8570873,"Beuson (Nendaz), bif.Veysonnaz",,0.000044,39,2,2,4,1207,1207,2414,21,0.122941,0.161872,646.166667,0,0
8570840,"Aproz, village",,0.00008,39,1,2,3,7064,1232,8296,5,0.323529,0.437879,544,0,0
8570844,"Fey (Nendaz), village",,0.000056,39,1,3,4,1198,1198,2396,3,0.538462,0.666667,72,0,0
8570845,"Fey (Nendaz), Crevey",,0.000027,39,1,2,3,461,461,922,3,0.5,0.611111,0,0,0
8501745,"Mayens-de-l'Ours, télécabine",,0.000014,39,1,1,2,1215,2389,3604,23,0.117531,0.14477,2,0,0
8501786,"Simplon Kulm, Bellevue",,0.000014,40,1,1,2,796,796,1592,24,0.09733,0.136783,0,0,0
8505709,"Brigerbad, Dorf",,0.000017,40,1,3,4,1157,1157,2314,16,0.161808,0.216922,68.812121,0,0
8505712,"Eyholz, Heechriz",,0.000025,40,3,2,5,3666,4043,7709,16,0.157001,0.19884,73.687879,0,0
8505717,"Glis, Dorf",,0.000029,40,3,2,5,8613,8724,17337,16,0.16692,0.213361,46.663636,0,0
8571158,"Gamsen, Dorf",,0.000043,40,1,4,5,4149,4149,8298,9,0.263889,0.372285,98.5,0,0
8578548,"Brig, Stadtplatz",,0.000023,40,1,1,2,3829,3829,7658,10,0.202247,0.248986,36,0,0
8578550,"Glis, Saltina",,0.00013,40,7,5,12,11600,11606,23206,9,0.270073,0.392707,7888.5,0,0
8501755,"Chandolin, poste",,0.000011,39,0,1,1,0,2468,2468,20,0.101444,0.122795,0,0,0
8501757,"Chexbres, poste",,0.00002,13,1,2,3,3306,2276,5582,24,0.084151,0.099562,523,0,0
8510004,"Cully, Hôpital de Lavaux",,0.000011,13,0,3,3,0,717,717,21,0.110263,0.135142,0,0,0
8570440,"Palézieux, gare",,0.000132,13,7,13,20,34489,32451,66940,19,0.13966,0.194545,27765.471115,0,0
8501763,"L'Etivaz, Maison de L'Etivaz",,0.000043,36,2,1,3,841,841,1682,8,0.216981,0.274068,40.5,0,0
8501761,"Erde, centre",,0.000011,38,0,1,1,0,2241,2241,5,0.333333,0.456667,0,0,0
8501768,"Grimentz, place du Mélèze",,0.000016,39,1,2,3,358,2770,3128,19,0.11285,0.145376,256,0,0
8501779,"St-Luc, poste",,0.00002,39,1,1,2,2468,2336,4804,19,0.112485,0.142245,273,0,0
8501769,"Gsteig b. Gstaad, Post",,0.00002,42,1,1,2,3683,3683,7366,17,0.121495,0.166443,78,0,0
8501784,"La Sage, village",,0.000023,39,1,2,3,1487,2974,4461,4,0.4375,0.559524,18,0,0
8501771,"Feutersoey, Dorf",,0.000028,42,1,2,3,3683,3683,7366,16,0.136525,0.202657,154,0,0
8501774,"Lauenen b. Gstaad, Moos",,0.00002,42,1,1,2,1021,2785,3806,16,0.13369,0.188061,75,0,0
8501977,"Turbach, Post",,0.000011,42,0,1,1,0,2214,2214,16,0.13369,0.188061,0,0,0
8501978,"Les Diablerets, poste",,0.00003,42,1,1,2,1970,1945,3915,16,0.13369,0.188061,75,0,0
8501777,"Panex, anc. poste",,0.000011,103,0,1,1,0,324,324,13,0.121588,0.15444,0,0,0
8501778,"Les Plans-sur-Bex, village",,0.000011,103,0,1,1,0,352,352,13,0.137056,0.169247,0,0,0
8501780,"Saas-Almagell, Dorfplatz",,0.000011,41,0,2,2,0,5599,5599,6,0.3,0.393333,0,0,0
8501783,"Saas-Grund, Post",,0.000016,41,1,2,3,5279,5327,10606,6,0.318182,0.419048,1.833333,0,0
8501960,Mattmark,,0.000022,41,2,2,4,1627,1597,3224,5,0.371429,0.464103,15.166667,0,0
8570917,"La Sage, Plan de Boë",,0.000032,39,2,1,3,1480,1826,3306,4,0.4,0.486111,18,0,0
8570739,"Savièse, Roumaz",,0.000034,39,1,2,3,1049,1046,2095,29,0.067261,0.090377,100,0,0
8501787,"Trient, Betty",,0.000017,39,1,1,2,832,1063,1895,11,0.157895,0.193842,168.75,0,0
8505680,"Grimentz, Le Boccard",,0.000038,39,3,3,6,747,747,1494,5,0.361702,0.469608,92.166667,0,0
8501793,"Col-du-Pillon, Glacier 3000",,0.000023,42,1,1,2,1970,1970,3940,17,0.119309,0.159858,3,0,0
8570815,"Crans-s.-S., Pirraparc",,0.000036,39,1,1,2,4109,4111,8220,15,0.114431,0.131664,3099,0,0
8570817,"Crans-s.-S., Zier-Régent",,0.000054,39,1,1,2,8736,8736,17472,13,0.146623,0.176613,3319,0,0
8501974,"Leysin-Feydey, gare",,0.000052,36,3,2,5,932,932,1864,6,0.3125,0.396667,162,0,0
8501975,"Le Sépey, gare",,0.000044,36,2,2,4,995,995,1990,6,0.316667,0.404386,13,0,0
8507221,"Château-d'Oex, Granges d'Oex",,0.000033,36,2,1,3,100,99,199,8,0.195876,0.266855,53,0,0
8501851,"Begnins, poste",,0.000042,125,2,3,5,7245,11760,19005,45,0.041794,0.059444,6968,0,0
8501852,"Burtigny, village",,0.000023,125,1,2,3,3790,3790,7580,44,0.042521,0.0566,3510,0,0
8501856,"Le Vaud, place du Battoir",,0.00004,125,2,2,4,10791,10789,21580,23,0.07904,0.115075,512,0,0
8501853,"Longirod, village",,0.000033,125,2,1,3,7244,7245,14489,44,0.042498,0.056058,3510,0,0
8501854,"Marchissy, village",,0.000048,125,2,2,4,10913,10912,21825,43,0.044359,0.061249,10493,0,0
8570013,"Begnins, Charbonnier",,0.000058,125,2,4,6,11685,11685,23370,8,0.21547,0.319383,365,0,0
8501857,"Vich, poste",,0.000049,125,3,2,5,11683,11685,23368,22,0.085481,0.134009,3331,0,0
8501970,"Signy, village",,0.000034,125,1,1,2,10288,10289,20577,22,0.084192,0.12485,836,0,0
8502812,"Prangins, Les Clos",,0.000011,125,0,1,1,0,13932,13932,22,0.084192,0.12485,0,0,0
8507318,"Prangins, Musée national",,0.000011,125,0,1,1,0,13490,13490,22,0.084192,0.12485,0,0,0
8570011,"Coinsins, Les Vettanes",,0.000031,125,1,1,2,7048,7048,14096,9,0.180995,0.239038,180,0,0
8501860,"Essertines-sur-Rolle, village",,0.000028,32,1,1,2,3988,3988,7976,12,0.144397,0.170364,134,0,0
8501863,"St-Oyens, église",,0.000035,32,1,1,2,3988,3989,7977,11,0.166247,0.196062,198,0,0
8501864,Col-de-la-Forclaz,,0.000025,39,1,1,2,1063,1063,2126,10,0.183594,0.228166,210.75,0,0
8501865,"Aubonne, Bougy-St-Martin",,0.000038,32,3,3,6,7083,11324,18407,41,0.044009,0.062487,15400,0,0
8501868,"Aubonne, La Levette",,0.000029,32,1,1,2,11640,11640,23280,41,0.043933,0.060474,1398,0,0
8570021,"Gimel, Le Signal",,0.000042,32,1,1,2,4593,4593,9186,8,0.244898,0.313244,48,0,0
8570045,"Aubonne, Curzilles",,0.000036,32,1,1,2,2174,2174,4348,8,0.244898,0.313244,69,0,0
8501867,"Aubonne, La Praz",,0.000022,32,1,1,2,9559,11640,21199,42,0.042113,0.055236,12,0,0
8504653,"Lavigny, café",,0.000031,5,2,3,5,8529,13819,22348,39,0.046109,0.060688,21173.5,0,0
8570041,"Perroy, Vinicole",,0.000049,32,1,1,2,4562,4562,9124,10,0.21,0.279157,103,0,0
8570046,"Aubonne, hôpital",,0.000113,32,5,5,10,11323,10836,22159,7,0.310811,0.448965,510,0,0
8570127,"Gimel, bas du village",,0.000066,32,3,2,5,12334,12333,24667,6,0.291667,0.371429,336,0,0
8501871,"Montherod, village",,0.000017,32,1,1,2,8346,8346,16692,11,0.166247,0.196062,75,0,0
8501872,"Gimel, Le Prunier",,0.000026,32,1,1,2,8346,6953,15299,10,0.196375,0.236007,125,0,0
8501873,"Mont-sur-Rolle, Les Granges",,0.00004,32,1,1,2,3989,3989,7978,10,0.196375,0.236007,260,0,0
8501880,"Bourg-St-Pierre, Commune",,0.000011,104,0,1,1,0,1081,1081,6,0.232558,0.318333,0,0,0
8501882,"Champex, Lac",,0.000024,104,1,1,2,1395,1351,2746,4,0.333333,0.40625,40,0,0
8501886,Liddes,,0.00002,104,1,1,2,1081,1095,2176,5,0.272727,0.353704,9,0,0
8501887,Praz-de-Fort,,0.000044,104,2,2,4,1311,1271,2582,6,0.269231,0.366667,49,0,0
8504673,Prayon,,0.00003,104,1,1,2,955,955,1910,6,0.254902,0.317949,0,0,0
8501890,"Morgins, poste",,0.000045,103,1,1,2,620,620,1240,14,0.114155,0.175422,125,0,0
8501894,"St-Loup, hôpital",,0.000011,5,0,2,2,0,4210,4210,10,0.231884,0.375769,0,0,0
8570109,"Cossonay-Ville, centre",,0.000105,5,4,7,11,19056,24116,43172,29,0.07238,0.092912,80478.5,0,0
8570129,"Cossonay-Penthalaz, gare",,0.000075,5,4,7,11,22772,23685,46457,28,0.076734,0.095389,88458.666667,0,0
8570141,"Eclépens, collège",,0.000044,5,1,1,2,4223,4223,8446,10,0.192982,0.311724,44,0,0
8501895,"Binn, Dorf",,0.000011,16,0,1,1,0,1789,1789,7,0.252874,0.311797,0,0,0
8501896,"Ernen, Dorfplatz",,0.00002,16,1,3,4,1789,4571,6360,6,0.323077,0.425397,21,0,0
8505744,"Binn, Langthal",,0.000032,16,1,2,3,1789,1789,3578,6,0.3,0.415278,24,0,0
8501897,Nufenen Passhöhe,,0.000011,108,0,4,4,0,634,634,19,0.100685,0.148029,0,0,0
8505798,Ronco (Bedretto),,0.000013,108,1,1,2,389,3457,3846,19,0.09377,0.114357,0,0,0
8575695,Cruina,,0.000054,108,1,1,2,514,388,902,5,0.310345,0.383333,1044,0,0
8579362,"Oberwald, Bahnhof",,0.000096,108,4,3,7,705,705,1410,3,0.583333,0.690476,1186,0,0
8501898,"Fieschertal, Dorfplatz",,0.000011,16,0,1,1,0,3206,3206,3,0.428571,0.5,0,0,0
8578899,"Ernen, Aragon",,0.000046,16,2,2,4,2827,2827,5654,3,0.466667,0.571429,45,0,0
8579346,"Lax, Bahnhof",,0.000031,16,1,1,2,288,288,576,3,0.428571,0.5,0,0,0
8501899,"Sanetsch, barrage",,0.000031,39,2,3,5,118,118,236,12,0.192308,0.340161,100,0,0
8570743,"Savièse, Crettaz",,0.00002,39,1,1,2,30,30,60,18,0.101604,0.187243,0,0,0
8570766,Dorbagnon,,0.000067,39,1,1,2,59,59,118,6,0.28,0.385714,84,0,0
8501956,"St. Niklaus VS, Bord",,0.00005,6,2,2,4,635,618,1253,13,0.18018,0.31734,105,0,0
8501988,Niedergrächen,,0.000052,6,1,2,3,1743,1825,3568,9,0.262295,0.395561,121,0,0
8579923,"St. Niklaus VS, Meiggern",,0.000042,6,2,1,3,557,557,1114,3,0.428571,0.5,24,0,0
8501957,"St. Niklaus VS, Flieltinen",,0.000032,6,1,1,2,540,557,1097,12,0.165217,0.23438,79,0,0
8505736,"Saas-Grund, Unter den Bodmen",,0.000027,41,2,3,5,5297,5327,10624,5,0.4,0.523611,12.666667,0,0
8501961,"Simplon Dorf, Post",,0.000037,40,2,2,4,1620,1665,3285,16,0.153846,0.217573,10858,0,0
8505711,Engeloch VS,,0.000044,40,1,1,2,1615,1615,3230,16,0.147583,0.196659,174,0,0
8501962,"Simplon Hospiz, Hospiz",,0.000027,40,1,1,2,1615,1615,3230,19,0.106457,0.138722,567,0,0
8571044,"Visp, Albe",,0.000042,40,1,2,3,4598,4598,9196,18,0.121929,0.153659,882,0,0
8571047,Zenstadlen,,0.000038,40,1,1,2,2406,2406,4812,17,0.131004,0.160165,288,0,0
8501966,"Chéserex, poste",,0.000011,125,0,1,1,0,10198,10198,25,0.067977,0.089732,0,0,0
8501967,"Gingins, poste",,0.00002,125,1,2,3,10198,10215,20413,24,0.072719,0.101682,338,0,0
8579314,"Crassier, Ancienne Gare",,0.000032,125,1,2,3,10674,21041,31715,23,0.068966,0.096085,1095.416667,0,0
8501968,"Grens, village",,0.000019,125,1,1,2,10189,10199,20388,24,0.072442,0.095064,170,0,0
8501969,"Signy, Le Glassey",,0.000027,125,1,1,2,10199,10288,20487,23,0.077868,0.106993,504,0,0
8501971,"Torgon, La Jorette",,0.000011,103,0,1,1,0,1469,1469,22,0.097561,0.146557,0,0,0
8504473,"Collombey, Barme",,0.000019,103,1,2,3,4609,4609,9218,19,0.141522,0.189197,264,0,0
8504501,"Monthey, Les Ilettes",,0.000027,103,1,2,3,2238,2238,4476,19,0.155922,0.213749,260,0,0
8501979,"Flanthey, poste",,0.000011,39,0,2,2,0,1453,1453,19,0.091258,0.119525,0,0,0
8570810,"Lens, Lyron-Biollaz",,0.000036,39,1,1,2,3980,3980,7960,19,0.091127,0.115578,2521,0,0
8570811,"Lens, poste",,0.000053,39,3,4,7,5630,5630,11260,18,0.099736,0.137772,3536.041667,0,0
8501984,"Törbel, Kirche",,0.000025,40,1,1,2,3142,3142,6284,22,0.083056,0.155152,53,0,0
8501986,"Gasenried, alte Post",,0.000048,6,2,1,3,1753,1743,3496,10,0.217949,0.304645,114,0,0
8501989,Rittinen,,0.000033,6,1,2,3,547,557,1104,8,0.263158,0.375635,99,0,0
8579324,"Herbriggen, Bahnhof",,0.00002,6,1,2,3,276,414,690,6,0.319149,0.415556,15,0,0
8579916,"St. Niklaus VS, Altersheim",,0.000039,6,1,2,3,552,554,1106,6,0.309524,0.412821,99,0,0
8571074,"St. German, Dorfplatz",,0.000011,40,0,3,3,0,5376,5376,8,0.293651,0.371203,0,0,0
8571128,"Gampel-Steg, Bahnhof",,0.000019,40,2,2,4,5190,7328,12518,9,0.233766,0.308245,44.333333,0,0
8571129,"Steg VS, Feldegg",,0.000041,40,2,3,5,9795,12785,22580,8,0.248227,0.335816,498.333333,0,0
8571132,"Steg VS, Industriezone",,0.000028,40,1,1,2,2749,2749,5498,10,0.20915,0.268738,34,0,0
8579546,"Ergisch, Dorf",,0.000036,40,2,2,4,3128,3154,6282,7,0.25,0.338221,57,0,0
8579554,"Gampel, Talstation LGJ",,0.00006,40,4,3,7,14141,14581,28722,9,0.256198,0.359268,315.416667,0,0
8580751,"Gampel, Schulhaus",,0.000108,40,7,5,12,9576,9388,18964,5,0.392157,0.514167,1111.5,0,0
8583664,"Visp, West",,0.000037,40,2,5,7,7039,7039,14078,4,0.44186,0.552632,502.333333,0,0
8509237,"Susten, St. Josef",,0.000016,40,1,1,2,4448,4448,8896,6,0.27907,0.352778,0,0,0
8587318,"Turtmann, Seilbahn LTUO",,0.000073,40,5,3,8,8840,8738,17578,6,0.310345,0.42037,242.733333,0,0
8587319,"Turtmann, Soleil",,0.000071,40,4,2,6,7057,3963,11020,6,0.298246,0.386275,92.7,0,0
8587835,"Gampel, Burketen",,0.000083,40,1,4,5,7487,7487,14974,4,0.466667,0.583333,41,0,0
8587837,"Niedergesteln, Wannumoos",,0.000088,40,4,4,8,5246,4832,10078,4,0.5,0.618056,166.716667,0,0
8501991,"Guttet, Grächmatten",,0.000017,40,1,1,2,3459,3459,6918,8,0.240506,0.295677,17,0,0
8504676,"Dixence, Le Chargeur",,0.000017,39,1,1,2,552,552,1104,22,0.106775,0.130437,0,0,0
8570695,"Sion, Carrefour Ouest",,0.000024,39,2,2,4,5815,5825,11640,25,0.081494,0.107742,59.5,0,0
8570737,"Savièse, Ormône",,0.000045,39,1,1,2,1046,1046,2092,30,0.06332,0.081357,1231,0,0
8504685,Mâche,,0.000045,39,2,1,3,3297,3216,6513,20,0.133609,0.175042,582,0,0
8509642,"Les Collons, Les Thermes",,0.000039,39,1,2,3,1383,1383,2766,20,0.141606,0.190948,942,0,0
8570827,"Sion, Carrefour de Platta",,0.000052,39,3,4,7,9979,9959,19938,20,0.137609,0.195975,3612.333333,0,0
8570883,"Les Agettes, contour du Pêchot",,0.00006,39,1,3,4,2998,2998,5996,20,0.136208,0.187395,1393,0,0
8570887,"Les Agettes, Crételannaz",,0.000049,39,1,2,3,2507,2507,5014,20,0.134205,0.179273,446,0,0
8570888,"Les Agettes, bif. M.-de-l'Ours",,0.000032,39,1,1,2,2389,2389,4778,20,0.133609,0.175042,0,0,0
8570889,"Sion, Pont-du-Rhône",,0.000171,39,9,6,15,21725,35057,56782,19,0.153418,0.225502,11037,0,0
8570924,"Bramois, Petit-Champsec",,0.00005,39,2,2,4,9658,9658,19316,15,0.157841,0.208586,2679,0,0
8579389,"Sion, St-Guérin",,0.000061,39,3,3,6,14789,14388,29177,15,0.179632,0.241911,3338.833333,0,0
8579429,"Grône, pramagnon",,0.000039,39,1,1,2,7184,7184,14368,15,0.166667,0.215131,1659,0,0
8579431,"St-Léonard, Le Lac",,0.00003,39,1,1,2,1480,1480,2960,15,0.166667,0.215131,924,0,0
8501996,"Sierre/Siders, gare",,0.000039,39,4,11,15,20708,53357,74065,17,0.13548,0.201851,5810.333333,0,0
8505682,"Brie, bif. Chippis",,0.000014,39,1,1,2,1064,1049,2113,19,0.098346,0.115014,0,0,0
8505683,"Chalais, poste",,0.000026,39,2,1,3,8233,8248,16481,18,0.108591,0.129763,225,0,0
8505684,"Chalais, téléphérique",,0.000036,39,2,2,4,9741,26275,36016,17,0.121278,0.151985,3684.833333,0,0
8570945,"Chippis, maison bourgeoisiale",,0.000073,39,2,4,6,10492,10492,20984,18,0.128611,0.186019,1877.5,0,0
8570946,"Chalais, Les Noyers",,0.000026,39,1,2,3,7723,7450,15173,20,0.102315,0.1416,108,0,0
8579552,"Salgesch, Post",,0.000023,39,1,1,2,6437,6437,12874,3,0.45,0.5,9,0,0
8581299,"Sierre, Parc de Finges",,0.00005,39,1,1,2,2173,2173,4346,3,0.45,0.5,54,0,0
8594629,"Sierre, Orzival",,0.000014,39,1,1,2,8114,8114,16228,4,0.4,0.520833,0,0,0
8582217,"Sierre, Chemin des Pins",,0.000103,39,5,5,10,26107,27352,53459,2,0.727273,0.8125,412.25,0,0
8501997,"Stalden-Saas, Bahnhof",,0.000032,40,1,1,2,3142,3085,6227,21,0.086957,0.160248,74,0,0
8502002,Brittnau-Wikon,,0.000017,9,1,1,2,11221,11224,22445,34,0.060635,0.068745,0,0,0
8502006,Wauwil,,0.000048,9,1,1,2,19950,20008,39958,30,0.079924,0.101293,11324,0,0
8502003,Reiden,,0.000032,9,2,1,3,20535,20550,41085,33,0.064526,0.07441,3194,0,0
8502004,Dagmersellen,,0.000038,9,1,1,2,20550,20550,41100,32,0.068953,0.081296,5906,0,0
8502005,Nebikon,,0.000043,9,1,1,2,20550,19950,40500,31,0.074033,0.08993,8616,0,0
8502008,Nottwil,,0.000019,9,1,1,2,20221,20231,40452,31,0.072842,0.087079,0,0,0
8502009,Sempach-Neuenkirch,,0.000035,9,2,3,5,29830,29805,59635,30,0.078537,0.097546,5191,0,0
8502012,Rothenburg Dorf,,0.000039,9,1,1,2,20221,20227,40448,33,0.070467,0.085157,2776,0,0
8502011,Oberkirch LU,,0.000033,9,2,1,3,20208,20221,40429,34,0.06585,0.077421,147,0,0
8502017,Waldibrücke,,0.000011,9,0,2,2,0,20220,20220,32,0.075807,0.095485,0,0,0
8502019,Ermensee,,0.000016,9,1,1,2,17504,17633,35137,32,0.075781,0.095157,0,0,0
8502020,Rothenburg,,0.000054,9,2,1,3,29826,29811,59637,32,0.075781,0.095157,9264,0,0
8502024,Hochdorf,,0.000043,9,1,3,4,20382,20364,40746,30,0.081097,0.103534,5911,0,0
8502027,Hitzkirch,,0.000037,9,1,1,2,17648,17633,35281,31,0.07773,0.097795,5500,0,0
8502022,Eschenbach LU,,0.000032,9,1,1,2,20382,20382,40764,32,0.069825,0.08255,675,0,0
8502023,Ballwil,,0.000038,9,1,1,2,20382,20382,40764,31,0.075039,0.09152,3294,0,0
8502029,Mosen,,0.000027,9,1,3,4,17666,17633,35299,30,0.080948,0.102936,710,0,0
8502034,Beinwil am See,,0.000052,9,2,2,4,18165,17848,36013,29,0.084411,0.108911,11683.5,0,0
8502025,Baldegg,,0.000023,9,1,1,2,17648,17648,35296,33,0.067316,0.079167,276,0,0
8502026,Gelfingen,,0.000031,9,1,1,2,17648,17648,35296,32,0.072148,0.087268,2889,0,0
8502033,Birrwil,,0.000039,9,1,1,2,16224,16224,32448,30,0.077867,0.095667,8226,0,0
8502030,Seon,,0.000019,9,1,1,2,15662,16224,31886,33,0.063182,0.071904,429,0,0
8502031,Hallwil,,0.000027,9,1,1,2,16224,16224,32448,32,0.067418,0.078163,3030,0,0
8502032,Boniswil,,0.000034,9,1,1,2,16224,16224,32448,31,0.072266,0.08586,5629,0,0
8502104,Hunzenschwil,,0.000027,9,1,1,2,16894,16894,33788,29,0.084383,0.108586,282.833333,0,0
8502114,Rupperswil,,0.00003,9,1,2,3,29806,29823,59629,29,0.084465,0.109227,0,0,0
8502038,"Beromünster, Post",,0.000011,59,0,4,4,0,12641,12641,50,0.073545,0.118247,0,0,0
8502550,"Sursee, Spital",,0.000013,59,1,2,3,4733,15429,20162,49,0.078524,0.132705,381,0,0
8572971,"Gunzwil, Hasenhusen",,0.000037,59,1,2,3,8451,8451,16902,10,0.188889,0.262803,181,0,0
8579848,"Rickenbach LU, Dorf",,0.000049,59,2,2,4,8935,8694,17629,9,0.20979,0.281323,902,0,0
8502086,"Büron, Dorf",,0.000011,59,0,5,5,0,16705,16705,49,0.079257,0.138288,0,0,0
8502089,"Wittwil, Käserei",,0.000022,59,1,2,3,8023,8023,16046,50,0.073257,0.114466,787,0,0
8502090,"Büron, Triengenacker",,0.000022,59,2,1,3,13300,13080,26380,50,0.073178,0.113403,8,0,0
8502092,"Geuensee, Chäppelimatt",,0.000031,59,2,3,5,15968,15969,31937,49,0.078855,0.134789,797,0,0
8502095,"Winikon, Post",,0.000029,59,2,2,4,7921,6443,14364,49,0.078731,0.133196,1568,0,0
8502552,"Schenkon, Tann",,0.000019,59,2,2,4,11310,11310,22620,49,0.078439,0.132234,383,0,0
8502886,"Kirchleerau-Moosleerau, Post",,0.00005,59,1,2,3,8983,8462,17445,49,0.078439,0.132234,2346,0,0
8502887,"Reitnau, Post",,0.000032,59,1,3,4,7502,6324,13826,49,0.078623,0.134454,70,0,0
8502959,"Eich, Dorf",,0.000026,59,2,2,4,13474,13475,26949,49,0.078774,0.133546,1598.5,0,0
8502994,"Sursee, Sonnhalde",,0.000019,59,1,1,2,8451,8451,16902,49,0.078347,0.13112,0,0,0
8572984,"Knutwil, alte Post",,0.000036,59,1,3,4,4664,4664,9328,8,0.242424,0.334263,840.633333,0,0
8572995,"Sursee, Surentalstrasse",,0.000022,59,1,6,7,7364,7239,14603,13,0.152,0.250451,2699.416667,0,0
8502088,"Staffelbach, Gemeindehaus",,0.000013,59,1,1,2,4829,8023,12852,51,0.068338,0.099725,1,0,0
8502097,"Moosleerau, Abzw.",,0.000031,59,1,1,2,6484,6484,12968,51,0.067959,0.098316,785,0,0
8502096,"Attelwil, alte Post",,0.000023,59,1,1,2,6324,6484,12808,52,0.06371,0.088163,9,0,0
8502100,Safenwil,,0.000017,9,1,1,2,16642,16642,33284,32,0.067246,0.077504,480,0,0
8502101,Kölliken,,0.000026,9,1,1,2,16642,16894,33536,31,0.072068,0.085,3139,0,0
8502102,Oberentfelden,,0.000033,9,1,1,2,16894,16894,33788,30,0.077637,0.094494,5796,0,0
8502110,Dulliken,,0.000028,9,3,1,4,10574,10574,21148,31,0.072047,0.08491,122.333333,0,0
8502202,Rotkreuz,,0.000056,9,2,4,6,39222,64809,104031,29,0.083795,0.107552,10318.433333,0,0
8502111,Däniken SO,,0.000038,9,2,1,3,19567,19525,39092,30,0.077613,0.094348,2844,0,0
8502128,Holderbank AG,,0.000031,9,1,1,2,19091,18590,37681,29,0.081255,0.097275,1619,0,0
8502247,Birr,,0.000046,9,1,1,2,18533,9980,28513,29,0.081255,0.097275,1619,0,0
8503020,Zürich Hardbrücke,,0.000045,9,6,16,22,175126,175126,350252,29,0.091888,0.130034,12720.747908,0,0
8503147,Stettbach,,0.000056,9,4,7,11,74424,73673,148097,28,0.09043,0.119849,9898.87381,0,0
8503424,Schaffhausen,,0.000103,9,4,6,10,71572,89388,160960,29,0.08585,0.112153,18986.41746,0,0
8503502,Siggenthal-Würenlingen,,0.000051,9,1,1,2,22264,22234,44498,29,0.081255,0.097275,9714,0,0
8502116,Schinznach Bad,,0.000023,9,1,1,2,18822,19091,37913,30,0.075191,0.087502,141,0,0
8502201,Gisikon-Root,,0.000034,9,1,1,2,20234,20234,40468,30,0.077343,0.094518,2915.333333,0,0
8502120,Küngoldingen,,0.000028,9,1,1,2,16657,16642,33299,2,0.666667,0.75,324,0,0
8502121,Walterswil-Striegel,,0.000034,9,1,1,2,16642,16642,33284,1,1,1,163,0,0
8502123,Buchs AG,,0.00003,9,1,1,2,34467,34467,68934,10,0.171717,0.242624,2363,0,0
8502157,"Fajauna, Tanis",,0.000011,112,0,1,1,0,1963,1963,31,0.070955,0.083465,0,0,0
8502159,"Ferenbalm, Dorf",,0.000011,126,0,1,1,0,2355,2355,15,0.09994,0.1143,0,0,0
8502160,Gränichen,,0.000037,9,1,1,2,34467,34467,68934,9,0.195122,0.268552,2240,0,0
8502161,Teufenthal AG,,0.000042,9,1,1,2,34467,33093,67560,8,0.227273,0.309603,2115,0,0
8502162,Unterkulm,,0.000047,9,1,2,3,33093,33093,66186,7,0.27451,0.395918,1988,0,0
8502169,Menziken,,0.000057,9,1,1,2,33054,33054,66108,6,0.304348,0.421429,42,0,0
8502163,Oberkulm,,0.000031,9,1,1,2,33068,33054,66122,12,0.151163,0.248324,858,0,0
8502164,Gontenschwil,,0.000037,9,1,1,2,33054,33054,66108,11,0.164384,0.263561,727,0,0
8502165,Zetzwil,,0.000042,9,1,1,2,33054,33054,66108,10,0.180328,0.281421,594,0,0
8502166,Leimbach AG,,0.000047,9,1,1,2,33054,33054,66108,9,0.2,0.302897,459,0,0
8502167,Reinach AG Nord,,0.000051,9,1,1,2,33054,33054,66108,8,0.225,0.329762,322,0,0
8502168,Reinach AG,,0.000054,9,1,1,2,33054,33054,66108,7,0.258065,0.365774,183,0,0
8502174,Bleien Liebegg,,0.000079,9,2,2,4,33079,33463,66542,5,0.375,0.547222,900,0,0
8502176,Reinach AG Mitte,,0.000044,9,1,1,2,33436,33054,66490,5,0.333333,0.456667,0,0,0
8502177,Schöftland Nordweg,,0.00003,9,1,1,2,34206,34206,68412,8,0.214286,0.294544,1668,0,0
8502178,Obermuhen,,0.000037,9,1,1,2,34206,34206,68412,7,0.25,0.329654,1540,0,0
8502179,Mittelmuhen,,0.000042,9,1,1,2,34206,34206,68412,6,0.30303,0.386667,1410,0,0
8502180,Muhen Nord,,0.000047,9,1,2,3,34206,34206,68412,5,0.391304,0.512963,1278,0,0
8502194,Oberentfelden Engelplatz,,0.000051,9,1,1,2,34206,34206,68412,3,0.5,0.583333,16,0,0
8502181,Oberentfelden Uerkenbrücke,,0.000031,9,1,1,2,29766,34206,63972,7,0.235294,0.34494,572,0,0
8502182,Unterentfelden Oberdorf,,0.000037,9,1,1,2,34206,34206,68412,6,0.269231,0.378571,436,0,0
8502183,Oberkulm Post,,0.000082,9,2,1,3,33081,33093,66174,4,0.4,0.520833,608,0,0
8502184,Gränichen Oberdorf,,0.000081,9,1,1,2,33093,34467,67560,3,0.5,0.611111,459,0,0
8502185,Bremgarten Isenlauf,,0.000011,9,0,3,3,0,35657,35657,30,0.077126,0.094825,0,0,0
8502187,Rudolfstetten Hofacker,,0.000023,9,1,1,2,34640,34640,69280,31,0.071587,0.084835,2715,0,0
8502188,Zufikon Hammergut,,0.000033,9,2,3,5,34889,34907,69796,30,0.077078,0.094675,5439.916667,0,0
8502212,Dottikon-Dintikon,,0.000065,9,2,1,3,34809,34799,69608,30,0.077028,0.093822,4971.033333,0,0
8502186,Dietikon Stoffelbach,,0.000014,9,1,1,2,34406,34640,69046,32,0.066827,0.077267,1,0,0
8502213,Wohlen AG,,0.000085,9,4,3,7,55385,54988,110373,29,0.083426,0.106492,19243.083333,0,0
8502248,Bremgarten Obertor,,0.000044,9,2,2,4,35514,35477,70991,33,0.060748,0.068614,1874.866667,0,0
8502189,Gränichen Töndler,,0.00008,9,1,1,2,34467,34467,68934,2,0.666667,0.75,308,0,0
8502190,"Ferenbalm, Jerisberg",,0.00002,126,1,1,2,2355,2355,4710,14,0.110368,0.126558,165,0,0
8502191,Binzenhof,,0.000042,9,1,1,2,34206,34206,68412,5,0.315789,0.422222,298,0,0
8502192,Distelberg,,0.000047,9,1,1,2,34206,34206,68412,4,0.384615,0.483333,158,0,0
8502195,Muhen,,0.000074,9,2,2,4,38646,33786,72432,2,0.75,0.833333,444,0,0
8502196,Unterentfelden Post,,0.000042,9,1,1,2,29346,34206,63552,2,0.666667,0.75,0,0,0
8502197,Hirschthal,,0.000078,9,2,1,3,38646,34206,72852,1,1,1,150,0,0
8502198,"Ferenbalm, Jerisberghof",,0.000028,126,1,1,2,2355,2355,4710,13,0.123308,0.142924,328,0,0
8502200,Ebikon,,0.000027,9,1,1,2,18996,20234,39230,31,0.071815,0.084941,321.333333,0,0
8502203,Cham,,0.000023,9,1,1,2,36076,36076,72152,29,0.083711,0.106572,0,0,0
8502211,Hendschiken,,0.00005,9,4,1,5,31445,31445,62890,31,0.071543,0.084422,1469.566667,0,0
8502205,Walchwil,,0.000017,9,1,1,2,16793,16793,33586,33,0.061217,0.0714,334,0,0
8502214,Boswil-Bünzen,,0.000035,9,1,1,2,26210,24961,51171,29,0.083151,0.105137,0,0,0
8502217,Mühlau,,0.000032,9,1,1,2,13439,13439,26878,2,0.666667,0.75,2,0,0
8502216,Benzenschwil,,0.000025,9,1,1,2,13439,13439,26878,3,0.5,0.611111,176,0,0
8502218,Sins,,0.000052,9,2,1,3,19224,19235,38459,1,1,1,178,0,0
8502220,Urdorf,,0.000017,9,1,1,2,19363,35459,54822,33,0.062436,0.07056,1336,0,0
8502221,Birmensdorf ZH,,0.000025,9,1,1,2,35459,35459,70918,32,0.06657,0.076512,3869,0,0
8502222,Bonstetten-Wettswil,,0.000032,9,1,1,2,35459,35459,70918,31,0.071291,0.083769,6400,0,0
8502223,Hedingen,,0.000038,9,1,1,2,35459,35459,70918,30,0.076735,0.092904,8929,0,0
8502224,Affoltern am Albis,,0.000044,9,1,2,3,35459,35459,70918,29,0.083082,0.105007,11456,0,0
8502227,Steinhausen,,0.000041,9,1,1,2,19363,19363,38726,29,0.083005,0.104443,5388,0,0
8502225,Mettmenstetten,,0.000029,9,1,1,2,19363,19363,38726,31,0.071234,0.083571,344,0,0
8502226,Knonau,,0.000036,9,1,1,2,19363,19363,38726,30,0.076669,0.092606,2867,0,0
8502231,Zug Oberwil,,0.000025,9,1,1,2,16793,16793,33586,32,0.06517,0.078003,1848,0,0
8502237,Lupfig,,0.000041,9,2,1,3,18533,18533,37066,30,0.075191,0.087502,176,0,0
8502268,Zufikon Belvédère,,0.000039,9,2,2,4,34729,34907,69636,32,0.064632,0.073914,1501.433333,0,0
8502269,Erdmannlistein,,0.000046,9,2,2,4,20366,20225,40591,32,0.064597,0.07365,1692.35,0,0
8502270,Bergfrieden,,0.000047,9,2,3,5,34529,34640,69169,31,0.069013,0.080225,6018.45,0,0
8502271,Wohlen Oberdorf,,0.000044,9,2,1,3,20337,20225,40562,32,0.064525,0.072814,57.5,0,0
8502272,Bremgarten West,,0.000062,9,2,1,3,35513,35503,71016,31,0.068933,0.079087,1616,0,0
8502273,Bremgarten,,0.000077,9,2,2,4,35753,35596,71349,30,0.073991,0.087,10565.2,0,0
8502275,Widen Heinrüti,,0.000048,9,1,1,2,34907,34907,69814,30,0.073909,0.086178,1613,0,0
8502274,Zufikon,,0.000044,9,1,1,2,34905,34907,69812,31,0.068863,0.078669,181,0,0
8502276,Berikon-Widen,,0.000084,9,2,2,4,35598,35582,71180,29,0.079759,0.095827,14861.2,0,0
8517376,Dietikon Schöneggstrasse,,0.000034,9,1,1,2,34640,34640,69280,1,1,1,338.8,0,0
8502277,Rudolfstetten,,0.000047,9,1,2,3,35331,35075,70406,28,0.086604,0.107897,16274,0,0
8502278,Reppischhof,,0.000031,9,1,1,2,34640,34640,69280,28,0.086554,0.107343,0,0,0
8503505,Wettingen,,0.000035,9,1,4,5,51467,42412,93879,28,0.086807,0.109286,786.006061,0,0
8503506,Killwangen-Spreitenbach,,0.000027,9,3,1,4,33075,32539,65614,28,0.086554,0.107343,0,0,0
8502300,Zug Postplatz,,0.000032,9,1,2,3,16793,16793,33586,31,0.069672,0.086829,3360,0,0
8503286,Samstagern,,0.000059,9,4,4,8,39009,39009,78018,30,0.074454,0.095844,7154.955556,0,0
8503292,Altmatt,,0.00004,9,1,2,3,8986,8986,17972,31,0.069762,0.087239,3416,0,0
8503295,Wilen bei Wollerau,,0.000046,9,1,2,3,17363,17363,34726,31,0.069693,0.086847,3372,0,0
8505002,Küssnacht am Rigi,,0.000038,9,2,3,5,19272,19305,38577,31,0.069702,0.087342,2206.818254,0,0
8505003,Immensee,,0.000022,9,1,1,2,11537,11252,22789,31,0.069655,0.086303,0,0,0
8505004,Arth-Goldau,,0.000133,9,9,10,19,63613,52735,116348,30,0.074825,0.099283,85858.689683,0,0
8505112,Flüelen,,0.000064,9,3,3,6,18555,18555,37110,26,0.084528,0.146947,9060.666667,0,0
8505114,Erstfeld,,0.000022,9,1,3,4,17864,16874,34738,27,0.079553,0.133938,88,0,0
8515992,Baar Neufeld,,0.000037,9,4,1,5,34569,34568,69137,5,0.321429,0.401852,84.583333,0,0
8502350,"Vordemwald, Post",,0.000011,94,0,2,2,0,20237,20237,61,0.04397,0.06891,0,0,0
8502351,"Vordemwald, Chratzernstrasse",,0.000016,94,1,1,2,7401,7401,14802,61,0.043919,0.06779,0,0,0
8502352,"Reiden, Unterdorf",,0.000011,94,0,1,1,0,15100,15100,18,0.108865,0.144944,0,0,0
8502353,"Brittnau, Ausserdorf",,0.000011,94,0,2,2,0,15255,15255,61,0.040721,0.064946,0,0,0
8502354,"Brittnau, Schulhaus",,0.000016,94,1,2,3,7628,11270,18898,60,0.042269,0.070981,652,0,0
8502355,"Brittnau, Bifang",,0.000022,94,2,1,3,15255,15255,30510,18,0.107644,0.139798,92,0,0
8502356,"Strengelbach, Schleipfen",,0.000029,94,2,3,5,20237,20237,40474,60,0.045882,0.076677,1660,0,0
8502364,"Oftringen, Lerchenfeld",,0.000017,94,1,1,2,22059,22059,44118,62,0.042834,0.065927,16,0,0
8502366,"Vordemwald, Pflegeheim Sennhof",,0.000019,94,1,1,2,7401,7401,14802,60,0.04094,0.067836,0,0,0
8502378,"Rothrist, Sennhof-Dörfli",,0.000039,94,1,4,5,29231,30632,59863,60,0.046731,0.084719,2191,0,0
8502358,"Zofingen, Altachen",,0.000011,94,0,2,2,0,16158,16158,63,0.042154,0.069759,0,0,0
8505231,"Zofingen, Bahnhofplatz",,0.000091,94,8,9,17,43993,44237,88230,58,0.044311,0.091828,22607.333333,0,0
8502359,"Brittnau, Abzw. Hard",,0.00003,94,1,1,2,15255,15255,30510,17,0.118881,0.155201,158,0,0
8502374,"Wikon, Hotel Adelboden",,0.00002,94,1,2,3,15100,15101,30201,17,0.120419,0.167445,69,0,0
8502380,"Wikon, Schlossberg",,0.000019,94,1,1,2,8299,8298,16597,17,0.118881,0.155201,0,0,0
8502361,"Oftringen, Perry-Center",,0.000014,94,1,2,3,21944,46908,68852,61,0.045991,0.080405,671,0,0
8502363,"Oftringen, Gilam",,0.000024,94,1,1,2,16432,16432,32864,61,0.045624,0.077599,1632,0,0
8502362,"Oftringen, Oberfeld",,0.000016,94,1,1,2,11494,16432,27926,62,0.043683,0.069506,799,0,0
8502365,"Rothrist, Gemeindehaus",,0.000033,94,2,1,3,29231,29231,58462,61,0.044696,0.073279,1370,0,0
8502367,"Mühlethal, Linden",,0.000011,94,0,1,1,0,13609,13609,66,0.037332,0.051549,0,0,0
8502368,"Uerkheim, Säge",,0.00002,94,1,1,2,13609,13609,27218,65,0.038734,0.054825,837,0,0
8502369,"Zofingen, Spital",,0.000028,94,1,1,2,13609,18597,32206,64,0.040246,0.058736,1672,0,0
8502370,"Zofingen, JHCO",,0.000035,94,1,1,2,18597,18598,37195,63,0.041884,0.063529,2505,0,0
8502371,"Mühlethal, Weiher",,0.00004,94,1,1,2,18598,18597,37195,62,0.043663,0.069616,3336,0,0
8502382,"Rothrist, Flecken",,0.000027,94,1,2,3,22059,22059,44118,60,0.047359,0.088312,1329,0,0
8502713,"Rothrist, Oberwil",,0.000038,94,2,4,6,10423,10286,20709,59,0.042611,0.079514,820.333333,0,0
8572688,"Rothrist, Rössli",,0.000076,94,3,1,4,29231,29231,58462,10,0.197279,0.249001,450,0,0
8502379,"Ferenbalm, Rütimatt",,0.000035,126,1,1,2,2355,2355,4710,12,0.139794,0.166443,489,0,0
8570545,"Ulmiz FR, Abzw. Lurtigen",,0.000028,126,1,1,2,3466,3466,6932,12,0.139794,0.166443,326,0,0
8570546,"Gempenach, Dorf",,0.00002,126,1,2,3,2976,2976,5952,11,0.159491,0.19445,163,0,0
8570555,"Laupen BE, Bahnhof",,0.000084,126,2,3,5,9066,9420,18486,12,0.145992,0.185054,2062,0,0
8502381,"Oftringen,Kallernhag/Center A1",,0.000019,94,1,1,2,22059,22059,44118,61,0.04527,0.076623,513,0,0
8502383,"Oftringen, Eggenscheide",,0.000037,94,2,2,4,41281,41279,82560,60,0.047747,0.08955,3956,0,0
8502392,"Murgenthal, Moosmatt",,0.000037,94,1,2,3,5173,5173,10346,60,0.047282,0.088017,1333,0,0
8502581,"Zofingen, Bifangstrasse",,0.000065,94,2,2,4,35029,35029,70058,60,0.047723,0.089887,5055,0,0
8502385,"Zofingen, Bethge",,0.000045,94,1,1,2,18597,18597,37194,61,0.045601,0.077779,4165,0,0
8502384,"Zofingen, Riedtalstrasse",,0.000061,94,3,1,4,30355,30356,60711,16,0.132937,0.177474,423,0,0
8502386,"Zofingen, Römerbad",,0.000063,94,1,2,3,30356,30356,60712,15,0.15103,0.215356,482,0,0
8572725,"Brittnau, Einmündung Zelgli",,0.000084,94,2,1,3,6825,6825,13650,7,0.239316,0.279507,507,0,0
8502387,"Zofingen, Bleiche",,0.000011,94,0,2,2,0,3356,3356,59,0.042561,0.077045,0,0,0
8502393,"Strengelbach, Burgherr",,0.000017,94,1,2,3,3642,6825,10467,59,0.042561,0.077045,1302,0,0
8502582,"Mühlethal, Milchhüsli",,0.000039,94,1,3,4,18597,18597,37194,59,0.042998,0.079415,2325,0,0
8502769,"Uerkheim, Kirche",,0.000067,94,1,4,5,13609,13609,27218,59,0.04256,0.077414,4613,0,0
8502770,"Uerkheim, Unterdorf",,0.000025,94,1,2,3,6224,6256,12480,58,0.044139,0.079539,2304,0,0
8502891,"Strengelbach, Kreuzplatz",,0.000044,94,3,3,6,20237,20237,40474,59,0.042622,0.079097,4421.5,0,0
8507243,"Zofingen, Bahnhofunterführung",,0.000019,94,1,2,3,15057,14968,30025,10,0.194719,0.24805,183,0,0
8572690,"Rothrist, Bahnhof",,0.000092,94,3,3,6,34401,33906,68307,9,0.241525,0.336188,682.666667,0,0
8502388,"Glashütten, Kirche",,0.000031,94,2,1,3,1409,5173,6582,61,0.0452,0.076408,521,0,0
8502389,"Richenthal, Post",,0.000011,94,0,1,1,0,7597,7597,18,0.098385,0.126376,0,0,0
8502390,"Langnau bei Reiden, Käserei",,0.00002,94,1,1,2,7597,7597,15194,17,0.107492,0.136577,66,0,0
8502394,"Pfaffnau, Brunnmatt",,0.000011,94,0,1,1,0,11988,11988,16,0.118613,0.149851,0,0,0
8502395,"Reiden, Mehlsecken",,0.00002,94,1,1,2,11988,11988,23976,15,0.132505,0.168093,64,0,0
8502397,"Brittnau, Grod",,0.000028,94,1,1,2,11988,11988,23976,14,0.150358,0.195571,126,0,0
8502398,"Wikon, Kreuzung",,0.000038,94,1,1,2,15101,15101,30202,14,0.150358,0.195571,333,0,0
8502579,"Richenthal, Kurhaus",,0.00004,94,1,1,2,7597,7597,15194,14,0.150358,0.195571,252,0,0
8502399,"Richenthal, Kirche",,0.000028,94,1,1,2,7597,7597,15194,16,0.118613,0.149851,130,0,0
8502463,"Kappelen, Werdthof",,0.000011,87,0,1,1,0,1714,1714,29,0.06913,0.074882,0,0,0
8571210,St. Niklaus b. Merzligen,,0.000039,87,1,2,3,6549,6549,13098,29,0.069886,0.077709,2420,0,0
8571220,"Aarberg, Post/Bahnhof",,0.000111,44,4,7,11,21168,21168,42336,22,0.14443,0.181929,10980.584921,0,0
8502465,"Pambio-Noranco, Igia",,0.000011,102,0,3,3,0,34998,34998,41,0.089162,0.139467,0,0,0
8505389,"Tesserete, Stazione",,0.000013,102,1,7,8,16680,60985,77665,33,0.117451,0.181825,344.952381,0,0
8505750,"Agra, Paese",,0.000011,102,0,1,1,0,1465,1465,41,0.087173,0.130725,0,0,0
8505757,"Carona, Paese",,0.000011,102,0,1,1,0,12615,12615,41,0.087173,0.130725,0,0,0
8505797,"Comano, Chiesa",,0.000012,102,1,1,2,1638,15979,17617,41,0.087173,0.130725,0,0,0
8505863,"Morcote, Piazza Grande",,0.000023,102,1,3,4,9435,11712,21147,41,0.088494,0.138917,487,0,0
8505894,"Breganzona, Crespera",,0.000031,81,1,1,2,8218,7981,16199,41,0.087173,0.130725,2227.15,0,0
8502466,"Russo, Ai Mundaa",,0.000011,101,0,1,1,0,5370,5370,36,0.068194,0.080339,0,0,0
8502470,"Landquart, Outlet Nord",,0.000011,73,0,1,1,0,29,29,43,0.071195,0.095382,0,0,0
8506780,"Wildhaus, Dorf",,0.000028,73,1,2,3,11883,14164,26047,43,0.071307,0.096535,2270,0,0
8506788,"Unterwasser, Post",,0.00003,73,1,3,4,11883,11883,23766,41,0.076456,0.10816,1940.8,0,0
8509690,"Sennwald, Post",,0.00003,73,3,3,6,25041,24560,49601,43,0.077248,0.116653,10796.176106,0,0
8502471,"Kloten, Waldeggweg",,0.000011,107,0,1,1,0,14088,14088,20,0.122344,0.147289,0,0,0.000216
8503700,"Bassersdorf, Bahnhof",,0.000011,107,0,5,5,0,44099,44099,20,0.130667,0.161343,0,0,0.000329
8503850,"Bülach, Untertor",,0.000028,107,3,5,8,33159,33052,66211,20,0.124802,0.156875,5014.665152,0.00002,0.001323
8503885,"Niederhasli, Hofstetterstrasse",,0.000036,107,2,4,6,15430,15380,30810,20,0.123342,0.152036,3640.966667,0.00012,0.000647
8503989,"Winkel, Oberrüti",,0.000033,107,1,2,3,14005,14007,28012,20,0.122781,0.149146,2910.149544,0,0.00067
8506897,"Embrach, Post",,0.000034,107,2,3,5,35502,35486,70988,20,0.122638,0.149932,5639.333333,0,0.000061
8506898,"Oberembrach, Dorf",,0.000033,107,2,3,5,12008,12008,24016,20,0.122506,0.149411,1353.166667,0.000009,0.00006
8572590,"Weiach, Alter Bahnhof",,0.000026,107,2,3,5,12050,12092,24142,20,0.123189,0.151023,1715.904762,0.000134,0.00539
8502473,"Gossau SG, Kirchstrasse",,0.000011,71,0,2,2,0,9618,9618,27,0.111805,0.141785,0,0,0
8506254,"Andwil SG, St. Margreten",,0.000016,71,1,3,4,9590,16476,26066,26,0.124466,0.165845,503.716667,0,0
8506468,"Gossau SG, Mettendorf",,0.00002,71,2,5,7,16870,66566,83436,25,0.139435,0.198373,973.62619,0,0
8502475,"Celerina, Olympia Bob Run",,0.000011,30,0,2,2,0,2404,2404,11,0.200535,0.258244,0,0,0
8502741,"Silvaplana, Camping",,0.000016,30,1,6,7,2330,8813,11143,10,0.237179,0.324914,49.5,0,0
8509762,"Champfèr, Schulhaus",,0.000033,30,4,8,12,6942,7612,14554,9,0.278226,0.383448,174.446429,0,0
8509881,"Sils/Segl Maria, Posta",,0.000043,30,3,3,6,6571,6542,13113,9,0.255814,0.319312,151.142857,0,0
8502477,"Rapperswil SG, Glärnischstr.",,0.000011,67,0,2,2,0,10756,10756,12,0.176179,0.21807,0,0,0
8503353,"Jona, Schönau",,0.000011,67,0,2,2,0,16428,16428,50,0.036546,0.062015,0,0,0
8576078,"Jona, Fluhstrasse",,0.000036,67,1,2,3,16536,16526,33062,13,0.181354,0.225923,1023.47619,0,0
8576079,"Rapperswil SG, Sonnenhof",,0.000036,67,3,4,7,22455,37268,59723,12,0.196653,0.25577,1030.883333,0,0
8578527,"Jona, Kreuz",,0.000057,67,2,1,3,36267,36292,72559,12,0.171233,0.218769,5301,0,0
8502478,"Colombier NE, Arsenal",,0.000011,48,0,2,2,0,481,481,18,0.102124,0.118925,0,0,0
8504734,"Boveresse, temple",,0.00003,11,1,1,2,29,29,58,18,0.102094,0.117501,35977.863095,0,0
8504742,"Corcelles NE, Pharmacie",,0.000044,48,3,6,9,65508,72992,138500,16,0.136005,0.172501,13607.192783,0,0
8504743,Les Grattes de bise,,0.000048,48,3,3,6,5422,5441,10863,17,0.113379,0.135623,36529.696429,0,0
8502485,"Porrentruy, Ô Vergers d'Ajoie",,0.00002,50,1,3,4,5264,5264,10528,22,0.137097,0.233969,68,0,0
8504112,"Porrentruy, Planchettes",,0.000011,50,0,1,1,0,5731,5731,22,0.13215,0.208113,0,0,0
8510382,"Porrentruy, Joseph Trouillat",,0.000011,50,0,1,1,0,6615,6615,22,0.13215,0.208113,0,0,0
8510762,"Porrentruy, Lorette",,0.000017,50,1,1,2,2087,2087,4174,22,0.13215,0.208113,0,0,0
8557072,"Porrentruy, St-Michel",,0.00002,50,1,1,2,5237,5237,10474,22,0.13215,0.208113,67,0,0
8572041,"Porrentruy, gare",,0.000066,50,5,6,11,22500,28746,51246,21,0.15,0.283004,438,0,0
8502492,"Neftenbach, Chlimberg",,0.000011,68,0,1,1,0,928,928,46,0.053407,0.077927,0,0,0
8503705,"Hettlingen, Dorf",,0.00002,68,1,4,5,2780,19293,22073,46,0.055287,0.088472,983,0,0
8502493,"Freienstein, Wohnschule",,0.000011,107,0,1,1,0,7542,7542,23,0.092743,0.105442,0,0,0
8506890,"Rorbas, Aubrücke",,0.000025,107,2,2,4,18724,18861,37585,22,0.10136,0.117638,1105.666667,0,0
8506892,"Embrach, Dreispitz",,0.000039,107,3,3,6,35464,35474,70938,21,0.11172,0.132972,3741.166667,0,0.000001
8502494,"Hagenbuch ZH, Hagenstal",,0.000011,65,0,1,1,0,5211,5211,38,0.045551,0.068964,0,0,0
8506853,"Aadorf, Morgental",,0.000023,65,1,1,2,8830,8830,17660,38,0.045551,0.068964,343,0,0
8502495,"Zürich, Bahnhof Wollishofen",,0.000011,130,0,3,3,0,76810,76810,12,0.171818,0.193591,0,0,0
8506549,"Adliswil, Dietlimoos",,0.000014,130,1,1,2,10057,10059,20116,14,0.132909,0.146027,0,0,0
8502496,"Auvernier Littorail, gare",,0.000011,48,0,1,1,0,29,29,18,0.11785,0.131419,0,0,0
8502498,giratoire,,0.00002,48,1,1,2,29,29,58,17,0.13335,0.152742,545,0,0
8502500,Place de jeux,,0.000028,48,1,2,3,29,58,87,16,0.153586,0.184973,1088,0,0
8502501,"Vaumarcus, giratoire",,0.000023,48,1,1,2,29,58,87,16,0.153347,0.183472,0,0,0
8504216,Noiraigue,,0.000039,11,2,2,4,14295,14295,28590,34,0.070378,0.095195,7408,0,0
8504253,Petit-Chézard,,0.000014,48,1,3,4,22962,23092,46054,21,0.145122,0.180253,745.428571,0,0
8504256,"Villiers, centre",,0.000033,48,2,3,5,16685,16755,33440,19,0.148436,0.182476,101842.652307,0,0
8504258,"Boudevilliers, centre",,0.000021,48,1,2,3,12006,12120,24126,19,0.147972,0.180273,565.605736,0,0
8504260,"Neuchâtel, Vauseyon",,0.000038,48,2,4,6,21225,97969,119194,17,0.158248,0.196463,23541.529978,0,0
8502502,Brot-Dessous,,0.000011,11,0,1,1,0,29,29,37,0.058176,0.069473,0,0,0
8502503,Fretereules,,0.00002,11,1,1,2,29,29,58,36,0.061743,0.075811,2289,0,0
8502504,L'Engolieu,,0.000028,11,1,1,2,29,29,58,35,0.065777,0.083938,4576,0,0
8504215,Travers,,0.000011,11,0,2,2,0,15746,15746,30,0.087717,0.111097,0,0,0
8502506,"Treytorrens, Les Molliettes",,0.000011,13,0,1,1,0,1585,1585,37,0.068265,0.087406,0,0,0
8504151,"Fétigny, village",,0.00002,13,1,5,6,4077,4077,8154,37,0.068608,0.091274,2203,0,0
8587020,"Dietikon, Bahnhof",,0.000054,22,5,14,19,67850,195225,263075,15,0.154795,0.199258,47177.174548,0.000805,0.000429
8590218,"Dietikon, Gjuchstrasse",,0.000017,22,2,2,4,38308,38437,76745,16,0.109043,0.127313,16.583333,0.00003,0.000026
8502513,"St. Gallen, Rosenheimstrasse",,0.000011,71,0,1,1,0,21149,21149,27,0.108495,0.132866,0,0,0
8502514,"St. Gallen, Hodlerstrasse",,0.00002,71,1,1,2,21149,42297,63446,26,0.121479,0.155914,552,0,0
8502515,"St. Gallen, Kolosseumstrasse",,0.000028,71,1,2,3,42297,42297,84594,25,0.138026,0.191816,1102,0,0
8506459,"St. Gallen, Heiligkreuzstrasse",,0.000041,71,4,7,11,51752,117420,169172,39,0.067618,0.128817,5280.796429,0,0
8506649,"Abtwil SG, Farnen",,0.000029,71,2,3,5,22825,30466,53291,38,0.07006,0.128861,6074.333333,0,0
8502516,"St. Gallen, Telltreppe",,0.000011,71,0,1,1,0,11420,11420,25,0.135242,0.188165,0,0,0
8502517,"St. Gallen, Uni/Curtistrasse",,0.000011,71,0,2,2,0,19313,19313,40,0.064912,0.121576,0,0,0
8506264,"Steinach, Post",,0.00002,71,1,1,2,8089,8153,16242,25,0.135242,0.188165,515,0,0
8506643,"Abtwil SG, Sonnenberg",,0.000011,71,0,2,2,0,9835,9835,40,0.064552,0.118947,0,0,0
8506651,"Engelburg, Dorfplatz",,0.000022,71,2,6,8,15275,34947,50222,37,0.072011,0.132536,6708.630952,0,0
8506653,"St. Gallen, Langgass",,0.00004,71,4,4,8,86959,86959,173918,25,0.139523,0.198044,384.345238,0,0
8506683,"Untereggen, Gemeindehaus",,0.00002,71,1,3,4,7168,7168,14336,35,0.075261,0.13026,7954.95,0,0
8506775,"Stein AR, Dorf",,0.000057,97,1,2,3,5758,5758,11516,25,0.136056,0.190484,7115.775376,0,0
8507327,"Goldach, Mühlegut",,0.000029,72,3,3,6,23610,23623,47233,34,0.078781,0.136186,5492.580952,0,0
8550757,"St. Gallen, Spisertor (Bus)",,0.000019,71,2,2,4,52628,46709,99337,25,0.137412,0.191798,45.428571,0,0
8557031,"Arbon, Kupferwiese",,0.000011,71,0,1,1,0,7111,7111,25,0.135242,0.188165,0,0,0
8573946,"Gossau SG, Poststrasse",,0.000039,71,1,5,6,78789,78613,157402,25,0.141818,0.205517,43299.302429,0,0
8573954,"Gossau SG, Migros-Markt",,0.000052,71,2,5,7,55509,55510,111019,25,0.138925,0.199902,39620.984175,0,0
8573965,"Wittenbach, Bahnhof",,0.000078,71,3,4,7,50500,55521,106021,25,0.137421,0.196144,9306.603665,0,0
8573967,"Wittenbach, Grünau",,0.000034,71,1,3,4,37289,37289,74578,25,0.136424,0.193269,570,0,0
8574076,"Heiden, Lindenplatz",,0.000022,71,1,2,3,11071,11070,22141,24,0.137517,0.191266,6035.858123,0,0
8574081,"Unterrechstein, Heilbad",,0.000048,71,1,3,4,14009,14009,28018,40,0.062091,0.117528,3753.5,0,0
8574093,"Rheineck, Bahnhof",,0.000088,72,5,8,13,23752,31106,54858,33,0.082612,0.145075,26860.540476,0,0
8506056,"Wittenbach, Bächi",,0.000011,71,0,4,4,0,37289,37289,40,0.063652,0.11021,0,0,0
8506256,"Stachen, Museum Momö",,0.000016,71,1,2,3,8915,8915,17830,40,0.063436,0.107184,1025.296429,0,0
8506263,"Kronbühl, alte Post",,0.00002,71,2,1,3,20588,20588,41176,40,0.063386,0.106428,0,0,0
8502518,Unterdorf,,0.000011,66,0,1,1,0,19518,19518,46,0.048329,0.086188,0,0,0
8502519,Schlossweiher,,0.00002,66,1,1,2,19518,19518,39036,45,0.050691,0.098931,550,0,0
8502520,"Flawil, Oberglatt",,0.000011,20,0,1,1,0,2983,2983,15,0.114286,0.165113,0,0,0
8502521,"Flawil, Burgau",,0.00002,20,1,2,3,2983,5938,8921,14,0.125448,0.189661,35,0,0
8502523,"Flawil, Glatthalde",,0.000019,20,1,1,2,2983,2983,5966,14,0.122302,0.165828,0,0,0
8502522,"Flawil, Isnyplatz",,0.000011,20,0,2,2,0,11633,11633,50,0.040631,0.05728,0,0,0
8502524,"Flawil, Wilerstrasse",,0.000011,20,0,1,1,0,11273,11273,50,0.040599,0.055711,0,0,0
8506471,"Flawil, Botsberg",,0.000025,20,2,2,4,22740,22465,45205,49,0.042289,0.061,2987,0,0
8506731,"Degersheim, Kreuzstrasse",,0.000054,20,1,2,3,7688,7688,15376,9,0.245763,0.332937,203,0,0
8573976,"Flawil, Niederberg",,0.000032,20,1,1,2,11273,11273,22546,9,0.232,0.300506,4131,0,0
8502525,Forsthaus,,0.000011,66,0,1,1,0,6649,6649,12,0.1375,0.181868,0,0,0
8502526,Berghaldenweg,,0.000028,66,1,1,2,19518,19518,39036,44,0.053301,0.119014,1098,0,0
8503474,Ramsen Sonne,,0.00002,65,1,3,4,13326,18008,31334,35,0.073122,0.146462,549,0,0
8503481,Kreuzstrasse,,0.000029,66,2,2,4,28015,44217,72232,44,0.054862,0.124802,1142,0,0
8503488,Schleitheim Bahnhofstrasse,,0.000041,66,1,4,5,7554,7554,15108,44,0.053741,0.126412,1661.333333,0,0
8503490,Gächlingen Dorf,,0.000027,66,2,4,6,1292,7233,8525,44,0.053702,0.127214,1668.166667,0,0
8503493,Schleitheim Mattenhof,,0.000038,66,1,1,2,5865,5865,11730,44,0.053301,0.119014,1098,0,0
8502527,Herblingen Bahnhof,,0.00002,66,1,1,2,6649,13298,19947,11,0.154589,0.200993,32,0,0
8502528,E.Homberger-Str.,,0.000028,66,1,1,2,13298,13298,26596,10,0.177143,0.229672,62,0,0
8573479,Herblingen Post,,0.000033,66,1,2,3,25409,25409,50818,10,0.197479,0.259642,1610.92381,0,0
8502533,"Steinach, Bifang",,0.000011,71,0,1,1,0,8089,8089,26,0.119334,0.153794,0,0,0
8502534,"Freienbach, Sarenbach",,0.000011,113,0,1,1,0,28520,28520,31,0.059746,0.09541,0,0,0
8503761,"Feusisberg, Gemeindehaus",,0.000011,113,0,1,1,0,9247,9247,31,0.059746,0.09541,0,0,0
8573795,"Siebnen, Aabrücke",,0.000056,67,2,2,4,10154,10501,20655,31,0.060591,0.102384,2291,0,0
8502535,"Obersommeri, Dorf",,0.000011,121,0,1,1,0,4893,4893,19,0.093284,0.111212,0,0,0
8502536,"Schüpfheim, Moosmättili",,0.000011,92,0,4,4,0,1284,1284,15,0.182836,0.29348,0,0,0
8502745,"Hasle LU, Dorf",,0.000013,92,1,2,3,463,858,1321,16,0.164384,0.24486,0,0,0
8510222,"Hasle LU, Heiligkreuz Witebach",,0.000019,92,2,1,3,147,147,294,16,0.161512,0.228793,0,0,0
8508865,"Sörenberg, Skilift Rischli",,0.000035,92,1,2,3,3891,3891,7782,11,0.219626,0.296075,61.5,0,0
8508867,"Sörenberg, Rothornbahn",,0.000057,92,3,3,6,2620,2620,5240,11,0.221154,0.311569,449.5,0,0
8572833,"Hasle LU, Bahnhof",,0.000035,92,3,3,6,1228,1228,2456,15,0.188525,0.299939,102.5,0,0
8502537,"Homburg, Löhren",,0.000011,65,0,1,1,0,223,223,44,0.036053,0.049409,0,0,0
8502538,"Homburg, Jagdhaus",,0.00002,65,1,1,2,223,223,446,43,0.037286,0.051517,322,0,0
8502539,"Hörhausen, Haidenhaus",,0.000028,65,1,1,2,223,223,446,42,0.03861,0.05398,642,0,0
8502540,"Hörhausen, Untersalen",,0.000035,65,1,1,2,223,223,446,41,0.040035,0.056948,960,0,0
8502546,"Hörhausen, Obersalen",,0.00004,65,1,1,2,223,233,456,40,0.041574,0.060742,1276,0,0
8506688,"Müllheim Dorf, Post",,0.000052,65,2,2,4,13599,12942,26541,51,0.039923,0.054122,2102,0,0
8502547,"Walzenhausen, Unterer Platz",,0.000011,71,0,1,1,0,859,859,40,0.059156,0.086652,0,0,0
8506445,"St. Margrethen SG, Rheinpark",,0.000014,72,1,3,4,13483,14755,28238,33,0.081378,0.128243,50,0,0
8506762,"Lutzenberg, Haufen",,0.000011,71,0,1,1,0,4782,4782,40,0.059156,0.086652,0,0,0
8502549,"Weinfelden, Dufourstrasse",,0.000011,20,0,1,1,0,3373,3373,49,0.043595,0.0574,0,0,0
8502551,"Schenkon, Zentrum",,0.000011,59,0,2,2,0,10019,10019,48,0.076576,0.116434,0,0,0
8502749,"Hildisrieden, Post",,0.000011,59,0,1,1,0,3486,3486,48,0.072719,0.102351,0,0,0
8502756,"Sempach Stadt, Post",,0.000025,59,2,2,4,9028,17060,26088,47,0.078321,0.117627,1017.5,0,0
8502553,"Unterlunkhofen, Breitenäcker",,0.000011,85,0,1,1,0,9028,9028,21,0.113011,0.126724,0,0,0
8502568,"Hermetschwil, alte Post",,0.000011,85,0,2,2,0,3145,3145,21,0.113571,0.129117,0,0,0
8502554,"Rifferswil, Oberrifferswil",,0.000011,115,0,2,2,0,5071,5071,33,0.089499,0.107469,0,0,0.012761
8502572,"Zürich, Goldbrunnenplatz",,0.000022,85,3,12,15,14992,239521,254513,32,0.129408,0.197528,7816.697891,0.001572,0.526865
8573180,"Knonau, Uttenberg",,0.000028,115,1,1,2,4526,4525,9051,9,0.180328,0.279906,22,0,0.000302
8502555,"Rickenbach AG, Zürichstrasse",,0.000011,115,0,1,1,0,7517,7517,39,0.07734,0.092964,0,0,0
8502556,"Merenschwand, Unterdorf",,0.00002,115,1,2,3,7517,7517,15034,38,0.083759,0.103956,1296,0,0.000001
8502565,"Aristau, Birri",,0.000029,115,2,3,5,8044,11131,19175,36,0.09231,0.118117,1952.876251,0.000049,0.000052
8572465,"Wildegg, Bahnhof",,0.000034,58,3,2,5,9232,9464,18696,5,0.318182,0.417857,36,0,0
8502558,"Merenschwand, Unterrüti",,0.000019,115,1,1,2,6974,7297,14271,37,0.084569,0.103626,644.709585,0,0.000049
8502559,"Waldegg, Birmensdorferstrasse",,0.000011,85,0,5,5,0,20140,20140,33,0.117547,0.163417,0,0,0.002088
8502567,"Rottenschwil, Abzw.",,0.000029,115,1,3,4,4097,5931,10028,34,0.105933,0.141359,2873.833444,0,0.013905
8502560,"Berikon, Kirche",,0.000013,85,1,4,5,12202,14479,26681,33,0.119306,0.167607,223.777778,0.000048,0.034748
8502571,"Rottenschwil, Kapelle",,0.000037,115,2,5,7,4919,4919,9838,33,0.11715,0.164967,4959.351204,0.000329,0.031234
8502878,"Bremgarten AG, Obertorplatz",,0.000025,85,2,4,6,12052,19697,31749,20,0.127286,0.148084,2016.266922,0,0.015681
8502894,"Oberwil-Lieli, Dreispitz",,0.00002,85,3,3,6,17424,17423,34847,20,0.1294,0.15224,853.398147,0.013329,0.020653
8503610,"Zürich, Triemli",,0.000088,85,7,12,19,99119,190267,289386,17,0.170306,0.216028,23659.935172,0.015172,0.748662
8572559,"Bellikon, Abzw. Hausen",,0.000044,22,2,3,5,12762,13205,25967,20,0.120157,0.145846,72660.102888,0.000022,0.020786
8502561,"Büblikon, Rössli",,0.000011,22,0,1,1,0,7274,7274,25,0.078855,0.089201,0,0,0
8502562,"Muri AG, Kreisspital",,0.000011,115,0,3,3,0,1813,1813,18,0.143034,0.170398,0,0,0.006315
8502563,"Muri AG, Bachmatten-Schulhaus",,0.000011,115,0,3,3,0,1755,1755,20,0.1127,0.128938,0,0,0.000157
8502564,"Buttwil, Schule",,0.000017,115,2,2,4,942,2990,3932,19,0.126349,0.146898,955.166667,0.000149,0.00383
8572610,"Muri AG, Egg",,0.000094,115,9,7,16,12871,13182,26053,18,0.144375,0.17717,20040.759763,0.002715,0.038152
8572626,"Besenbüren, Schulhaus",,0.000025,115,1,3,4,2793,2976,5769,18,0.1438,0.170483,4664.51592,0.000351,0.020166
8572637,"Beinwil (Freiamt), Unterdorf",,0.000056,115,2,2,4,3335,3215,6550,18,0.141478,0.167128,1861,0.000002,0.00517
8572638,"Beinwil (Freiamt), Ab.Winters.",,0.000035,115,1,1,2,2270,2149,4419,18,0.141342,0.166196,0,0.000119,0.00505
8572640,"Muri AG, Lindenberg",,0.000039,115,1,3,4,4562,4562,9124,18,0.141614,0.168059,1041,0,0.005423
8572641,"Buttwil, Weinmatten",,0.000022,115,1,2,3,2634,2634,5268,18,0.141478,0.167128,0,0.000125,0.005298
8572642,"Buttwil, Handlung Bartlome",,0.000031,115,2,1,3,2625,2625,5250,18,0.141342,0.166196,0,0.000248,0.00505
8572647,"Rottenschwil, Seematten",,0.000028,115,1,4,5,3068,3086,6154,17,0.157191,0.193103,706.734566,0.000166,0.128117
8502569,"Brunnwil, Weiler",,0.000014,115,1,2,3,755,2270,3025,20,0.112498,0.127725,3.833333,0.000004,0.000004
8502577,"Aristau, Dorf",,0.000027,115,3,4,7,4099,4098,8197,19,0.129888,0.154038,968.937796,0.013207,0.021241
8502877,"Beinwil (Freiamt), Dorf",,0.00004,115,2,3,5,3097,3334,6431,19,0.126366,0.147528,2777.833333,0,0.003772
8502889,"Wohlen AG, Bahnhof",,0.000089,115,4,4,8,15071,25650,40721,19,0.127706,0.152083,8598,0,0.004185
8503598,"Arni AG, Dorf",,0.000047,85,4,7,11,10767,14973,25740,18,0.161629,0.19805,8887.659959,0.001026,0.043066
8503709,"Waldegg, Post",,0.000016,85,1,5,6,5098,5095,10193,19,0.131575,0.158138,722.333333,0.00192,0.010744
8572544,"Wohlen AG, Coop",,0.00003,115,1,7,8,14856,12145,27001,19,0.127883,0.154389,161.666667,0.000097,0.005889
8572602,"Oberlunkhofen, Haldenmatten",,0.000041,85,4,5,9,5885,5872,11757,18,0.143931,0.173689,1939.029883,0.00357,0.01711
8572609,"Merenschwand, Hinterdorf",,0.000049,115,2,2,4,7840,7839,15679,18,0.139686,0.16721,2521.534468,0.000003,0.00776
8502884,"Obfelden, Toussen",,0.00003,115,2,2,4,10462,10462,20924,19,0.120932,0.138554,1796.956515,0.000671,0.000004
8502566,"Aristau, Althäusern",,0.000021,115,2,1,3,3922,4097,8019,35,0.095853,0.120984,1587.833444,0.000049,0
8502570,"Rottenschwil, Hecht",,0.000021,115,2,1,3,2999,3086,6085,34,0.104938,0.13706,12.055556,0.000369,0.000329
8572607,"Bremgarten AG, Stockweier",,0.000025,85,1,1,2,6051,6051,12102,25,0.086418,0.096282,767.4,0,0
8502576,"Rüstenschwil, Kreuzung",,0.000028,115,1,1,2,2977,2977,5954,20,0.112297,0.126381,926,0,0
8502779,"Ottenbach, Zentrum",,0.000024,115,2,3,5,5758,5974,11732,20,0.124366,0.142951,1524.768078,0.012468,0.015915
8502876,"Aesch ZH, Gemeindehaus",,0.000031,85,4,2,6,5899,5966,11865,20,0.123552,0.140562,223.57181,0.013744,0.002155
8502574,"Affoltern a.A., Stigeli",,0.000011,85,0,1,1,0,1538,1538,32,0.106416,0.135638,0,0,0.012803
8502764,"Hausen am Albis, Tüfenbach",,0.000033,115,1,4,5,3297,3293,6590,30,0.110337,0.139585,2714.917112,0,0.01484
8502778,"Obfelden, Alte Post",,0.000028,115,2,2,4,7474,10462,17936,20,0.115273,0.129556,2135.813139,0.000001,0.013139
8502771,"Aeugst am Albis, Dorf",,0.000029,85,3,5,8,3246,5124,8370,31,0.118992,0.162844,5416.247657,0.012803,0.019906
8502963,"Hausen am Albis, Heisch",,0.000046,115,4,3,7,3294,3292,6586,30,0.119036,0.158,7355.103746,0.000851,0.015937
8502986,"Ebertswil, Schulhaus",,0.00004,115,2,3,5,2162,2160,4322,18,0.146609,0.173679,2182.053707,0.000397,0.019981
8503579,"Birmensdorf ZH, Obere Risi",,0.000038,85,1,1,2,13170,13169,26339,18,0.145645,0.17107,2888.317527,0,0.015172
8503580,"Uitikon, Schlössli",,0.000019,85,1,2,3,4791,4792,9583,18,0.155386,0.184418,905.408752,0.000477,0.016198
8503693,"Wettswil a.A., Heidenchilen",,0.000018,85,1,3,4,4492,5501,9993,17,0.147421,0.180638,925.147717,0.000052,0.08088
8503696,"Stallikon, Sellenbüren",,0.000063,85,3,5,8,5940,5942,11882,17,0.158382,0.194302,4699.526288,0,0.091828
8503697,"Aeugstertal, Kloster",,0.000026,85,2,4,6,4174,4164,8338,17,0.147422,0.1813,951.687256,0.00258,0.085357
8503699,"Uitikon, Dorf",,0.000025,85,1,4,5,4787,7561,12348,17,0.152974,0.187532,2407,0,0.083141
8506517,"Zürich, Hertersteg",,0.000011,85,0,3,3,0,72813,72813,17,0.151776,0.193322,0,0,0.058115
8530813,"Zürich, Kreuzplatz",,0.000036,85,2,6,8,208472,208425,416897,16,0.16032,0.207635,7601.292572,0.01091,0.443136
8572599,"Berikon, Kreisschule",,0.000056,85,1,4,5,14480,14478,28958,17,0.154424,0.18747,69698.82024,0,0.106275
8572603,"Jonen, Käppeli",,0.00005,85,3,6,9,12148,12148,24296,17,0.161273,0.197781,5492.189636,0.000576,0.100688
8572744,"Muri AG, Bahnhof",,0.000139,115,9,12,21,20283,18791,39074,17,0.164424,0.208803,30486.906713,0.00505,0.185391
8573176,"Hausen am Albis, Vollenweid",,0.000017,85,1,2,3,132,132,264,17,0.146165,0.177819,0,0.001971,0.07863
8573178,"Affoltern a.A., Bahnhof",,0.000137,115,7,8,15,25612,25620,51232,17,0.155706,0.195726,16491.812764,0.005045,0.099758
8573182,"Hausen am Albis, Bifang",,0.000054,115,4,2,6,2162,2071,4233,17,0.146194,0.177879,1586.625357,0.004348,0.076037
8576244,"Regensdorf, Obstgarten",,0.000042,107,2,2,4,22857,43827,66684,20,0.134253,0.162881,5243,0,0.013096
8576245,"Regensdorf, Zentrum",,0.000029,107,1,5,6,38978,69156,108134,20,0.136921,0.170191,624.093837,0.000302,0.014149
8580522,"Zürich, Escher-Wyss-Platz",,0.00005,85,8,12,20,245994,332961,578955,14,0.206342,0.260566,12745.678848,0.129682,0.258416
8588078,"Zürich, Central",,0.00006,85,5,19,24,263655,353707,617362,15,0.232108,0.297115,41165.918818,0.096164,3.039913
8590318,"Zürich, Farbhof",,0.000023,85,3,4,7,99092,131778,230870,10,0.208728,0.236006,6896.038977,0.124574,0.207638
8591041,"Zürich, Althoos",,0.000011,85,0,2,2,0,26763,26763,9,0.215427,0.238216,0,0,0.032357
8591053,"Zürich, Bad Allenmoos",,0.000029,85,4,4,8,55625,55611,111236,8,0.239741,0.270077,2626.234102,0.119477,0.090021
8591060,"Zürich, Bahnhof Hardbrücke",,0.00004,85,7,7,14,196316,196276,392592,9,0.24189,0.278416,7570.162648,0.208272,0.076045
8591066,"Zürich, Bahnhof Wipkingen",,0.000022,85,3,9,12,98883,98908,197791,8,0.249415,0.292057,5358.741572,0.114357,0.065983
8591071,"Zürich, Beckenhof",,0.000044,85,5,6,11,110725,110746,221471,8,0.243697,0.279314,10258.71674,0.135913,0.19207
8591076,"Zürich, Berufswahlschule",,0.000016,85,1,1,2,13464,13464,26928,9,0.214882,0.23575,0,0.004917,0.03161
8591079,"Zürich, Bezirksgebäude",,0.000103,85,10,8,18,93542,93419,186961,8,0.267065,0.306086,29959.544447,0.278335,0.17157
8591086,"Zürich, Birchdörfli",,0.000024,85,3,1,4,55762,55787,111549,9,0.214882,0.23575,174.579069,0.025243,0.03161
8591093,"Zürich, Kantonalbank",,0.000097,85,9,4,13,206902,208491,415393,8,0.243519,0.271989,14443.030428,0.195271,0.047055
8591097,"Zürich, Bristenstrasse",,0.000042,85,4,6,10,88353,88363,176716,8,0.236842,0.27054,3256.363507,0.035941,0.049569
8591098,"Zürich, Brunau/Mutschellenstr.",,0.000073,85,3,3,6,63124,63094,126218,9,0.219149,0.244812,18577.752972,0.011559,0.039215
8502573,"Wallenschwil, Weiler",,0.00002,115,2,1,3,2313,2977,5290,21,0.101057,0.111398,2,0.000004,0
8502575,"Widen, Dorf",,0.000014,22,1,4,5,1069,7727,8796,22,0.100905,0.120653,172,0.000802,0.000003
8502707,"Mellingen Heitersberg, Bahnhof",,0.00003,22,2,5,7,14610,26003,40613,23,0.093426,0.113911,2515.250585,0,0.000005
8502750,"Bellikon, Dorf",,0.000019,22,2,3,5,9191,8780,17971,22,0.100815,0.119775,2466.43828,0,0.000002
8502772,"Niederrohrdorf,Gemeindezentrum",,0.000024,22,3,1,4,17492,17173,34665,24,0.087776,0.101352,11.6,0,0
8502956,"Remetschwil, Dorf",,0.000029,22,3,3,6,12643,12749,25392,22,0.100501,0.119136,1698.638432,0.000004,0.000047
8502983,"Baden, Badener Tor",,0.000043,22,5,4,9,34252,34422,68674,22,0.105597,0.131059,8573.34566,0.000006,0.000037
8572601,"Zufikon, Algier",,0.000046,85,1,3,4,11646,11646,23292,18,0.141972,0.167168,1037.075,0,0.007184
8502578,"Langnau bei Reiden, Lupfen",,0.000035,94,1,1,2,7597,7597,15194,15,0.132505,0.168093,192,0,0
8572651,"Schöftland, Dorfstrasse",,0.000035,59,1,2,3,6256,6256,12512,6,0.294118,0.349333,867,0,0
8572652,"Uerkheim, Schweizermatten",,0.000026,59,1,1,2,3128,3128,6256,6,0.285714,0.322222,0,0,0
8572653,"Bottenwil, Unterdorf",,0.000034,94,2,1,3,7170,7126,14296,6,0.285714,0.322222,0,0,0
8502583,"Uerkheim, Tannacker",,0.000022,94,1,1,2,13609,13609,27218,62,0.038108,0.05756,112,0,0
8502584,"Uerkheim, Abzw. Neudorf",,0.000029,94,1,3,4,13609,13609,27218,61,0.039558,0.064243,761,0,0
8502766,"Bottenwil, Dorf",,0.000027,94,1,1,2,7126,7126,14252,61,0.039334,0.060081,659,0,0
8502767,"Holziken, Post",,0.000027,94,1,1,2,6256,6256,12512,61,0.039334,0.060081,659,0,0
8502585,"Weinfelden, Wilerstrasse",,0.00002,20,1,1,2,3373,3276,6649,48,0.045553,0.061776,1596,0,0
8502587,"Uerkheim, Oberdorf",,0.000019,94,1,1,2,7170,7126,14296,62,0.037901,0.055384,16,0,0
8502589,"Schöftland, Abzw. Böhler",,0.000011,59,0,1,1,0,4602,4602,66,0.031425,0.040237,0,0,0
8502590,"Schöftland, Sandplatten",,0.00002,59,1,1,2,4602,4602,9204,65,0.032392,0.041769,609,0,0
8502591,"Schlossrued, Klack",,0.000028,59,1,1,2,4602,4602,9204,64,0.033421,0.043493,1216,0,0
8502592,"Schlossrued, Dorf",,0.000035,59,1,1,2,4602,4602,9204,63,0.03452,0.045459,1821,0,0
8502593,"Kirchrued, Kirche",,0.00004,59,1,1,2,4602,4602,9204,62,0.035695,0.047744,2424,0,0
8502594,"Schmiedrued, Matt",,0.000045,59,1,1,2,4602,4602,9204,61,0.036956,0.050477,3025,0,0
8502595,"Schmiedrued, Dorf",,0.000049,59,1,1,2,4602,4602,9204,60,0.03831,0.053914,3624,0,0
8502596,"Walde AG, Käserei",,0.000053,59,1,2,3,4602,4602,9204,59,0.03977,0.05882,4221,0,0
8502598,"Schiltwald, Wendeplatz",,0.000039,59,1,1,2,4481,4481,8962,59,0.039646,0.05652,601,0,0
8502597,"Schiltwald, Firma Michel",,0.000033,59,1,1,2,4481,4481,8962,60,0.038196,0.052709,8,0,0
8502599,"Weinfelden, Dunantstrasse",,0.000028,20,1,2,3,3276,3373,6649,47,0.047697,0.067367,3190,0,0
8506553,"Rothenhausen, Dorf",,0.000023,20,1,2,3,1450,2057,3507,46,0.049237,0.072086,3186.5,0,0
8502602,"Olten, Fustlighalde",,0.000014,94,1,1,2,13979,15493,29472,26,0.098352,0.119911,3,0,0
8502603,"Olten, Höhenstrasse West",,0.000023,94,1,1,2,15493,15493,30986,25,0.108527,0.135292,198,0,0
8502604,"Olten, Höhenstrasse Ost",,0.00003,94,1,1,2,15493,15493,30986,24,0.121118,0.156967,391,0,0
8502616,"Hattenhausen, Dorf",,0.000011,65,0,2,2,0,4801,4801,52,0.038412,0.049583,0,0,0
8502744,"Märstetten, Gemeindehaus",,0.000016,65,1,1,2,4681,4679,9360,52,0.03839,0.049018,0,0,0
8502617,"Kümmertshausen, Oberlöwenhaus",,0.000011,65,0,1,1,0,4704,4704,26,0.06305,0.0804,0,0,0
8502618,"Flüh, Mühle",,0.000037,54,2,1,3,7249,7307,14556,12,0.185567,0.283512,69.6,0,0
8572162,"Mariastein, Metzerlenstrasse",,0.000085,54,1,1,2,5664,3126,8790,12,0.185567,0.283512,454,0,0
8502623,"Claro, Scubiago",,0.000011,108,0,1,1,0,4963,4963,32,0.075472,0.087248,0,0,0
8502624,"Claro, Paese",,0.00002,108,1,1,2,4963,5084,10047,31,0.081424,0.095178,391,0,0
8502625,"Claro, San Nazzaro",,0.000028,108,1,1,2,5084,5023,10107,30,0.088415,0.105124,780,0,0
8502626,"Claro, Bivio Ponton",,0.000035,108,1,1,2,5023,5084,10107,29,0.096742,0.118099,1167,0,0
8502627,"Claro, Cassero",,0.00004,108,1,1,2,5084,5084,10168,28,0.106828,0.136077,1552,0,0
8575221,"Biasca, Stazione",,0.000156,108,6,9,15,72658,69520,142178,27,0.12479,0.184561,38314.116667,0,0
8575223,"Bellinzona, S. Paolo Posta",,0.000058,108,1,4,5,47578,47578,95156,27,0.120467,0.169964,1251.5,0,0
8570732,"Sion, Nord",,0.000033,39,3,7,10,6067,16703,22770,21,0.114998,0.180706,1847.994048,0,0
8502629,"Güttingen, Schulhaus",,0.000011,65,0,1,1,0,4678,4678,35,0.04475,0.060352,0,0,0
8502631,"Güttingen, Bahnhof",,0.00002,65,1,1,2,4678,4678,9356,34,0.046667,0.063948,259,0,0
8502633,"Lostorf, Buechehof",,0.000011,94,0,1,1,0,8668,8668,22,0.129176,0.170837,0,0,0
8502634,"Lostorf, Mahren",,0.00002,94,1,3,4,8668,8668,17336,21,0.147059,0.213411,115,0,0
8577989,"Obergösgen, Schulhaus",,0.000047,94,1,1,2,48231,48230,96461,21,0.121564,0.1616,1184,0,0
8577992,"Lostorf, Pfarrhof",,0.000022,94,1,1,2,40247,40250,80497,21,0.135787,0.180442,700.733333,0,0
8502636,"Noville, Les Saviez",,0.00002,103,1,1,2,4609,7583,12192,17,0.120941,0.152461,108,0,0
8502637,"Noville, la Mounie",,0.000028,103,1,3,4,7583,7584,15167,16,0.136306,0.18417,214,0,0
8506941,"Vionnaz, Ravines",,0.000022,103,1,1,2,4608,4609,9217,20,0.085868,0.108887,154,0,0
8557105,"Noville, Collège",,0.000038,103,2,1,3,4875,4875,9750,19,0.092955,0.117657,244,0,0
8502670,"Büttikon AG, Brunnächer",,0.000011,115,0,1,1,0,4128,4128,20,0.113351,0.12902,0,0,0
8502702,"Wohlen AG, Kirchenplatz",,0.000019,115,1,1,2,3859,3859,7718,20,0.113351,0.12902,939,0,0
8502711,"Waltenschwil, Hessel",,0.000042,115,1,1,2,2975,5253,8228,20,0.113351,0.12902,2985,0,0
8502752,"Hägglingen, Schulhaus",,0.000019,115,1,1,2,1832,1831,3663,20,0.113351,0.12902,939,0,0
8502682,"Küttigen, Grossmatt",,0.000029,57,2,1,3,7953,7857,15810,37,0.047613,0.060722,303,0,0
8502684,"Küttigen, Hinterrain",,0.00002,57,1,1,2,15319,15319,30638,37,0.047613,0.060722,1182,0,0
8502683,"Küttigen, Post",,0.000011,57,0,1,1,0,15319,15319,38,0.045486,0.056064,0,0,0
8502893,"Staffelegg, Passhöhe",,0.000038,57,2,2,4,8491,8479,16970,36,0.049922,0.067282,614.5,0,0
8502689,"Dottikon, Sternenplatz",,0.000011,115,0,1,1,0,3785,3785,22,0.092653,0.101664,0,0,0
8502690,"Baden, Sonnmatt",,0.000011,22,0,3,3,0,28090,28090,23,0.10124,0.127596,0,0,0.000033
8502774,"Fislisbach, Post",,0.000024,22,2,4,6,10349,10817,21166,23,0.096743,0.118569,817.767716,0.000001,0.000092
8502899,"Wohlenschwil, Zentrum",,0.000025,22,1,2,3,7391,7391,14782,23,0.095674,0.113578,4924,0,0.000073
8503767,"Nussbaumen AG, Landschreiber",,0.00002,22,1,2,3,10274,23015,33289,26,0.088861,0.116852,253.366667,0.000001,0.000027
8503779,"Kirchdorf AG, Landstrasse",,0.000024,22,1,3,4,17516,17516,35032,26,0.088297,0.115985,7851.115372,0,0.000098
8503875,"Rieden AG, Limmatsteg",,0.000018,22,1,2,3,12037,12037,24074,26,0.088093,0.11416,15,0.000002,0.000094
8503879,"Widen, Imbismatt",,0.000036,22,4,2,6,8170,7727,15897,21,0.110287,0.132725,11069.627057,0.000002,0.000049
8507592,"Wettingen, Zirkuswiese",,0.000023,22,2,4,6,12661,13542,26203,26,0.088545,0.118508,1130.471323,0.000007,0.000125
8502701,"Wohlen AG, Jurastrasse",,0.00002,115,1,2,3,3785,5691,9476,21,0.102005,0.114121,941,0,0
8502705,"Windisch, Kath. Kirche",,0.00002,22,1,1,2,4832,4832,9664,13,0.15534,0.247717,16,0,0
8502874,"Mülligen, Rösslimatte",,0.000027,22,1,2,3,5172,5171,10343,25,0.081121,0.093248,2989,0,0.000002
8502773,"Oberrohrdorf, Post",,0.00004,22,3,4,7,17815,17813,35628,23,0.096126,0.115897,1180.5,0,0.000046
8502708,"Besenbüren, Dorf",,0.000023,115,2,1,3,2976,2793,5769,23,0.084811,0.091814,204,0.001212,0
8502709,"Bünzen, Freienhof",,0.00003,115,1,1,2,2793,2976,5769,22,0.092573,0.10124,1133,0,0
8502710,"Waldhäusern AG, Burehof",,0.000037,115,1,1,2,2976,2975,5951,21,0.101908,0.113178,2060,0,0
8507305,"Zofingen, Frikartstrasse",,0.000036,94,3,2,5,16184,16158,32342,11,0.261194,0.371758,178.75,0,0
8502733,"Küblis, Fryegg",,0.000011,112,0,1,1,0,3563,3563,16,0.12464,0.154697,0,0,0
8557021,"Luzein, Sprecherhaus",,0.00006,112,2,1,3,3649,3649,7298,16,0.12464,0.154697,3822,0,0
8574848,"Davos Dorf, Bahnhof",,0.000113,131,4,12,16,20476,72190,92666,15,0.146316,0.218806,107536.897436,0,0
8575070,"Schiers, Hinterdorf",,0.000055,112,2,3,5,2615,2615,5230,16,0.127298,0.164955,15286.933333,0,0
8575080,"Fideris, Dorf",,0.000042,112,1,2,3,3848,3626,7474,15,0.137931,0.175976,1189.066667,0,0
8502735,"Pailly, Moulin-Pacot",,0.000011,35,0,1,1,0,3912,3912,31,0.06761,0.086749,0,0,0
8505056,"St. Moritz Bad, Signalbahn",,0.000013,30,1,5,6,2751,12098,14849,9,0.267399,0.346227,25.142857,0,0
8509605,"Surlej, Corvatschbahn",,0.000017,30,2,3,5,8337,8336,16673,10,0.229032,0.296859,9,0,0
8509606,"Sils/Segl, Furtschellasbahn",,0.000016,30,1,1,2,2775,2767,5542,10,0.220126,0.268243,0,0,0
8509794,"Maloja, Posta",,0.000017,30,2,1,3,3234,3234,6468,11,0.173028,0.200305,0,0,0
8509880,"Sils/Segl, Dotturas",,0.000031,30,3,1,4,3692,3692,7384,10,0.206154,0.241945,67,0,0
8502746,"Warth, Rohr",,0.000011,65,0,2,2,0,6663,6663,41,0.049374,0.073742,0,0,0
8506758,"Herdern, Dorf",,0.000035,65,1,2,3,8070,8232,16302,41,0.049374,0.073742,1503,0,0
8506760,"Hüttwilen, Zentrum",,0.00003,65,2,2,4,6102,6102,12204,41,0.049285,0.072889,5,0,0
8506888,"Nussbaumen TG, Schulhaus",,0.000024,65,1,1,2,5216,5216,10432,41,0.049192,0.071031,0,0,0
8502748,"Kirchleerau, Abzw./Bank",,0.000046,59,2,1,3,7444,8983,16427,50,0.072821,0.111995,1574,0,0
8502754,"Neuenkirch, Post",,0.000011,59,0,3,3,0,14422,14422,45,0.091492,0.150952,0,0,0
8505431,"Root, Wiesstrasse",,0.000011,90,0,2,2,0,39056,39056,43,0.095164,0.149629,0,0,0
8505663,Holderkäppeli,,0.000011,90,0,3,3,0,4589,4589,46,0.087886,0.143618,0,0,0
8573006,"Sempach Stadt, Seesatz",,0.000058,59,1,1,2,17061,17053,34114,45,0.063636,0.091723,40507.5,0,0
8573034,"Emmenbrücke, Strassenkreuz",,0.000044,90,3,3,6,18208,18208,36416,21,0.104738,0.157606,9188.333333,0,0
8573004,"Sempach Stadt, Meierhöfli",,0.000039,59,1,1,2,8999,8999,17998,47,0.056657,0.074978,38987,0,0
8502758,"Hausen am Albis, Post",,0.000017,115,2,5,7,5226,8533,13759,32,0.097856,0.121376,1338.166667,0.012459,0.00093
8502762,"Langnau a.A., Albispasshöhe",,0.000014,115,1,1,2,1231,1231,2462,32,0.090519,0.105776,0,0.000021,0.000022
8502798,"Baar, Bahnhof",,0.000014,115,1,1,2,1987,1987,3974,32,0.096358,0.115878,0,0.000021,0.000843
8502760,"Hütten, Schöntal",,0.000011,63,0,2,2,0,7705,7705,18,0.105963,0.131482,0,0,0
8502954,"Schönenberg ZH, Tanne",,0.000016,63,1,3,4,7600,8208,15808,18,0.10734,0.138723,37.668831,0,0
8502763,"Hausen am Albis, Riedmatt",,0.000026,115,2,1,3,3297,3297,6594,31,0.099446,0.119805,1508.917112,0.000022,0
8502776,"Gattikon, Obstgarten",,0.000018,115,1,2,3,1228,3149,4377,29,0.110255,0.135843,788,0.000343,0.000872
8502961,"Hausen am Albis, Albisbrunn",,0.000037,115,4,2,6,2161,2162,4323,31,0.106545,0.13365,3379.165775,0.000843,0.001248
8502765,"Holziken, Abzw. Bändli",,0.000019,94,1,1,2,6224,6256,12480,62,0.037901,0.055384,16,0,0
8502768,"Uerkheim, Post",,0.000066,94,3,1,4,13597,13609,27206,60,0.040882,0.066608,3976,0,0
8502892,"Walde AG, Zentrum",,0.000067,59,2,1,3,4602,4601,9203,58,0.041214,0.061708,6000,0,0
8502998,"Sursee, Bahnhof",,0.000105,59,9,15,24,43896,57642,101538,48,0.084897,0.165635,13815.583333,0,0
8507415,"Triengen, Gisler",,0.000026,59,2,2,4,7341,7341,14682,57,0.042882,0.066388,1.166667,0,0
8502896,"Oberrohrdorf, Staretschwil",,0.000019,22,1,4,5,5696,5698,11394,23,0.099898,0.122318,601.04098,0.000001,0.00005
8572550,"Baden, Postautostation",,0.000085,22,6,3,9,26181,26724,52905,24,0.094702,0.117411,111879.407458,0.000079,0.0002
8572553,"Fislisbach, Gemeindehaus",,0.000048,22,2,4,6,15774,15162,30936,24,0.098189,0.128084,2475.375779,0.000001,0.00131
8572554,"Fislisbach, Monopol",,0.000021,22,1,1,2,4839,4839,9678,24,0.088816,0.101799,0,0.00003,0.000039
8557043,"Ennetbaden, Rütenen-Felmen",,0.00005,22,2,3,5,15295,15295,30590,25,0.089044,0.110642,7701.605865,0.000001,0.000083
8572387,"Baden, Lindenplatz",,0.000067,22,7,11,18,48858,52212,101070,25,0.096494,0.13709,18363.76477,0.000027,0.002824
8572500,"Tegerfelden, Kirche",,0.000042,22,2,2,4,3164,3164,6328,25,0.088172,0.107727,94441.516215,0.000002,0.000081
8572531,"Koblenz, Bahnhof",,0.000021,98,1,1,2,96,96,192,25,0.086593,0.102471,2854.5,0,0.000079
8572547,"Wohlenschwil, Mühlematten",,0.000034,22,1,2,3,7391,7391,14782,25,0.089592,0.109046,1067.666667,0,0.000272
8502873,"Gebenstorf, alte Post",,0.000018,22,2,3,5,7337,19461,26798,30,0.074467,0.100713,571.311167,0,0.000006
8502992,"Langnau am Albis, Unteralbis",,0.000024,115,1,1,2,1228,1231,2459,29,0.061247,0.070509,3349,0.000368,0.000021
8503877,"Turgi, Bahnhof",,0.000024,22,1,3,4,9780,9780,19560,22,0.119855,0.147194,4364.925649,0,0.000011
8503881,"Mellingen, Meierhofer",,0.000021,22,2,2,4,7340,7340,14680,23,0.107432,0.127816,54.561752,0,0.000074
8503886,"Gebenstorf, Waldheim",,0.000026,22,1,2,3,12124,12124,24248,22,0.119512,0.144485,1087.80943,0,0.000161
8502879,"Jonen, Taverne",,0.000043,85,4,4,8,11891,12146,24037,19,0.140348,0.164984,4551.623829,0.0015,0.005541
8572635,"Muri AG, Industriegebiet",,0.000034,115,2,2,4,2986,3095,6081,19,0.124186,0.141636,209.333333,0.000968,0.000091
8502950,"Birmensdorf ZH, Zentrum",,0.000039,85,3,4,7,18186,18880,37066,19,0.14044,0.164929,1747.495094,0.000655,0.020638
8502955,"Oberlunkhofen, Post",,0.000025,85,2,2,4,9113,9113,18226,19,0.139315,0.161375,1191.908535,0.00049,0.002068
8510050,"Unterlunkhofen, Mühlegg",,0.000027,85,2,2,4,7862,9113,16975,19,0.123089,0.138664,11.333333,0.001042,0.003466
8502882,"Maschwanden, Dorf",,0.000011,115,0,1,1,0,4525,4525,11,0.151163,0.247683,0,0,0
8502883,"Zwillikon, Gemeindeplatz",,0.000011,115,0,1,1,0,2944,2944,18,0.134861,0.158326,0,0,0.005045
8502953,"Affoltern a.A., Kronenplatz",,0.000016,115,1,1,2,3163,6056,9219,18,0.134861,0.158326,368.650446,0.00046,0.005045
8502960,"Obfelden, Unterlunnern",,0.000032,115,2,2,4,10462,10462,20924,18,0.136283,0.160471,3512.108797,0.000003,0.005167
8572606,"Ottenbach, Ulmenhof",,0.000033,115,1,1,2,2986,2988,5974,18,0.134861,0.158326,1772.666667,0,0.005045
8573171,"Rifferswil, Unterrifferswil",,0.000037,115,1,1,2,3162,3162,6324,18,0.134861,0.158326,2667.917112,0,0.005045
8502890,"Merenschwand, Zentrum",,0.000032,115,2,3,5,7840,7840,15680,19,0.122914,0.142247,1630.820084,0.000001,0.000128
8502885,"Bonstetten, Dorfplatz",,0.000011,85,0,2,2,0,2803,2803,20,0.12178,0.142123,0,0,0.004576
8573712,"Wettswil a.A., Bäumlisächer",,0.000037,85,3,1,4,5107,5105,10212,21,0.108576,0.122239,311.83105,0.002221,0.004377
8573713,"Wettswil a.A., Grund",,0.000066,85,4,1,5,9894,10538,20432,20,0.121633,0.140943,1455.239182,0.004377,0.000198
8573718,"Birmensdorf ZH, Bahnhof",,0.000071,85,6,5,11,19575,24430,44005,19,0.148669,0.177598,33419.161405,0.010264,0.003054
8573724,"Stallikon, Aegerten",,0.000063,85,4,2,6,5203,5222,10425,20,0.123116,0.14479,4092.680148,0.000131,0.00056
8573725,"Islisberg, Dorf",,0.000033,85,1,1,2,1729,1813,3542,20,0.121633,0.140943,1446.865716,0,0.000198
8502888,"Mellingen, Lindenplatz",,0.000033,22,3,2,5,12223,12195,24418,24,0.088025,0.102882,4140.666667,0.000002,0
8502952,"Scherz, Dorfplatz",,0.000045,22,1,2,3,5155,5155,10310,11,0.194444,0.346658,47,0,0
8572619,"Wohlen AG, Nordstrasse",,0.000058,115,1,2,3,3785,3785,7570,24,0.099413,0.115482,5484,0,0.001168
8572608,"Merenschwand, Allmend Gut",,0.000034,115,2,1,3,7517,7517,15034,19,0.122682,0.140394,49,0.000122,0.000003
8572687,"Oftringen, alte Strasse",,0.000052,94,1,1,2,22059,22059,44118,11,0.167139,0.204595,177,0,0
8572390,"Küttigen, Kreuz",,0.000028,57,1,4,5,23245,23245,46490,40,0.042216,0.060395,2294.461538,0,0
8502895,"Freienwil, Dorf",,0.000011,22,0,3,3,0,8034,8034,29,0.071072,0.08561,0,0,0
8503575,"Döttingen, Chunte",,0.000014,22,1,1,2,96,96,192,29,0.066399,0.075682,0,0,0
8503582,"Endingen, Zentrum",,0.000033,22,1,3,4,12406,12405,24811,27,0.076409,0.092227,2268.1,0,0
8503584,"Tegerfelden, Hochbrücke",,0.000028,22,1,1,2,3163,3164,6327,29,0.070765,0.082835,1005,0,0
8572551,"Dättwil AG, Täfere",,0.000039,22,2,1,3,15976,15561,31537,25,0.089498,0.10954,627.676068,0.000006,0.000001
8502898,"Reiden, Bahnhof",,0.000101,94,3,3,6,34686,34686,69372,13,0.174157,0.246781,882,0,0
8572726,"Brittnau, Abzw. Bahnhof",,0.000109,94,2,2,4,22080,22080,44160,6,0.303371,0.360494,671,0,0
8502907,Trimsteinstrasse,,0.000011,100,0,2,2,0,7566,7566,17,0.156217,0.215884,0,0,0
8503334,Bächlen,,0.000044,100,1,1,2,1920,1919,3839,17,0.153017,0.206467,568,0,0
8506906,Münsingen Bahnhof West,,0.000011,100,0,1,1,0,2740,2740,17,0.153017,0.206467,0,0,0
8507789,Gerzensee Dorf,,0.000035,100,1,3,4,6788,6788,13576,16,0.170644,0.239902,429,0,0
8502909,Eichi,,0.000016,100,1,1,2,1909,1920,3829,20,0.107195,0.131395,4,0,0
8502910,Trimstein Schule,,0.000024,100,1,2,3,1920,1909,3829,19,0.119243,0.151434,148,0,0
8502911,Trimstein Dorf,,0.000021,100,1,1,2,255,253,508,19,0.118519,0.145541,0,0,0
8502912,Richigen Niederhaus,,0.000039,100,2,1,3,1907,1920,3827,18,0.13352,0.169218,430,0,0
8502940,"Sirnach, Pumpwerkstrasse",,0.000011,20,0,1,1,0,10127,10127,50,0.039154,0.04994,0,0,0
8503689,"Stallikon, Wolfenhof",,0.000017,85,1,1,2,3907,3891,7798,20,0.107809,0.118792,0,0.017286,0.018182
8502951,"Habsburg, Dorfplatz",,0.00004,22,2,1,3,5199,5155,10354,12,0.172414,0.279103,40,0,0
8502966,"Birrhard, Usserdorf",,0.000044,22,2,2,4,5127,5172,10299,10,0.213115,0.366331,200.666667,0,0
8503754,"Horgenberg, Wührenbach",,0.00002,63,2,2,4,699,1718,2417,17,0.117912,0.154369,936.664502,0,0
8503798,"Wädenswil, Bahnhof",,0.000036,63,2,13,15,30343,76221,106564,17,0.121029,0.181967,1197.504329,0,0
8503855,"Horgen, Bahnhof",,0.000022,63,2,14,16,8919,26077,34996,16,0.127512,0.181537,2725.162338,0,0
8502958,"Münchwilen TG, Eschlikonerstr.",,0.00002,20,1,1,2,10127,10127,20254,49,0.040722,0.053159,1498,0,0
8572965,"Schenkon, Zellfeld",,0.000041,59,2,3,5,21329,21329,42658,49,0.052849,0.076933,41195.966667,0,0
8502969,"Scherz, Rüchlig",,0.000048,22,2,2,4,5200,4873,10073,10,0.206897,0.369081,51.666667,0,0
8502979,"Oberwil-Lieli, Lieli Dorf",,0.000025,85,2,2,4,16820,16820,33640,20,0.115267,0.129946,86.316667,0.000953,0
8503551,"Birmensdorf ZH, Landikon Bach",,0.000012,85,1,1,2,966,968,1934,20,0.112975,0.124668,14.333333,0.012165,0
8572595,"Birmensdorf ZH, Altenberg",,0.000017,85,1,1,2,12202,12202,24404,21,0.102012,0.113259,5537.566667,0.00003,0
8507590,"Wettingen, Bahnhofplatz",,0.000016,22,1,4,5,11829,15278,27107,27,0.085425,0.116524,445.066667,0.000004,0.000041
8502985,"Gebenstorf, Gemeindehaus",,0.000016,22,1,2,3,12124,19377,31501,29,0.073463,0.091493,456.5,0,0.000001
8503593,"Würenlingen, Weissenstein",,0.000042,57,2,3,5,7861,7861,15722,29,0.071497,0.088083,4340.241892,0,0.000001
8503599,"Villigen, PSI Ost",,0.000049,57,2,4,6,16267,17788,34055,29,0.071762,0.089612,3664.241892,0,0.000001
8502991,"Kappel am Albis, Kloster",,0.000022,115,1,1,2,1985,1987,3972,18,0.127675,0.147843,0,0.000461,0.004348
8502996,"Aarau, Bahnhof",,0.00005,57,2,7,9,23677,81983,105660,35,0.052465,0.076097,6722.5,0,0
8572388,"Aarau, Aarepark",,0.000017,57,1,4,5,42089,42089,84178,42,0.039281,0.057081,266.5,0,0
8572395,"Ueken, Unterdorf",,0.000056,57,1,1,2,8169,8169,16338,35,0.050487,0.059649,7747.5,0,0
8578007,"Erlinsbach, Dorfplatz",,0.000014,57,1,2,3,14921,14921,29842,16,0.155963,0.215297,132,0,0
8578644,"Aarau, Rathaus",,0.000023,57,1,7,8,48055,41416,89471,11,0.206349,0.323755,2107.9,0,0
8578642,"Aarau, Kunsthaus",,0.000033,57,4,6,10,68333,68333,136666,15,0.17265,0.265689,856.301282,0,0
8578643,"Aarau, Holzmarkt",,0.000041,57,2,3,5,48276,48319,96595,12,0.178862,0.256104,3530,0,0
8578652,"Erlinsbach, Oberdorf",,0.000062,57,2,2,4,18797,18797,37594,8,0.258621,0.372302,405,0,0
8590133,"Aarau, Bavaria",,0.00005,57,3,1,4,18141,18141,36282,10,0.191083,0.257579,957.6,0,0
8590137,"Aarau, Dammweg",,0.000032,57,2,2,4,6452,6452,12904,10,0.202703,0.300913,155.184615,0,0
8508450,"Luzern, Bahnhof",,0.000022,90,3,11,14,6228,670495,676723,45,0.095443,0.176378,1833.357143,0,0
8508650,"Ettiswil, Post",,0.000019,90,2,7,9,6150,8760,14910,47,0.085237,0.157043,6015.666667,0,0
8508653,"Nebikon, Maschinenfabrik",,0.000015,59,1,4,5,7831,9450,17281,52,0.052956,0.089865,334.566667,0,0
8510053,"St. Erhard, Galerie",,0.000017,59,1,2,3,2089,2089,4178,51,0.055276,0.092083,0,0,0
8572648,"Schöftland, Bahnhof",,0.000113,59,6,4,10,19023,19841,38864,57,0.042914,0.070337,31433.166667,0,0
8572666,"Reitnau, Unterdorf",,0.000053,59,1,2,3,8023,6324,14347,57,0.040964,0.057045,2264,0,0
8572670,"Triengen, Grund",,0.000042,59,1,1,2,12725,13080,25805,55,0.044232,0.059065,33672,0,0
8508899,"Ruswil, Rottalcenter",,0.000019,90,2,5,7,4825,8000,12825,47,0.083204,0.152124,6802.633333,0,0
8557090,"Dagmersellen, Bahnhof",,0.000037,59,2,4,6,11050,11180,22230,51,0.055561,0.099325,1615.566667,0,0
8572676,"Geuensee, Zollhaus",,0.000061,59,1,1,2,15969,15969,31938,51,0.053328,0.085233,35668,0,0
8572788,"Willisau, Bahnhof",,0.000054,59,4,5,9,12291,12579,24870,51,0.054906,0.097178,3833.633333,0,0
8572805,"Ettiswil, Oberdorf",,0.000031,59,1,3,4,3487,3487,6974,51,0.053864,0.09141,2798,0,0
8577298,"Buttisholz, Guglern",,0.000044,92,1,1,2,5575,5575,11150,8,0.235772,0.294951,2287,0,0
8577299,"Buttisholz, Dorf",,0.000057,92,3,4,7,5675,5675,11350,7,0.297872,0.410459,2586.083333,0,0
8577327,"Oberkirch, Dorf",,0.000045,92,1,1,2,1825,1825,3650,7,0.234043,0.314502,957,0,0
8577328,"Oberkirch, Länggasse",,0.000067,92,3,1,4,3700,3700,7400,6,0.277778,0.356667,1630,0,0
8577322,"Kottwil, Dorf",,0.000049,59,1,1,2,2950,2950,5900,7,0.263158,0.326381,345,0,0
8581081,"Sursee, Waldegg",,0.000056,59,3,1,4,4664,4664,9328,7,0.263158,0.326381,685.033333,0,0
8582782,"Oberkirch LU, CAMPUS Sursee",,0.000047,59,2,3,5,8423,8423,16846,5,0.421053,0.597917,702.8,0,0
8503003,Zürich Stadelhofen,,0.000023,9,2,7,9,172993,173093,346086,29,0.083649,0.115047,7956.046104,0,0
8503004,Zürich Tiefenbrunnen,,0.000014,9,1,3,4,38662,38662,77324,29,0.082432,0.108331,49.3,0,0
8503009,Zürich Wollishofen,,0.000023,9,2,1,3,38984,38984,77968,30,0.079309,0.101076,0,0,0
8503011,Zürich Wiedikon,,0.000023,9,1,5,6,55980,55980,111960,29,0.084712,0.112852,1696.333333,0,0
8503015,Zürich Wipkingen,,0.000017,9,2,1,3,19870,19870,39740,29,0.084379,0.109737,0,0,0
8503201,Rüschlikon,,0.000038,9,1,1,2,38984,38984,77968,29,0.085243,0.110946,3295.011905,0,0
8503204,Horgen,,0.000034,9,2,2,4,36609,36609,73218,30,0.080056,0.099455,2177,0,0
8503205,Au ZH,,0.000025,9,1,1,2,19613,19589,39202,30,0.080017,0.09898,0,0,0
8503141,Küsnacht Goldbach,,0.000043,9,2,1,3,35397,15600,50997,28,0.088381,0.110127,11348.5,0,0
8503503,Turgi,,0.00018,9,10,2,12,79849,61495,141344,28,0.088386,0.110436,29935.833369,0,0
8506319,Altstätten SG,,0.000077,18,2,4,6,29288,29069,58357,24,0.087105,0.134562,7732.633333,0,0
8508100,Langenthal,,0.000102,9,5,4,9,53155,74635,127790,24,0.089455,0.136487,51502.507143,0,0
8509004,Bad Ragaz,,0.000023,28,2,2,4,34654,34654,69308,5,0.409091,0.531481,584.533333,0,0
8509402,Salez-Sennwald,,0.000118,28,1,1,2,10039,10007,20046,6,0.310345,0.401852,36,0,0
8503008,Zürich Affoltern,,0.000024,9,2,1,3,21119,21119,42238,30,0.084195,0.109184,1946,0,0
8503109,Feldbach,,0.000047,9,1,1,2,19395,19395,38790,30,0.080514,0.10121,7657,0,0
8503122,Bubikon,,0.000022,9,1,1,2,37680,37694,75374,30,0.078274,0.096913,1324,0,0
8503123,Wetzikon ZH,,0.000037,9,4,5,9,75756,76013,151769,29,0.084877,0.110963,3994.766667,0,0
8503124,Aathal,,0.000017,9,1,1,2,19578,19578,39156,30,0.079853,0.098755,0,0,0
8503134,Bauma,,0.000022,9,1,2,3,15096,19746,34842,29,0.082605,0.105248,4057.888889,0,0
8503139,Tann-Dürnten,,0.000045,9,1,1,2,15096,14845,29941,29,0.082411,0.104145,6372,0,0
8503307,Bassersdorf,,0.000078,9,3,3,6,39438,36175,75613,29,0.0835,0.107482,4819.111111,0,0
8503340,Opfikon,,0.000044,9,1,1,2,19318,19318,38636,29,0.082411,0.104145,3186,0,0
8503512,Glanzenberg,,0.000047,9,2,2,4,38323,37067,75390,29,0.082428,0.104647,9162.656169,0,0
8503007,Zürich Seebach,,0.000013,9,1,1,2,18864,18864,37728,31,0.077694,0.095907,0,0,0
8503125,Uster,,0.000037,9,4,4,8,75868,75868,151736,29,0.086738,0.113327,5847.668254,0,0
8503110,Rapperswil SG,,0.000062,9,5,8,13,57839,96066,153905,29,0.087519,0.117635,15537.940476,0,0
8503128,Dübendorf,,0.000035,9,1,2,3,38708,38710,77418,31,0.081159,0.103951,3909.638095,0,0
8503129,Wallisellen,,0.000038,9,4,4,8,54008,53506,107514,30,0.077564,0.098894,2322.444444,0,0
8503112,Kempraten,,0.000039,9,2,3,5,19372,19395,38767,29,0.084812,0.105305,2262.773016,0,0
8503210,Freienbach SBB,,0.000017,9,1,2,3,19589,19339,38928,30,0.079317,0.096917,291.388095,0,0
8503303,Illnau,,0.000049,9,1,1,2,24253,24253,48506,30,0.077267,0.093691,4993,0,0
8503304,Kemptthal,,0.000035,9,4,1,5,19513,19593,39106,30,0.077267,0.093691,0,0,0
8503305,Effretikon,,0.000134,9,9,2,11,92512,92366,184878,29,0.083686,0.106088,17256.584127,0,0
8503100,Zollikon,,0.000017,9,2,1,3,35397,35397,70794,35,0.065496,0.075703,1.5,0,0
8503101,Küsnacht ZH,,0.000028,9,2,2,4,37146,37146,74292,34,0.070051,0.08299,2455,0,0
8503103,Herrliberg-Feldmeilen,,0.00003,9,1,2,3,35397,35397,70794,34,0.074362,0.089985,1941,0,0
8503130,Hinwil,,0.000025,9,2,1,3,19108,250,19358,29,0.082976,0.103181,760.035714,0,0
8503525,Otelfingen Golfpark,,0.000018,9,1,1,2,18864,18864,37728,4,0.4,0.520833,336,0,0
8503209,Pfäffikon SZ,,0.000081,9,7,12,19,94097,94697,188794,28,0.093826,0.130044,40750.852381,0,0
8503022,"Münchwilen TG, Bahnhof",,0.000028,20,1,2,3,10127,24189,34316,48,0.042422,0.057228,2994,0,0
8503031,"St. Margarethen TG, Dorf",,0.000023,20,1,1,2,10127,9823,19950,47,0.044165,0.060098,4453.5,0,0
8503032,"Münchwilen TG, Oberhofen",,0.00003,20,1,1,2,9823,10127,19950,46,0.046175,0.065412,5942.5,0,0
8503040,"Collex, Crest-d'El",,0.000011,120,0,1,1,0,863,863,20,0.109291,0.118723,0,0,0
8503046,"Versoix, Machefer",,0.00002,120,1,1,2,863,867,1730,19,0.12252,0.135197,673,0,0
8503243,"Bellevue GE, Roselière",,0.000045,120,1,2,3,13679,13679,27358,19,0.122931,0.137309,2043,0,0
8510221,"Genthod, Centre ornithologique",,0.000042,120,1,1,2,10419,10420,20839,19,0.12252,0.135197,1346,0,0
8503049,"Genthod, le Haut",,0.000011,120,0,1,1,0,13532,13532,20,0.11495,0.12653,0,0,0
8503051,Zürich Binz,,0.000011,7,0,2,2,0,40054,40054,9,0.220779,0.346475,0,0,0
8503054,Zürich Triemli,,0.000031,7,1,2,3,38889,38944,77833,9,0.225806,0.376672,31,0,0
8503055,Uitikon Waldegg,,0.000024,7,1,2,3,19371,19370,38741,9,0.220339,0.380006,8,0,0
8503056,Ringlikon,,0.000021,7,1,2,3,18884,18382,37266,9,0.210526,0.370007,5,0,0
8503057,Uetliberg,,0.00002,7,1,1,2,16931,16931,33862,9,0.196429,0.312734,0,0,0
8503087,Zürich Saalsporthalle,,0.00002,7,1,1,2,37437,37437,74874,9,0.196429,0.312734,11,0,0
8503052,Zürich Friesenberg,,0.000016,7,1,1,2,38944,38944,77888,11,0.172043,0.259007,5,0,0
8503053,Zürich Schweighof,,0.000024,7,1,1,2,38944,38889,77833,10,0.194805,0.296376,19,0,0
8503059,"Zürich Stadelhofen, Bahnhof",,0.000011,85,0,8,8,0,175188,175188,18,0.141241,0.183428,0,0,0.035546
8503060,Esslingen,,0.000012,85,1,1,2,20498,25318,45816,23,0.088946,0.099611,0,0.000821,0.00084
8503061,Langwies ZH,,0.000022,85,2,2,4,30738,25366,56104,22,0.097536,0.112118,1033.333333,0.00084,0.000885
8503064,Scheuren,,0.000028,85,1,1,2,24735,24140,48875,20,0.100429,0.113044,1114.38474,0,0.00084
8503066,Zumikon,,0.00004,85,3,3,6,29010,33221,62231,21,0.107621,0.126779,3296.758117,0.000044,0.000938
8503065,Forch,,0.000036,85,2,3,5,38480,34611,73091,19,0.111533,0.129585,2141.218074,0.00084,0.000977
8503072,Neuhaus bei Hinteregg,,0.000032,85,2,3,5,25520,22882,48402,19,0.113576,0.133066,1107.721216,0.000003,0.000978
8503078,Waldburg,,0.000049,85,1,1,2,32825,32464,65289,19,0.110013,0.123871,1940.38474,0,0.000886
8573710,"Zürich, Bahnhof Wiedikon",,0.000133,85,15,13,28,206211,231058,437269,16,0.170356,0.225951,104924.979369,0.074282,0.747685
8576182,"Zürich, Bahnhof Tiefenbrunnen",,0.000059,85,4,5,9,58620,197619,256239,16,0.157051,0.195624,40058.078527,0.029183,0.058018
8503062,Egg,,0.000022,85,2,2,4,25524,25520,51044,22,0.097478,0.111985,8.333333,0.000841,0.000045
8503063,Hinteregg,,0.00002,85,1,1,2,25088,24735,49823,21,0.091344,0.100924,88.38474,0.000001,0
8503068,Maiacher,,0.000017,85,1,3,4,32002,32043,64045,20,0.10951,0.127943,83.88474,0.000001,0.000099
8503067,Zollikerberg,,0.000023,85,2,3,5,32709,33062,65771,21,0.107551,0.126578,205.166667,0.000842,0.000051
8503070,Emmat,,0.000037,85,3,2,5,24333,25366,49699,20,0.109415,0.127092,846.681169,0.000046,0.000052
8503075,Waltikon,,0.000032,85,2,1,3,30594,32043,62637,21,0.090352,0.098659,131,0.000042,0.000001
8503074,Neue Forch,,0.000058,85,5,4,9,31920,31094,63014,22,0.116263,0.14295,6948.620493,0.000049,0.000862
8503189,"Riedikon, Dorf",,0.000048,84,2,1,3,21411,21408,42819,19,0.113177,0.13144,10124.101413,0,0.00002
8503198,"Esslingen, Bahnhof",,0.000064,84,2,3,5,21470,21473,42943,18,0.12748,0.155871,13286.887128,0.00002,0.000022
8506638,"Zollikerberg, Station/Q treff",,0.000042,85,2,3,5,621,2295,2916,17,0.13935,0.166064,15540.030759,0.00002,0.004876
8576224,"Zumikon, Gössikon",,0.000037,86,2,1,3,17137,17137,34274,15,0.106102,0.117674,6693,0,0.000779
8503077,Spital Zollikerberg,,0.000045,85,2,1,3,32791,32825,65616,20,0.099212,0.109676,1086.38474,0.000001,0
8503080,"Genthod, Rennex",,0.00002,120,1,2,3,13532,13532,27064,19,0.12969,0.146274,681,0,0
8503085,"Genthod, Pierre-Grise",,0.000019,120,1,2,3,3112,16720,19832,18,0.148504,0.172312,1342,0,0
8503083,"Zürich, Römerhof",,0.000012,85,1,4,5,54892,98737,153629,17,0.145259,0.183511,202.076222,0.000821,0.431494
8530812,"Zürich, Hegibachplatz",,0.000079,85,2,3,5,149437,242614,392051,17,0.140699,0.17133,9381.548325,0.017694,0.041041
8573244,"Glattbrugg, Unterriet",,0.000033,107,2,5,7,102815,102774,205589,21,0.151756,0.186065,6401.531519,0.000417,0.177793
8576200,"Zürich, Wildbachstrasse",,0.000051,85,1,6,7,170767,169752,340519,15,0.18547,0.230491,2668.783153,0,0.88769
8576240,"Zürich, Meierhofplatz",,0.000026,85,2,9,11,33970,121565,155535,19,0.157765,0.213677,6302.69136,0.034549,0.77371
8580449,"Zürich, Bahnhof Oerlikon",,0.000048,107,5,12,17,199285,287976,487261,18,0.173439,0.237933,30572.122667,0.055114,0.847478
8580912,"Zürich, Schaufelbergerstrasse",,0.000138,85,11,11,22,118494,146705,265199,17,0.17375,0.223116,66682.019994,0.119537,0.620373
8591063,"Zürich, Bahnhof Oerlikon Ost",,0.00013,85,7,14,21,300974,305292,606266,8,0.257208,0.307101,44903.010855,0.04647,0.130958
8591067,"Zürich, Bahnhofstrasse/HB",,0.000099,85,7,7,14,207185,207269,414454,9,0.233831,0.269523,27759.9877,0.183926,0.200431
8591073,"Zürich, Berninaplatz",,0.000064,85,5,5,10,120154,120884,241038,8,0.227431,0.259079,6735.186177,0.149823,0.050934
8591105,"Zürich, Bürkliplatz",,0.000188,85,7,10,17,301927,301854,603781,11,0.263636,0.315792,45448.581271,0.074768,0.100146
8591106,"Zürich, Butzenstrasse",,0.000128,130,6,11,17,129026,129021,258047,10,0.258212,0.308987,21506.73076,0.029465,0.176082
8591110,"Zürich, Löwenbräu",,0.000102,85,9,9,18,133768,134750,268518,9,0.258979,0.30402,16343.526603,0.249293,0.151057
8591119,"Zürich, Englischviertelstrasse",,0.000037,85,2,4,6,54900,54952,109852,9,0.220398,0.247186,1335.007054,0.041973,0.053255
8591126,"Zürich, Fellenbergstrasse",,0.000038,85,3,3,6,103212,103272,206484,9,0.203929,0.229523,2344.971383,0.045118,0.108178
8591138,"Zürich, Freihofstrasse",,0.000058,85,4,3,7,48110,48094,96204,8,0.230444,0.257077,3043.556559,0.072603,0.126182
8591173,"Zürich, Haldenbach",,0.000083,85,3,7,10,121083,121046,242129,7,0.253579,0.293798,5936.47243,0.010325,0.295753
8591184,"Zürich, Helvetiaplatz",,0.000051,85,4,7,11,101395,109890,211285,7,0.268351,0.316026,2778.984331,0.024416,0.345226
8587039,"Chambésy, fontaine",,0.000047,120,2,2,4,12192,38044,50236,18,0.157475,0.186243,3355,0,0
8587044,"Collex, centre",,0.000046,120,1,2,3,14882,14564,29446,18,0.14971,0.172856,2683.306213,0,0
8503086,Zürich Brunau,,0.000011,7,0,1,1,0,37437,37437,10,0.176471,0.280192,0,0,0
8503088,Zürich HB SZU,,0.000082,7,6,2,8,76988,76989,153977,8,0.222222,0.384286,90,0,0
8503089,Wildpark-Höfli,,0.000046,7,1,1,2,28627,28627,57254,8,0.204545,0.315873,0,0,0
8503090,Zürich Selnau,,0.000085,7,2,1,3,76989,37437,114426,7,0.228571,0.341964,88,0,0
8503091,Zürich Giesshübel,,0.000083,7,1,1,2,37437,37437,74874,6,0.259259,0.37381,84,0,0
8503093,Zürich Manegg,,0.000081,7,1,1,2,37437,37437,74874,5,0.3,0.413889,78,0,0
8503094,Zürich Leimbach,,0.00008,7,1,1,2,37437,37437,74874,4,0.357143,0.466667,70,0,0
8503095,Sood-Oberleimbach,,0.000079,7,1,1,2,37437,37437,74874,3,0.444444,0.541667,60,0,0
8503096,Adliswil,,0.000078,7,1,1,2,37437,37437,74874,2,0.6,0.666667,48,0,0
8503097,Langnau-Gattikon,,0.000077,7,1,2,3,37437,33233,70670,1,1,1,34,0,0
8503098,Sihlwald,,0.000044,7,1,1,2,4228,4228,8456,1,1,1,0,0,0
8503102,Erlenbach ZH,,0.000023,9,1,1,2,35397,35397,70794,35,0.069248,0.081367,258,0,0
8503104,Meilen,,0.000038,9,3,3,6,40363,39993,80356,33,0.075214,0.091271,5781.092857,0,0
8503105,Uetikon,,0.000022,9,1,2,3,35246,35246,70492,33,0.075178,0.090802,0,0,0
8503106,Männedorf,,0.000031,9,2,1,3,21144,21114,42258,33,0.064938,0.074715,2638,0,0
8503107,Stäfa,,0.000037,9,1,1,2,21114,21114,42228,32,0.069412,0.081513,4313,0,0
8503108,Uerikon,,0.000042,9,1,1,2,21114,19395,40509,31,0.07455,0.090018,5986,0,0
8503111,Winkel am Zürichsee,,0.00005,9,4,2,6,35395,35382,70777,29,0.083824,0.102347,9983.004762,0,0
8503113,Blumenau,,0.000017,9,1,1,2,9653,9653,19306,31,0.073855,0.088292,0,0,0
8503116,Uznach,,0.000038,9,1,5,6,19071,33786,52857,29,0.08656,0.11363,4696.2,0,0
8503206,Wädenswil,,0.000064,9,4,4,8,53179,73348,126527,29,0.086931,0.113751,12249.62381,0,0
8503207,Richterswil,,0.000024,9,1,2,3,36585,36585,73170,29,0.085861,0.110338,284,0,0
8503208,Bäch SZ,,0.000021,9,1,1,2,19589,19019,38608,29,0.085819,0.109868,0,0,0
8503115,Schmerikon,,0.000032,9,2,1,3,19206,19071,38277,30,0.079703,0.098779,3068.2,0,0
8503118,Benken SG,,0.000017,9,1,1,2,9623,9489,19112,29,0.084343,0.101064,0,0,0
8503117,Kaltbrunn,,0.000017,18,1,1,2,10152,10164,20316,30,0.073735,0.087935,0,0,0
8505018,Meggen Zentrum,,0.00006,9,3,3,6,18702,19301,38003,30,0.072973,0.09027,8043.585714,0,0
8503119,Schänis,,0.000032,9,2,1,3,16587,18799,35386,28,0.092058,0.115278,3708.25,0,0
8503223,Reichenburg,,0.000032,9,1,2,3,8683,8698,17381,28,0.092107,0.115805,1971,0,0
8503224,Bilten,,0.000024,9,1,1,2,7742,7742,15484,28,0.092058,0.115278,0,0,0
8503120,Jona,,0.000017,9,1,1,2,37694,37694,75388,32,0.071524,0.086636,2340.888889,0,0
8503121,Rüti ZH,,0.000026,9,1,2,3,37694,52776,90470,31,0.076994,0.096932,3996.888889,0,0
8503126,Nänikon-Greifensee,,0.000021,9,2,1,3,38707,38356,77063,33,0.069891,0.083046,635.638095,0,0
8503127,Schwerzenbach ZH,,0.000029,9,1,1,2,38356,38708,77064,32,0.075103,0.091975,2273.638095,0,0
8503300,Kempten,,0.000024,9,2,1,3,19242,19242,38484,33,0.062826,0.071257,39,0,0
8503135,Steg,,0.00002,9,1,1,2,15096,15096,30192,33,0.062111,0.070439,1080,0,0
8503136,Fischenthal,,0.000028,9,1,1,2,15096,15096,30192,32,0.066183,0.076241,2406,0,0
8503137,Gibswil,,0.000035,9,1,1,2,15096,15096,30192,31,0.070829,0.083317,3730,0,0
8503138,Wald ZH,,0.00004,9,1,1,2,15096,15096,30192,30,0.07618,0.092243,5052,0,0
8503421,Jestetten,,0.000045,9,1,1,2,14318,19598,33916,31,0.07335,0.087204,8146,0,0
8503150,"Volketswil, Dorf",,0.000011,84,0,1,1,0,36139,36139,24,0.102157,0.122348,0,0,0
8503151,"Volketswil, Zentrum",,0.00002,84,1,5,6,36139,62598,98737,23,0.113622,0.144996,719,0,0.000001
8503152,"Uster, Brandschenke",,0.000014,84,1,3,4,22196,31553,53749,24,0.105248,0.134696,227.333333,0,0.000001
8503156,"Volketswil, Hegnau",,0.000018,84,2,3,5,42169,41997,84166,23,0.113097,0.141612,336.783333,0,0.000001
8503154,"Volketswil, Volkiland Chliriet",,0.000014,84,1,3,4,19233,44578,63811,15,0.130267,0.153211,14,0,0.000006
8503155,"Volketswil, Chrummacher",,0.000015,84,1,1,2,26828,26829,53657,15,0.129487,0.148,0,0,0.000001
8503157,"Gutenswil, Unterdorf",,0.00002,84,2,2,4,23259,23246,46505,15,0.129896,0.161271,240.45,0,0.000001
8503350,"Kindhausen ZH, Geeren",,0.00002,84,2,2,4,18037,20743,38780,22,0.115879,0.141745,833,0,0.000001
8573504,"Uster, Bahnhof",,0.000181,84,12,16,28,147131,173820,320951,15,0.133978,0.185116,25746.829539,0.000001,0.000008
8575918,"Effretikon, Bahnhof",,0.000113,84,7,10,17,80297,114120,194417,20,0.125565,0.167351,9007.540744,0,0.000007
8503254,"Uster, Niederuster",,0.000011,84,0,2,2,0,20155,20155,16,0.11846,0.146658,0,0,0.000001
8503364,"Mönchaltorf, Langenmatt",,0.000029,84,1,1,2,20976,20976,41952,16,0.118351,0.145102,0,0,0.000001
8503392,"Gossau ZH, Mitteldorf",,0.000046,84,3,3,6,26963,26990,53953,16,0.130849,0.163508,3238.622396,0,0.000001
8503567,"Uster, Spital",,0.000038,84,3,2,5,31189,40369,71558,61,0.034685,0.063818,6105,0,0.000001
8503633,"Uster, See",,0.000011,84,0,1,1,0,18365,18365,16,0.118351,0.145102,0,0,0.000001
8503785,"Uster, Schlyffi",,0.000011,84,0,1,1,0,124,124,16,0.118351,0.145102,0,0,0.000001
8503872,"Uster, Reithalle",,0.000027,84,1,4,5,23096,23109,46205,60,0.035621,0.066172,6238,0,0.000001
8505296,"Uster, Sportanlage",,0.000017,84,1,1,2,7920,7920,15840,16,0.118351,0.145102,0,0,0
8573503,"Wermatswil, Ledi",,0.000049,84,2,1,3,14092,14077,28169,16,0.118351,0.145102,12224,0,0.000001
8576127,"Schwerzenbach ZH, Bahnhof",,0.000072,84,8,8,16,89318,125668,214986,14,0.14838,0.182433,26952.997919,0.000001,0.000182
8576128,"Volketswil, Hölzliwisen",,0.000019,84,1,3,4,26829,26829,53658,15,0.119701,0.141742,119.5,0.000004,0.00001
8576129,"Volketswil, Wallberg",,0.000033,84,3,5,8,60686,60673,121359,15,0.119976,0.145406,955.483333,0.000005,0.000011
8576131,"Volketswil, Eichstrasse",,0.00003,84,2,3,5,30875,30875,61750,15,0.118488,0.137059,500,0,0.00001
8576132,"Volketswil, Chapf",,0.000019,84,1,1,2,6341,6341,12682,15,0.115502,0.127265,0,0,0.000005
8576140,"Volketswil, In der Au",,0.000034,84,2,3,5,17958,17959,35917,15,0.118445,0.13803,1148.2,0,0.000006
8503159,"Bubikon, Ritterhaus",,0.000011,8,0,1,1,0,4804,4804,19,0.11573,0.138856,0,0,0
8503161,"Bubikon, Bad Kämmoos",,0.00002,8,1,3,4,4804,5155,9959,18,0.130241,0.165604,205,0,0
8503176,"Wolfhausen, Hüebli",,0.000018,8,1,2,3,12349,12769,25118,19,0.117409,0.144631,55.666667,0,0
8503177,"Hombrechtikon, Tobel",,0.000026,8,2,2,4,17837,17839,35676,19,0.119315,0.148217,163.833333,0,0
8503195,"Bubikon, Dorf",,0.000035,8,3,4,7,13127,13151,26278,18,0.131717,0.168717,459.666667,0,0
8503197,"Hombrechtikon, Post",,0.000046,8,4,4,8,23820,23808,47628,18,0.133557,0.171247,607.833333,0,0
8503163,"Oetwil am See, Felsengrund",,0.000011,84,0,1,1,0,17569,17569,24,0.074868,0.080532,0,0,0
8503164,"Hombrechtikon, Grüt",,0.000011,8,0,1,1,0,5958,5958,19,0.118343,0.142199,0,0,0
8503196,"Wolfhausen, Zentrum",,0.000018,8,1,2,3,6762,6761,13523,19,0.128452,0.159017,0,0,0
8503165,"Oetwil am See, Gusch",,0.00002,84,1,1,2,17569,17569,35138,23,0.080854,0.087648,1109,0,0
8503168,"Riedikon, Chis/Naturstation",,0.000028,84,1,1,2,17569,21405,38974,22,0.087888,0.096386,2216,0,0
8503169,"Oetwil am See, Langholz",,0.000011,84,0,2,2,0,5863,5863,21,0.098278,0.111573,0,0,0
8503172,"Stäfa, Mühlehölzli",,0.000016,84,1,2,3,4413,4874,9287,21,0.098311,0.111665,6.5,0,0
8503174,"Esslingen, Oberesslingen",,0.000026,84,1,1,2,17568,17569,35137,21,0.098198,0.11077,939.333333,0,0
8503183,"Grüningen, Station",,0.000018,84,1,3,4,18003,18216,36219,21,0.102377,0.121633,1999.259096,0,0
8503170,"Esslingen, Lieburg",,0.000035,84,1,2,3,21405,21414,42819,21,0.096269,0.107643,3321,0,0
8503184,"Oetwil am See, Zentrum",,0.000049,84,4,5,9,31296,38482,69778,20,0.108792,0.12758,6872.76808,0,0
8503171,"Tann, Sonnenberg",,0.000011,8,0,1,1,0,3549,3549,17,0.109517,0.129473,0,0,0
8503173,"Tann, Nauen",,0.00002,8,1,2,3,3549,3551,7100,16,0.122137,0.149538,144,0,0
8503190,"Hinwil, Hadlikon",,0.000019,8,1,1,2,2042,2042,4084,16,0.121392,0.14359,0,0,0
8503175,"Hombrechtikon, Plattenhof",,0.000017,8,1,2,3,4443,17862,22305,20,0.107538,0.131671,4,0,0
8503179,"Wetzikon ZH, Walfershausen",,0.000011,84,0,3,3,0,23542,23542,60,0.036356,0.060231,0,0,0
8503194,"Kempten, Ochsen",,0.000014,84,1,4,5,20548,21846,42394,59,0.037549,0.064145,1887.4,0,0
8503219,"Bäretswil, Bussental",,0.000014,84,1,1,2,9537,9529,19066,62,0.034095,0.053049,0,0,0
8575993,"Bauma, Dorfmitti",,0.000053,84,1,2,3,9532,9534,19066,7,0.275862,0.336756,136.5,0,0
8503180,"Grüt (Gossau ZH), Dorf",,0.000011,84,0,3,3,0,27455,27455,23,0.092055,0.113875,0,0,0
8503181,"Gossau ZH, Ernst-Brugger-Platz",,0.000014,84,1,4,5,9545,18545,28090,23,0.095193,0.120996,380.817338,0,0
8503264,"Grüningen, Im Haufland",,0.000035,84,3,4,7,18056,18069,36125,17,0.119615,0.14873,2715.929257,0,0
8575963,"Oetwil am See, Buacher",,0.000033,84,1,2,3,7547,7537,15084,14,0.177479,0.216243,217.471429,0,0
8503182,"Ottikon (Gossau), Kreisel",,0.000017,84,2,2,4,18068,18083,36151,22,0.092961,0.106842,1094.830815,0,0
8503267,"Bertschikon bei Gossau, Dorf",,0.00003,84,2,1,3,17193,17205,34398,17,0.115874,0.136087,299.966812,0,0
8503185,"Oetwil am See, Willikon",,0.000019,84,1,2,3,7543,7524,15067,18,0.107155,0.127232,1197.333333,0,0
8503263,Sulzbach,,0.000026,84,3,2,5,8389,17208,25597,18,0.107008,0.126512,206.071719,0,0
8503188,"Mönchaltorf, Mönchhof",,0.000034,84,2,1,3,19971,19968,39939,20,0.101771,0.114822,3480.666667,0,0
8503187,"Männedorf, Auf Dorf",,0.000019,84,1,3,4,8906,16203,25109,19,0.131148,0.189154,863.5,0,0
8503363,"Uetikon am See, Kleindorf",,0.000016,84,1,2,3,7115,15827,22942,19,0.130435,0.184389,130,0,0
8576025,"Oetwil am See, Bergstrasse",,0.000016,84,1,1,2,7423,7415,14838,19,0.120141,0.154152,0,0,0
8503191,"Dürnten, Oberdürnten",,0.000036,8,2,3,5,3551,24177,27728,15,0.137198,0.170716,426,0,0
8503192,"Dürnten, Kirche",,0.000021,8,1,1,2,21907,21357,43264,17,0.106635,0.121277,0,0,0
8503556,"Pfäffikon ZH, Wiesengrund",,0.00004,84,1,1,2,5805,5815,11620,59,0.035425,0.054299,8124,0,0
8503564,"Madetswil, Dorf",,0.000021,84,1,1,2,6171,6171,12342,59,0.035425,0.054299,2004,0,0
8503792,"Russikon, Gemeindehaus",,0.000027,84,2,2,4,9701,9701,19402,59,0.035437,0.055266,6105,0,0
8503852,"Hittnau, Sonne",,0.000014,84,1,2,3,165,5262,5427,59,0.03543,0.054898,6,0,0
8503873,"Wermatswil, Post",,0.000017,84,1,1,2,9058,9046,18104,59,0.035425,0.054299,7791.5,0,0
8573278,"Bauma, Bahnhof",,0.000053,84,4,5,9,18131,19139,37270,59,0.037829,0.070957,15071.5,0,0
8503356,"Hombrechtikon, Krone",,0.000021,8,1,3,4,9243,9243,18486,15,0.144737,0.180491,276.333333,0,0
8575968,"Hombrechtikon, Eichtal",,0.000034,8,2,2,4,11279,11282,22561,20,0.120625,0.153696,192,0,0
8575969,"Hombrechtikon, Garstlig",,0.000026,8,1,2,3,8353,8353,16706,20,0.120149,0.152581,24,0,0
8576050,"Rüti ZH, Jonamarkt",,0.000066,8,5,3,8,7518,7510,15028,20,0.141998,0.199344,3291.02381,0,0
8503200,Kilchberg ZH,,0.000032,9,4,1,5,38984,38984,77968,30,0.078585,0.097352,1671.011905,0,0
8503203,Oberrieden,,0.000018,9,1,1,2,19613,19613,39226,31,0.074158,0.088692,0,0,0
8503285,Schindellegi-Feusisberg,,0.000021,9,1,1,2,36501,36501,73002,31,0.069333,0.084716,0,0,0
8503211,Altendorf,,0.000024,9,2,1,3,17998,17998,35996,30,0.078248,0.091817,488,0,0
8503220,Lachen SZ,,0.000037,9,2,1,3,25124,25357,50481,29,0.08484,0.102938,2167,0,0
8503281,Sattel-Aegeri,,0.000025,9,1,1,2,8986,8986,17972,30,0.076006,0.093966,1798,0,0
8503282,Rothenthurm,,0.000038,9,2,1,3,16283,16755,33038,29,0.082212,0.106579,3594,0,0
8503283,Einsiedeln,,0.00003,9,2,1,3,35528,36266,71794,29,0.082212,0.106579,727,0,0
8503217,"Bellevue GE, mairie",,0.000028,120,2,1,3,13532,13679,27211,22,0.090137,0.096681,24,0,0
8503218,"Bellevue GE, Mollies",,0.000034,120,1,1,2,13679,13679,27358,21,0.09892,0.106843,699,0,0
8503222,Schübelbach-Buttikon,,0.000024,9,1,1,2,8683,8683,17366,29,0.084385,0.101302,588,0,0
8509002,Landquart,,0.000017,28,1,9,10,61970,82570,144540,22,0.09823,0.150301,289419.116667,0,0
8509404,Buchs SG,,0.000147,28,4,2,6,23528,23098,46626,5,0.4,0.535417,2992.166667,0,0
8509406,Sevelen,,0.000073,28,1,1,2,9454,9454,18908,5,0.368421,0.469048,0,0,0
8503226,Nieder- und Oberurnen,,0.000024,9,1,1,2,17002,17030,34032,13,0.142857,0.244626,3900,0,0
8503227,Näfels-Mollis,,0.000031,9,1,1,2,17030,17295,34325,12,0.153846,0.258601,3612,0,0
8503228,Netstal,,0.000037,9,1,1,2,17295,17295,34590,11,0.166667,0.274534,3322,0,0
8503229,"Les Tuileries, gare",,0.00004,120,1,1,2,13679,13679,27358,20,0.109618,0.119797,1372,0,0
8503230,Glarus,,0.000043,9,1,1,2,17295,17310,34605,10,0.181818,0.292897,3030,0,0
8503231,Ennenda,,0.000047,9,1,1,2,17310,17937,35247,9,0.2,0.31433,2736,0,0
8503232,Mitlödi,,0.000051,9,1,1,2,17937,17937,35874,8,0.222222,0.339732,2440,0,0
8503233,Schwanden GL,,0.000054,9,1,1,2,17937,10235,28172,7,0.25,0.370408,2142,0,0
8503234,Nidfurn-Haslen,,0.000057,9,1,1,2,10235,10235,20470,6,0.285714,0.408333,1842,0,0
8503235,Leuggelbach,,0.000059,9,1,1,2,10235,10235,20470,5,0.333333,0.456667,1540,0,0
8503236,Luchsingen-Hätzingen,,0.000061,9,1,1,2,10235,10235,20470,4,0.4,0.520833,1236,0,0
8503237,Diesbach-Betschwanden,,0.000063,9,1,1,2,10235,10235,20470,3,0.5,0.611111,930,0,0
8503238,Rüti GL,,0.000064,9,1,1,2,10235,10235,20470,2,0.666667,0.75,622,0,0
8503239,Linthal,,0.000066,9,1,1,2,10235,10235,20470,1,1,1,312,0,0
8503244,"Haslen GL, Chappeli",,0.000011,128,0,3,3,0,2312,2312,26,0.106583,0.191974,0,0,0
8503245,"Hätzingen, Rössliplatz",,0.000014,128,1,1,2,1185,1185,2370,26,0.085957,0.116354,0,0,0
8503256,"Sool, Schulhaus",,0.000011,128,0,3,3,0,3241,3241,10,0.190311,0.265945,0,0,0
8503279,"Schwanden GL, Thon",,0.00002,128,1,1,2,5419,5419,10838,10,0.184669,0.238245,53,0,0
8503618,"Schwanden GL, Au",,0.000055,128,2,1,3,9365,9454,18819,10,0.184669,0.238245,681,0,0
8505925,"Mitlödi, Schulhaus",,0.000026,128,2,1,3,855,1181,2036,10,0.184669,0.238245,53,0,0
8507548,"Schwanden GL, Alpsteg",,0.000028,128,1,1,2,1903,1903,3806,10,0.184669,0.238245,106,0,0
8573131,"Linthal, Bahnhof",,0.000093,128,2,3,5,2710,2626,5336,21,0.136164,0.225715,1666.5,0,0
8503246,"Betschwanden, Schulhaus",,0.000026,128,2,1,3,2172,2172,4344,25,0.09311,0.128778,148,0,0
8503247,"Chambésy, gare",,0.000011,120,0,1,1,0,12193,12193,22,0.09714,0.105008,0,0,0
8503251,"Wetzikon ZH, Oberwetzikon",,0.000029,84,3,3,6,21278,24811,46089,61,0.035282,0.058805,2555.3,0,0
8573499,"Pfäffikon ZH, Bahnhof",,0.000107,84,7,9,16,37273,39851,77124,58,0.036708,0.061672,52926.233333,0,0
8573544,"Hittnau, Oberdorf",,0.00005,84,1,2,3,5265,5262,10527,11,0.18408,0.254205,148,0,0
8575988,"Adetswil, Frowiesstrasse",,0.00004,84,1,2,3,12754,12757,25511,7,0.275591,0.331701,114.166667,0,0
8575998,"Wetzikon ZH, Friedhof",,0.000059,84,1,2,3,5568,5572,11140,7,0.271186,0.328943,601.333333,0,0
8575999,"Wetzikon ZH, Sonnenfeld",,0.000036,84,1,1,2,3531,3531,7062,7,0.264957,0.307296,0,0,0
8576001,"Wetzikon ZH, Buchgrindel",,0.000036,84,2,2,4,2754,2754,5508,7,0.274336,0.336866,33.633333,0,0
8503252,"Kempten, Oberkempten",,0.000019,84,1,2,3,20062,20069,40131,60,0.036484,0.062096,4553,0,0
8503560,"Saland, Juckeren",,0.00002,84,1,1,2,5539,5540,11079,60,0.036467,0.061653,2114,0,0
8503622,"Adetswil, Sunneberg",,0.000019,84,1,2,3,12764,12761,25525,60,0.036475,0.062129,25.166667,0,0
8503627,"Sternenberg, Gfell",,0.000011,84,0,1,1,0,3057,3057,60,0.036467,0.061653,0,0,0
8503253,"Uster, Hegetsberg",,0.000011,84,0,1,1,0,9185,9185,62,0.033538,0.056506,0,0,0
8503565,"Uster, Buchholz",,0.000011,84,0,2,2,0,22008,22008,62,0.033554,0.056969,0,0,0
8503566,"Pfäffikon ZH, Faichrüti",,0.000016,84,1,1,2,9057,9053,18110,62,0.033538,0.056506,0,0,0
8503255,"Matt, Dorf",,0.000011,128,0,2,2,0,9416,9416,17,0.09434,0.140791,0,0,0
8503266,"Elm, Schwändi",,0.000031,128,1,2,3,9454,9133,18587,16,0.1,0.141472,134,0,0
8505621,"Mitlödi, Kirche",,0.000014,128,1,1,2,325,590,915,11,0.158358,0.197113,0,0,0
8503258,"Elm, Meissenboden",,0.000016,128,1,1,2,9133,9133,18266,18,0.085502,0.115923,2,0,0
8503259,Wart,,0.000024,128,1,1,2,9133,9454,18587,17,0.092141,0.125324,69,0,0
8503270,"Engi, Dorf",,0.000029,128,2,1,3,4176,4176,8352,16,0.098655,0.128464,66,0,0
8503271,"Engi, Weberei",,0.000049,128,2,1,3,9416,9416,18832,15,0.107794,0.13983,325,0,0
8503272,"Engi, Vorderdorf",,0.000052,128,1,1,2,9416,9737,19153,14,0.118959,0.155789,384,0,0
8503273,"Engi, Hinterdorf",,0.000055,128,1,2,3,9737,9416,19153,13,0.132911,0.182849,441,0,0
8589545,"Matt, Brummbach",,0.00006,128,2,1,3,9222,9133,18355,1,1,1,112,0,0
8503274,"Matt, Station",,0.000034,128,1,2,3,9133,9133,18266,12,0.149038,0.202792,488,0,0
8503276,"Elm, Sportbahnen",,0.000026,128,1,2,3,6790,10481,17271,12,0.148418,0.202838,36,0,0
8503275,Kies (Niederental),,0.000011,128,0,1,1,0,1903,1903,12,0.138889,0.171935,0,0,0
8503277,"Elm, Station",,0.000036,128,2,2,4,9365,9133,18498,11,0.162791,0.216859,552,0,0
8503616,"Elm, Dorf",,0.000033,128,1,1,2,7022,7022,14044,11,0.158358,0.197113,54,0,0
8503278,"Schwändi b. Schwanden GL, Post",,0.000011,128,0,1,1,0,5419,5419,11,0.158358,0.197113,0,0,0
8503280,Steinerberg,,0.000017,9,1,1,2,472,8986,9458,31,0.070674,0.084567,290,0,0
8503289,Freienbach SOB,,0.000031,9,1,2,3,17363,17363,34726,33,0.061299,0.072223,2237,0,0
8503287,Burghalden,,0.000023,9,1,1,2,20391,20391,40782,1,1,1,297,0,0
8503288,Wollerau,,0.000023,9,1,1,2,17613,17363,34976,34,0.057791,0.066524,849,0,0
8503290,Biberegg,,0.000035,9,2,1,3,8986,8986,17972,32,0.065249,0.078275,2032,0,0
8503294,Riedmatt SZ,,0.000041,9,2,1,3,17363,17363,34726,32,0.065189,0.078022,1992,0,0
8503301,Pfäffikon ZH,,0.000039,9,2,1,3,24253,24253,48506,32,0.066997,0.077211,2231,0,0
8503302,Fehraltorf,,0.000044,9,1,1,2,24253,24253,48506,31,0.071765,0.084485,3613,0,0
8503308,Kloten,,0.000033,9,1,1,2,19318,19318,38636,31,0.070829,0.083317,622,0,0
8503309,Kloten Balsberg,,0.000039,9,1,1,2,19318,19318,38636,30,0.07618,0.092243,1905,0,0
8503310,Glattbrugg,,0.000041,9,4,2,6,41087,41075,82162,31,0.072347,0.08741,3934.685714,0,0
8503311,Rümlang,,0.000028,9,1,1,2,37679,37679,75358,31,0.072307,0.086858,0,0,0
8503314,Niederhasli,,0.000026,9,1,1,2,19333,19333,38666,5,0.333333,0.456667,1570,0,0
8503315,Dielsdorf,,0.000033,9,1,1,2,19333,19333,38666,4,0.4,0.520833,1260,0,0
8503316,Steinmaur,,0.000039,9,1,1,2,19333,19333,38666,3,0.5,0.611111,948,0,0
8503317,Schöfflisdorf-Oberweningen,,0.000044,9,1,1,2,19333,19333,38666,2,0.666667,0.75,634,0,0
8503318,Niederweningen Dorf,,0.000048,9,1,1,2,19333,19318,38651,1,1,1,318,0,0
8503320,"Chambésy, Ravin",,0.00002,120,1,1,2,12193,12192,24385,21,0.107433,0.117285,675,0,0
8503322,"Nidfurn, Abzw. Haslen",,0.000033,128,1,2,3,2172,2256,4428,24,0.101643,0.148669,245,0,0
8503325,"Diesbach GL, Schulhaus",,0.000032,128,1,1,2,987,987,1974,24,0.099897,0.136271,97,0,0
8503324,"Luchsingen, Schulhaus",,0.000025,128,1,1,2,987,987,1974,25,0.091674,0.122902,4,0,0
8503326,"Rüti GL, Schulhaus",,0.000052,128,2,1,3,2256,2256,4512,23,0.10984,0.155249,524,0,0
8503327,"Linthal Braunwaldbahn, Parkpl.",,0.000055,128,1,2,3,2256,2326,4582,22,0.122108,0.18649,613,0,0
8573129,"Linthal, Oberberg",,0.000041,128,1,1,2,384,384,768,23,0.108945,0.15162,958.5,0,0
8573130,"Linthal, Post",,0.000069,128,2,1,3,2450,2450,4900,22,0.120978,0.177836,967.5,0,0
8503330,"Satigny, Champvigny",,0.000011,132,0,1,1,0,6072,6072,27,0.078994,0.092747,0,0,0
8503331,"Grand-Saconnex, Sonnex",,0.000011,120,0,2,2,0,27650,27650,20,0.167987,0.198339,0,0,0
8587037,"Carouge GE, Tours",,0.00002,120,1,8,9,18865,173954,192819,20,0.175405,0.214588,639,0,0
8587048,"Bellevue GE, Colovrex",,0.000059,120,3,6,9,53160,71870,125030,17,0.173171,0.212413,7163.498427,0,0
8587057,"Genève, Cornavin",,0.000069,120,6,14,20,244479,574883,819362,19,0.20171,0.260419,12712.934896,0,0
8508108,"Vernier, Etang-Place",,0.000011,120,0,2,2,0,28366,28366,19,0.163365,0.198317,0,0,0
8587058,"Genève, Nations",,0.00003,120,4,13,17,297384,296212,593596,19,0.19906,0.253557,4337.853144,0,0
8587075,"Lancy-Bachet, gare",,0.000059,120,8,11,19,181036,212718,393754,19,0.184442,0.2393,6266.294067,0,0
8587082,"Petit-Lancy, place",,0.000019,120,2,2,4,122272,122239,244511,20,0.155659,0.187677,90.609617,0,0
8587386,"Confignon, croisée",,0.000078,120,7,7,14,152396,149315,301711,19,0.174927,0.221863,8269.434034,0,0
8587387,"Genève, Bel-Air",,0.000056,120,9,21,30,486889,515688,1002577,18,0.200278,0.274168,13802.677431,0,0
8503332,"Genève, Pédiatrie",,0.000011,120,0,1,1,0,32560,32560,20,0.146685,0.164293,0,0,0
8503333,"Genève, Aubépine",,0.00002,120,1,1,2,32560,32876,65436,19,0.17163,0.200275,634,0,0
8587047,"Cologny, croisée",,0.000036,120,3,1,4,37647,37649,75296,19,0.17163,0.200275,1776.320666,0,0
8587059,"Genève, plage",,0.000032,120,3,4,7,86402,127331,213733,19,0.179807,0.216862,1102.855951,0,0
8503351,"Bisikon, Dorf",,0.000019,84,1,1,2,19896,19897,39793,21,0.11172,0.135556,1037.173913,0,0
8503372,"Effretikon, Wattspitz",,0.000029,84,2,1,3,19557,23733,43290,21,0.11172,0.135556,1224,0,0
8503378,"Tagelswangen, Dorf",,0.000016,84,1,2,3,11390,15380,26770,21,0.111882,0.136966,306,0,0
8503380,"Winterberg ZH, Dorf",,0.000022,84,2,1,3,13290,13289,26579,21,0.11172,0.135556,306,0,0
8503381,"Grafstal, Thalegg",,0.000027,84,1,2,3,12717,12719,25436,21,0.111882,0.136966,1831,0,0
8506960,"Brütten, Zentrum",,0.000013,107,1,2,3,3192,6598,9790,20,0.118619,0.14551,142.333333,0.000008,0
8575909,"Effretikon, Vogelbuckstrasse",,0.000023,84,1,1,2,8539,12720,21259,21,0.11172,0.135556,0,0,0
8503354,"Kempraten, Belsito",,0.000016,67,1,2,3,15876,16537,32413,49,0.037525,0.059453,1099,0,0
8576076,"Rüti ZH, Seefeldstrasse",,0.00003,8,1,2,3,2374,2375,4749,15,0.188976,0.245053,1413.511905,0,0
8503355,"Rüti ZH, Unterwiesstrasse",,0.000017,67,1,2,3,2242,2374,4616,48,0.038834,0.063139,2254.52381,0,0
8503358,"Rüti ZH, Sportplatz",,0.000018,67,1,3,4,2243,2241,4484,47,0.040132,0.06599,3161,0,0
8503396,"Rüti ZH, Rekrutierungszentrum",,0.000034,8,3,1,4,5147,5146,10293,21,0.124918,0.161724,1026,0,0
8573587,"Laupen ZH, Hauptstrasse",,0.00003,67,1,4,5,2959,2961,5920,21,0.147718,0.22627,1538.25,0,0
8573588,"Goldingen, Löffel",,0.000017,67,1,2,3,990,989,1979,21,0.146718,0.21825,0,0,0
8575967,"Hombrechtikon, Eichberg",,0.000021,8,1,1,2,8439,8439,16878,21,0.108234,0.132503,18,0,0
8503999,"Goldingen, Egligen",,0.000072,67,2,3,5,7218,7505,14723,44,0.044299,0.071582,14017,0,0
8503359,"Stäfa, Kehlhof",,0.000011,8,0,1,1,0,2934,2934,11,0.158192,0.212303,0,0,0
8503361,"Stäfa, Laubisrüti",,0.000017,8,1,3,4,5958,9160,15118,14,0.163223,0.20112,343.833333,0,0
8575971,"Feldbach, Bahnhof",,0.000029,8,1,1,2,5513,5513,11026,18,0.136879,0.171655,172,0,0
8576053,"Wolfhausen, Neugut",,0.000084,8,1,2,3,12797,12773,25570,18,0.153922,0.207584,2001.166667,0,0
8575975,"Uerikon, Ritterhaus",,0.00002,8,1,1,2,2934,2933,5867,10,0.181208,0.244253,27,0,0
8576056,"Uerikon, Gsteig",,0.000033,8,1,1,2,5958,5957,11915,16,0.097744,0.160836,1014,0,0
8576057,"Uerikon, Bahnhof",,0.000033,8,2,2,4,5779,5781,11560,9,0.213115,0.306654,228,0,0
8503365,"Hinwil, Girenbad",,0.000011,8,0,1,1,0,1438,1438,16,0.117749,0.133579,0,0,0
8503366,"Wernetshausen, Dorf",,0.00002,8,1,1,2,1438,1438,2876,15,0.132483,0.150556,135,0,0
8503367,"Laupen ZH, Hubwies",,0.000016,67,1,1,2,956,990,1946,46,0.040755,0.05842,4145,0,0
8503368,"Rufi, Maseltrangen",,0.000011,67,0,1,1,0,5040,5040,46,0.040398,0.059461,0,0,0
8503383,"Neuhaus SG, Lenzikon",,0.00002,67,1,5,6,32037,31736,63773,43,0.04616,0.084979,1205,0,0
8503369,"Neuhaus SG, Post",,0.000011,67,0,1,1,0,32037,32037,44,0.044158,0.07272,0,0,0
8503370,"Effretikon, Eselriet",,0.000011,84,0,2,2,0,19557,19557,22,0.100788,0.118312,0,0,0
8503371,"Illnau, Löwen",,0.000016,84,1,1,2,9873,9873,19746,22,0.10064,0.116874,0,0,0
8503373,"Weisslingen, Dorf",,0.000011,84,0,4,4,0,15148,15148,61,0.033273,0.050036,0,0,0
8503382,"Illnau, Weisslingerstrasse",,0.000013,84,1,2,3,8917,8921,17838,6,0.301887,0.394792,1.333333,0,0
8503519,"Weisslingen, Bergwiesenstrasse",,0.000019,84,2,3,5,5029,5127,10156,5,0.365854,0.474444,18.333333,0,0
8573533,"Theilingen, Schwemmrüti",,0.000066,84,1,2,3,5916,5915,11831,6,0.272727,0.384444,1358,0,0
8503374,"Grafstal, Unterdorf",,0.000011,84,0,1,1,0,12685,12685,24,0.084268,0.095189,0,0,0
8503375,"Kyburg, Dorf",,0.00002,84,1,2,3,12685,13098,25783,23,0.091873,0.106615,615,0,0
8575948,"Kyburg, Ettenhusen",,0.000028,84,1,3,4,12721,12717,25438,2,0.8,0.875,47,0,0
8503376,Ottikon b. Kemptthal,,0.000019,84,1,1,2,12720,12717,25437,22,0.100771,0.117498,1220,0,0
8503377,"Lindau, Dorf",,0.000011,84,0,2,2,0,13290,13290,22,0.100788,0.118312,0,0,0
8573534,"Weisslingen, Oberhof",,0.000047,84,3,2,5,6992,6987,13979,5,0.285714,0.386905,1109.333333,0,0
8575921,"Effretikon, Lindenwiese",,0.000024,84,2,2,4,21454,17277,38731,6,0.297872,0.414286,221,0,0
8575926,"Illnau, Chrummenacher",,0.000045,84,2,1,3,15005,15005,30010,6,0.25,0.33,30,0,0
8506460,Betzikon SG,,0.000052,67,2,1,3,7317,7317,14634,44,0.04315,0.067665,1890.885714,0,0
8503998,"Kaltbrunn, Fischhausen",,0.000051,67,1,2,3,9430,9430,18860,43,0.045074,0.075976,6116.911905,0,0
8506487,"St. Gallenkappel, Post",,0.000058,67,2,3,5,21060,21466,42526,43,0.045058,0.077287,3056.885714,0,0
8506498,"Eschenbach SG, Gublen",,0.000048,67,2,3,5,6300,6286,12586,43,0.044778,0.073278,13789.5,0,0
8573594,"Eschenbach SG, Oberfeld",,0.000069,67,1,1,2,6515,6515,13030,43,0.044571,0.070572,5810,0,0
8503384,"Kaltbrunn, Steinenbrücke",,0.000024,67,2,3,5,14720,14720,29440,45,0.042063,0.06599,1217.333333,0,0
8503770,"Uetliburg SG, Säge",,0.000021,67,1,3,4,5873,9500,15373,46,0.040415,0.063163,94.085714,0,0
8503790,"Uznach, Spital Ost",,0.000023,67,2,2,4,4870,4870,9740,45,0.041901,0.064855,648.585714,0,0
8503982,"Gebertingen, Freudwil",,0.000068,67,3,3,6,9108,9128,18236,45,0.041829,0.066576,2403.914286,0,0
8503385,"Ricken SG, Hinterer Schümberg",,0.000014,67,1,5,6,7098,9128,16226,46,0.040405,0.06292,55.904762,0,0
8503577,"Uznach, Sonnenhof",,0.000013,67,1,1,2,655,5892,6547,47,0.038935,0.057037,0,0,0
8503768,"Rieden SG, Dorf",,0.000011,67,0,1,1,0,5509,5509,47,0.038935,0.057037,0,0,0
8503769,"Gommiswald, Dorf",,0.000034,67,3,3,6,11433,11755,23188,46,0.040478,0.063383,2465.27619,0,0
8503974,"Ricken SG, Bildhaus",,0.000039,67,4,2,6,4091,5834,9925,45,0.041728,0.063763,4154.111905,0,0
8503977,"Wattwil, Mittlerer Hummelwald",,0.00003,67,1,1,2,6800,6800,13600,46,0.040059,0.057615,2378,0,0
8503386,"Goldingen, Wolfertingen",,0.000025,67,1,1,2,990,989,1979,45,0.042452,0.063869,5377,0,0
8503995,"Goldingen, Oberdorf",,0.000047,67,1,1,2,6229,6229,12458,45,0.042452,0.063869,6180,0,0
8503387,"Hintergoldingen, Sonne",,0.000011,67,0,1,1,0,5903,5903,49,0.036423,0.048013,0,0,0
8503390,"Wald ZH, Sonnenberg",,0.000011,67,0,1,1,0,855,855,24,0.112195,0.145481,0,0,0
8503391,"Goldingen, Vordersagen",,0.00002,67,1,1,2,5903,5903,11806,48,0.037769,0.051062,1240,0,0
8503394,"Siebnen, Zentralhof",,0.000011,67,0,2,2,0,18974,18974,23,0.087382,0.116768,0,0,0
8503639,"Siebnen, Stegweg",,0.000045,67,1,1,2,6089,6089,12178,23,0.085833,0.110137,1345,0,0
8503398,"Wernetshausen, Letten",,0.000028,8,1,1,2,1438,1438,2876,14,0.151584,0.174334,268,0,0
8576041,"Tann, Härtiplatz",,0.000021,8,1,2,3,2042,2041,4083,14,0.153326,0.182799,544,0,0
8576044,"Hinwil, Sportplatz",,0.00002,8,1,2,3,2009,1963,3972,14,0.152542,0.18045,5,0,0
8576045,"Hinwil, Zelgacher",,0.000019,8,1,1,2,1020,1020,2040,14,0.151584,0.174334,0,0,0
8503401,Glattfelden,,0.000022,9,1,1,2,19347,19347,38694,36,0.05403,0.06029,0,0,0
8503402,Eglisau,,0.00004,9,2,2,4,37302,37296,74598,35,0.057081,0.064688,5443,0,0
8503403,Hüntwangen-Wil,,0.000028,9,1,1,2,19347,19347,38694,34,0.060218,0.067702,4216,0,0
8503404,Rafz,,0.000035,9,1,1,2,19347,14314,33661,33,0.064037,0.072977,5528,0,0
8503409,Bad Zurzach,,0.000044,9,2,1,3,28534,28535,57069,33,0.061537,0.068601,4856,0,0
8503410,Rietheim,,0.000048,9,1,1,2,28535,28612,57147,32,0.065532,0.074038,6161,0,0
8503413,Kaiserstuhl AG,,0.000033,9,1,1,2,18032,17955,35987,2,0.666667,0.75,646,0,0
8503414,Mellikon,,0.000039,9,1,1,2,17955,17955,35910,1,1,1,324,0,0
8503419,"Dardagny, Le Roulave",,0.000011,120,0,1,1,0,11073,11073,24,0.087339,0.095064,0,0,0
8503420,Lottstetten,,0.00004,9,1,1,2,14314,14318,28632,32,0.068376,0.079329,6838,0,0
8506000,Winterthur,,0.000227,9,13,8,21,187461,195056,382517,28,0.089756,0.122064,122785.658117,0,0
8503425,Feuerthalen,,0.000025,9,1,1,2,18310,18310,36620,35,0.054543,0.060428,2015.5,0,0
8503426,Langwiesen,,0.000033,9,1,1,2,18310,18310,36620,34,0.057652,0.064439,3230.5,0,0
8503427,Schlatt TG,,0.000039,9,1,1,2,18310,18250,36560,33,0.061139,0.069121,4443.5,0,0
8503428,Diessenhofen,,0.000044,9,1,1,2,18250,18280,36530,32,0.065078,0.074687,5654.5,0,0
8503429,Schlattingen,,0.000048,9,1,1,2,18280,18250,36530,31,0.069563,0.081487,6863.5,0,0
8506024,Stammheim,,0.000041,9,1,1,2,17820,17311,35131,31,0.069563,0.081487,5431.5,0,0
8503435,"Riaz, CO",,0.000011,126,0,11,11,0,22008,22008,34,0.076486,0.10599,0,0,0
8504046,"Farvagny-le-Grand, Rte Ecoles",,0.000012,126,1,3,4,1186,1188,2374,47,0.059564,0.090989,111,0,0
8504047,"Magnedens, bif. Corpataux",,0.000015,126,2,3,5,4328,7931,12259,47,0.059549,0.091117,119.833333,0,0
8504002,"Massonnens, Ferlens FR",,0.000012,126,1,2,3,5896,5896,11792,47,0.05774,0.085691,111,0,0
8504042,"Avry-devant-Pont, village",,0.000021,126,1,1,2,335,335,670,36,0.072993,0.096472,1386,0,0
8504098,Les Chavannes-sous-Romont,,0.00006,126,3,8,11,12919,13872,26791,44,0.063962,0.104657,12504.509524,0,0
8504099,Farvagny-le-Petit,,0.000019,126,3,2,5,12201,11885,24086,34,0.084097,0.120162,2821.425669,0,0
8504094,"Chavannes-Les-Forts, village",,0.000011,13,0,2,2,0,6645,6645,27,0.082938,0.10161,0,0,0
8504692,"Rue, ville",,0.000011,13,0,1,1,0,11021,11021,27,0.082722,0.100016,0,0,0
8504048,"Villariaz, Moulin Rouge",,0.000011,13,0,1,1,0,2435,2435,21,0.109369,0.128504,0,0,0
8504530,"Villarbeney, village",,0.000012,126,1,2,3,707,7191,7898,34,0.075053,0.098215,13.924242,0,0
8504971,Les Ecasseys,,0.000039,13,2,3,5,6327,6327,12654,20,0.121868,0.157581,263.666667,0,0
8503436,"Seuzach, Alterszentrum",,0.000011,68,0,1,1,0,2780,2780,47,0.052441,0.077267,0,0,0
8503470,"Hemishofen, Dorf",,0.000011,65,0,1,1,0,13326,13326,36,0.068255,0.11924,0,0,0
8503495,SH Bahnhof,,0.0001,66,6,21,27,68349,161172,229521,43,0.056199,0.1602,9662.25,0,0
8573325,"Weiningen TG, Mehrzweckhalle",,0.000041,65,1,2,3,8232,8232,16464,35,0.051496,0.092114,892.5,0,0
8503479,Kreuz,,0.000011,66,0,2,2,0,28016,28016,45,0.052181,0.104325,0,0,0
8503480,Rheinhof,,0.000016,66,1,1,2,7652,7651,15303,45,0.052095,0.102759,0,0,0
8503482,Beringen Enge,,0.000023,66,1,2,3,7652,9668,17320,47,0.047468,0.085127,63,0,0
8503485,Siblingen Dorf,,0.000028,66,1,3,4,9570,9569,19139,45,0.051339,0.108184,1121.666667,0,0
8503483,Beringen Sonne,,0.000021,66,1,2,3,9570,13671,23241,47,0.04746,0.085743,61.666667,0,0
8503484,Löhningen Dorf,,0.00002,66,1,1,2,9570,9570,19140,46,0.048915,0.091396,570.666667,0,0
8578369,Näppental,,0.000059,66,1,2,3,7554,7554,15108,20,0.088821,0.156083,265,0,0
8578371,Siblingerstrasse,,0.000053,66,3,2,5,7233,7233,14466,18,0.102564,0.178621,407.666667,0,0
8503486,Siblingerhöhe,,0.000029,66,2,1,3,7553,7554,15107,46,0.048688,0.088594,569.333333,0,0
8503487,Schleitheim Hohbrugg,,0.000035,66,1,1,2,7554,7554,15108,45,0.051088,0.102678,1116.333333,0,0
8573441,Mühlentor,,0.00004,66,3,6,9,56752,56739,113491,14,0.154564,0.226364,2427.25,0,0
8578363,Schleitheim Schweizerbund,,0.000025,66,1,2,3,5865,5865,11730,22,0.078913,0.135825,61,0,0
8578370,Gächlingen Höfe,,0.000036,66,1,1,2,792,792,1584,19,0.094527,0.149267,135,0,0
8503491,Beggingen Dorf,,0.000025,66,2,1,3,5865,5865,11730,46,0.048329,0.086188,22,0,0
8503492,Schleitheim Altersheim,,0.000032,66,1,1,2,5865,5865,11730,45,0.050691,0.098931,561,0,0
8503953,Bibern Dorf,,0.000024,66,1,3,4,2615,2716,5331,15,0.130277,0.18294,108,0,0
8503954,Buch Dorf,,0.000021,66,2,2,4,5288,5288,10576,17,0.112426,0.152067,153,0,0
8503952,"Benken ZH, Dorf",,0.000015,66,1,2,3,4948,8183,13131,42,0.050808,0.087604,6426,0,0
8503963,Hofen Dorf,,0.000027,66,2,2,4,2615,2615,5230,15,0.128329,0.172241,37.833333,0,0
8503964,Lohn Dorf,,0.000031,66,2,2,4,5327,5326,10653,15,0.127427,0.169119,68.666667,0,0
8503957,Dörflingen Post,,0.000024,66,2,1,3,6120,6120,12240,16,0.121971,0.154083,141,0,0
8503968,Sommerhalde,,0.000024,66,1,1,2,5425,5425,10850,17,0.1,0.115621,150,0,0
8503966,Opfertshofen Dorf,,0.000046,66,4,4,8,4019,4019,8038,14,0.144444,0.20585,891.666667,0,0
8503967,Rheinhalde Mitte,,0.000035,66,2,2,4,6820,6820,13640,15,0.137994,0.186799,290,0,0
8557042,"Feuerthalen, Rhymarkt",,0.000037,66,2,3,5,12682,12680,25362,15,0.138739,0.192133,1208,0,0
8503969,Sommerwies,,0.000035,66,2,1,3,24731,24733,49464,16,0.11037,0.127862,298,0,0
8573442,Rhybadi / IWC,,0.000017,66,1,2,3,25414,25428,50842,13,0.142303,0.177501,1130.5,0,0
8573460,Neubrunn,,0.000026,66,1,2,3,24831,24831,49662,12,0.147685,0.179258,545.857143,0,0
8573462,Heuberg,,0.000029,66,1,3,4,24733,24733,49466,11,0.16338,0.203089,265,0,0
8503965,Merishausen Brunngasse,,0.000017,66,1,1,2,4907,4907,9814,14,0.130435,0.187017,5,0,0
8573465,Finsterwaldstrasse,,0.000041,66,4,2,6,38571,38571,77142,12,0.158879,0.196636,1812.92381,0,0
8573467,Sandlöchli,,0.000071,66,1,3,4,25303,25303,50606,12,0.172117,0.222842,1795.5,0,0
8573478,Falkeneck,,0.000052,66,3,2,5,44568,44568,89136,14,0.151659,0.200555,2075.42381,0,0
8592515,Birch,,0.000032,66,1,2,3,19579,19579,39158,6,0.284091,0.348667,224.07619,0,0
8592525,CMC,,0.000043,66,1,1,2,19518,19518,39036,7,0.264368,0.323602,46,0,0
8592530,Ebnat,,0.000099,66,3,4,7,35682,36368,72050,7,0.294118,0.414381,1561.92381,0,0
8592532,Feldstrasse,,0.000029,66,2,3,5,6524,6722,13246,6,0.338028,0.425,206.538095,0,0
8592533,Felsentäli,,0.000033,66,2,2,4,19579,19579,39158,5,0.333333,0.396377,89.038095,0,0
8592545,Gruben,,0.000051,66,2,3,5,19861,19861,39722,4,0.47619,0.591667,750.5,0,0
8592554,Huus Emmersberg,,0.000025,66,1,1,2,3211,3211,6422,4,0.380952,0.458333,0,0,0
8503501,Döttingen,,0.000047,9,3,1,4,22264,22264,44528,30,0.075191,0.087502,8418,0,0
8503509,Schlieren,,0.000034,9,1,2,3,38323,38323,76646,30,0.076239,0.093021,6684.656169,0,0
8503511,Neuenhof,,0.000026,9,1,1,2,19586,19586,39172,30,0.076195,0.092452,0,0,0
8506003,Sennhof-Kyburg,,0.000033,9,1,2,3,27690,24980,52670,6,0.318182,0.492857,3248.343831,0,0
8506008,Wila,,0.000048,9,1,2,3,24240,22486,46726,1,1,1,507,0,0
8506038,Winterthur Wallrüti,,0.000061,9,1,2,3,28380,26623,55003,30,0.073677,0.088029,4983.666667,0,0
8575931,"Weisslingen, Brauiweiher",,0.000047,84,1,2,3,8922,8920,17842,3,0.545455,0.638889,121,0,0
8503522,"Guarda, Pitschen",,0.000011,138,0,1,1,0,2355,2355,2,0.666667,0.75,0,0,0
8503524,"Bellinzona, Carmagnola",,0.000011,108,0,3,3,0,47578,47578,40,0.084423,0.118691,0,0,0
8503526,Regensdorf-Watt,,0.000029,9,2,1,3,22873,18864,41737,3,0.5,0.611111,1023,0,0
8503527,Buchs-Dällikon,,0.000035,9,1,1,2,18864,18864,37728,2,0.666667,0.75,684,0,0
8503528,Otelfingen,,0.000041,9,1,1,2,18864,18864,37728,1,1,1,343,0,0
8503552,"Pfäffikon ZH, Berg",,0.000011,84,0,1,1,0,5815,5815,63,0.031084,0.041202,0,0,0
8503553,"Pfäffikon ZH, Wallikon",,0.00002,84,1,1,2,5815,5814,11629,62,0.032066,0.043522,2034,0,0
8503554,"Pfäffikon ZH, Humbel",,0.000028,84,1,1,2,5814,5810,11624,61,0.033112,0.046287,4066,0,0
8503555,"Pfäffikon ZH, Hermatswil",,0.000035,84,1,1,2,5810,5805,11615,60,0.034229,0.049719,6096,0,0
8503559,"Hittnau, Hasel/Schönau",,0.000011,84,0,1,1,0,5539,5539,61,0.0352,0.055628,0,0,0
8503561,"Rumlikon, Dorfstrasse",,0.000013,84,1,2,3,4780,9698,14478,60,0.034288,0.051045,2020,0,0
8503563,"Russikon, Wilhof",,0.000025,84,1,2,3,11086,11090,22176,60,0.034257,0.050685,2035,0,0
8503562,"Pfäffikon ZH, Bussenhausen",,0.000017,84,1,1,2,4916,11086,16002,61,0.033138,0.046827,4,0,0
8503569,"Mandach, Dorf",,0.000011,57,0,1,1,0,3403,3403,30,0.065787,0.076854,0,0,0
8503570,"Leuggern, Post",,0.00002,57,1,2,3,3403,3889,7292,29,0.070359,0.08479,1161,0,0
8503573,"Etzwil, Mandacherstrasse",,0.000027,57,1,1,2,3403,3403,6806,29,0.070251,0.083642,1159,0,0
8503590,"Böttstein, Birch",,0.000029,57,1,1,2,5217,4919,10136,29,0.070251,0.083642,4065.844158,0,0
8503572,"Hettenschwil, Dorf",,0.000019,57,1,1,2,3403,3403,6806,30,0.065693,0.076268,2,0,0
8503574,"Brugg AG, Au",,0.000063,57,5,3,8,17640,18249,35889,30,0.068211,0.084325,8669.427943,0,0
8503587,"Würenlingen, Post",,0.000011,57,0,2,2,0,7861,7861,30,0.066845,0.080051,0,0,0
8503591,"Kleindöttingen, Zentrum",,0.000067,57,3,2,5,8808,16027,24835,28,0.075494,0.09358,9840.844158,0,0
8503780,"Kleindöttingen, Eien",,0.000021,57,1,1,2,4919,5217,10136,35,0.047989,0.054623,0,0,0
8572450,"Umiken, Abzw. Riniken",,0.000073,57,3,2,5,11267,11281,22548,35,0.048077,0.055986,10283.966667,0,0
8572463,"Bözberg, Altstalden",,0.000072,57,1,2,3,5908,5908,11816,35,0.048005,0.055482,1059.066667,0,0
8503576,"Rafz, Post",,0.000011,68,0,3,3,0,14290,14290,12,0.189573,0.282889,0,0,0
8573708,"Rüdlingen, Steinenkreuz",,0.000053,68,2,2,4,9339,9336,18675,10,0.20202,0.271478,1632,0,0
8573709,"Rafz, Bahnhof",,0.000036,68,2,3,5,13028,10508,23536,11,0.203125,0.292512,1492,0,0
8581966,"Hüntwangen, Dorf",,0.000032,68,1,1,2,5922,5918,11840,4,0.4,0.520833,16,0,0
8503578,"Birmensdorf ZH, Sternen/WSL",,0.000032,85,2,1,3,13170,13170,26340,19,0.127239,0.143736,1896.317527,0,0
8503581,"Lengnau AG, Unterlengnau",,0.000026,22,2,1,3,5496,12406,17902,28,0.071051,0.082681,1263.1,0,0
8503799,"Ennetbaden, Schützenhaus",,0.00005,22,2,2,4,15265,15295,30560,26,0.082082,0.098905,3220.679458,0.000001,0.000001
8503583,"Unterendingen, Dorf",,0.00002,22,1,1,2,3163,3163,6326,30,0.066149,0.075995,4,0,0
8503585,"Ehrendingen, Post",,0.000047,22,3,2,5,14702,15295,29997,28,0.076078,0.091691,3482.073593,0,0
8503586,"Ehrendingen, Unterdorf",,0.000031,22,1,1,2,6559,6166,12725,28,0.076008,0.090786,0,0,0
8503592,"Villigen, PSI West",,0.000062,57,3,2,5,15468,16267,31735,30,0.067077,0.080874,5889.483785,0,0
8503588,"Ehrendingen, Höhtal",,0.000057,22,2,2,4,14902,15295,30197,27,0.082178,0.101945,5474.073593,0,0.000001
8503589,"Schneisingen, Murzlen",,0.000035,22,1,2,3,96,192,288,27,0.085636,0.111217,3721.418038,0,0.000038
8572583,"Ehrendingen, Niedermatt",,0.000028,22,1,4,5,15295,15295,30590,21,0.131566,0.164396,1664,0,0.001578
8503776,"Untersiggenthal, Mühleweg",,0.000049,22,4,2,6,29359,29479,58838,28,0.075795,0.093426,10552.041021,0.000001,0
8503597,"Windlach, Raat",,0.000011,107,0,1,1,0,12100,12100,23,0.094153,0.10992,0,0,0
8573711,"Zürich, Sädlenweg",,0.000047,85,4,3,7,22488,22480,44968,20,0.130643,0.151601,21952.982051,0.026955,0.013047
8573715,"Stallikon, Aumüli",,0.000033,85,2,2,4,4604,4611,9215,20,0.129838,0.148857,1436.091605,0.002175,0.010506
8572747,"Bremgarten AG, Bahnhof",,0.000074,85,5,6,11,22231,21379,43610,22,0.115962,0.140394,10383.01073,0.003037,0.01293
8573719,"Birmensdorf ZH, Aescherstrasse",,0.000023,85,1,2,3,5987,5976,11963,18,0.148464,0.177233,1914.509305,0.000071,0.12647
8503607,"Kirchberg BE, Neuhof Mitte",,0.000011,45,0,1,1,0,12810,12810,21,0.103466,0.122594,0,0,0
8530811,"Zürich, Balgrist",,0.000073,85,4,1,5,92325,95428,187753,18,0.123469,0.143065,7181.96284,0.000886,0.017694
8576193,"Zürich, Bellevue",,0.000036,85,4,13,17,326058,370970,697028,16,0.178554,0.243505,35502.309123,0.029655,1.467857
8576241,"Zürich, Heizenholz",,0.000013,85,1,4,5,40892,66827,107719,18,0.159606,0.204144,223.282053,0.017864,0.450044
8576263,"Zürich, Hungerbergstrasse",,0.000021,107,1,3,4,75018,74878,149896,15,0.177167,0.208988,555.615033,0.001385,0.158586
8573723,"Oberlunkhofen, Dorfplatz",,0.000068,85,4,5,9,9499,10660,20159,18,0.156945,0.190717,10717.699414,0.00702,0.174629
8574739,"Waldegg, Katholische Kirche",,0.000076,85,3,2,5,7269,7283,14552,18,0.150809,0.179298,7288.697097,0.000507,0.122362
8579994,"Wettswil a.A., Moosstrasse",,0.000088,85,3,4,7,10556,4793,15349,18,0.155659,0.194154,13469.574337,0.000418,0.193983
8580302,"Rottenschwil, Rebberg",,0.000068,85,4,3,7,4784,4790,9574,18,0.149757,0.18105,17543.198838,0.009207,0.153304
8580317,"Berikon, Stalden",,0.000054,85,3,4,7,14480,13876,28356,18,0.156015,0.185247,12426.975428,0.002584,0.144823
8590805,"Schlieren, Zentrum/Bahnhof",,0.00013,85,5,6,11,117487,114862,232349,11,0.205662,0.237046,44645.361511,0.000458,0.223225
8591033,"Zürich, Aargauerstrasse",,0.00002,85,3,2,5,48916,48932,97848,11,0.206701,0.230592,684.414205,0.142068,0.031332
8591035,"Zürich, Albisrank",,0.000028,85,3,2,5,80451,80429,160880,10,0.213115,0.239483,3403.824042,0.063981,0.038008
8591036,"Zürich, Albisrieden",,0.000022,85,3,3,6,75068,77298,152366,10,0.213575,0.241567,994.868242,0.105337,0.04437
8503612,"Mollis, Beglingen",,0.000011,106,0,2,2,0,6114,6114,15,0.12963,0.179389,0,0,0
8503629,"Obstalden, Stocken",,0.000016,106,1,2,3,2920,3268,6188,14,0.145199,0.197632,29,0,0
8503613,"Elm, Steinibach",,0.000022,128,1,1,2,3459,3459,6918,3,0.5,0.611111,30,0,0
8503614,"Elm, Rüfi",,0.000029,128,1,1,2,3459,3335,6794,2,0.666667,0.75,22,0,0
8503615,"Elm, Altersheim",,0.000026,128,1,1,2,6790,7022,13812,12,0.138889,0.171935,11,0,0
8503619,"Elm, Chappelen",,0.000036,128,1,1,2,3335,852,4187,1,1,1,12,0,0
8503623,"Vorderthal, Schweig",,0.000016,67,1,1,2,4412,4205,8617,28,0.059705,0.070187,7,0,0
8503624,"Vorderthal, Sonne",,0.000024,67,1,1,2,4205,4412,8617,27,0.063254,0.07423,268,0,0
8503625,"Vorderthal, Einschnitt",,0.000031,67,1,1,2,4412,4412,8824,26,0.067268,0.07895,527,0,0
8503626,"Vorderthal, Flühbödeli",,0.000038,67,1,1,2,4412,4412,8824,25,0.071843,0.084553,784,0,0
8503628,"Vorderthal, Rempen",,0.000043,67,1,1,2,4412,4412,8824,24,0.077106,0.09135,1039,0,0
8503973,"Mollis, Post",,0.000022,106,2,2,4,6114,6114,12228,14,0.144208,0.196773,35,0,0
8503634,"Pfäffikon SZ, Industrie Ost",,0.000011,67,0,1,1,0,6089,6089,28,0.06097,0.07239,0,0,0
8503635,"Altendorf, Lidwil",,0.00002,67,1,1,2,6089,6089,12178,27,0.064692,0.07701,273,0,0
8503636,"Altendorf, Schweizerhofplatz",,0.000028,67,1,1,2,6089,6089,12178,26,0.068913,0.082537,544,0,0
8503637,"Lachen SZ, Rotbach",,0.000035,67,1,1,2,6089,6089,12178,25,0.073741,0.089336,813,0,0
8503638,"Galgenen, Kirche",,0.00004,67,1,1,2,6089,6089,12178,24,0.079318,0.09806,1080,0,0
8503640,"Siebnen, Schulhaus",,0.000054,67,2,4,6,20651,25291,45942,22,0.093543,0.13035,1876,0,0
8503643,"Buttikon SZ, Dorfplatz",,0.000036,67,1,2,3,10240,10240,20480,21,0.100537,0.133168,524,0,0
8503717,"Nuolen, Kirche",,0.000017,67,1,3,4,6272,6112,12384,21,0.100039,0.134904,1,0,0
8503641,"Schübelbach, Dorf",,0.000022,67,1,1,2,10240,10240,20480,23,0.084264,0.10219,16,0,0
8503642,"Schübelbach, Gutenbrunnen",,0.00003,67,1,1,2,10240,10240,20480,22,0.09167,0.114487,271,0,0
8503715,"Wangen SZ, Löwenfeld",,0.000022,67,1,3,4,12235,13943,26178,21,0.100347,0.136308,1740,0,0
8503760,"Vorderthal, Post",,0.000054,67,1,1,2,4412,4004,8416,21,0.099033,0.126719,1792,0,0
8506738,"Tuggen, Grynau",,0.000051,67,1,2,3,8818,8818,17636,21,0.099691,0.131551,780,0,0
8510049,"Siebnen, Bitzi",,0.000055,67,4,2,6,9620,9199,18819,21,0.099381,0.130117,96.5,0,0
8570505,"Altendorf, Tevag",,0.000046,67,2,2,4,5659,6089,11748,21,0.102196,0.13732,528,0,0
8503649,"Kirchberg BE, Neuhof Nord",,0.00002,45,1,1,2,12810,12819,25629,20,0.114838,0.138868,202,0,0
8503656,"Aefligen, Bahnhof",,0.000028,45,1,1,2,12819,12819,25638,19,0.129094,0.16226,402,0,0
8508892,"Ersigen, Gemeindehaus",,0.000016,45,1,2,3,7286,15268,22554,19,0.131043,0.169406,201,0,0
8508966,Rudswil,,0.000046,45,1,1,2,8595,8595,17190,19,0.129094,0.16226,804,0,0
8503684,"Oberiberg, Tschalun",,0.000011,69,0,4,4,0,8294,8294,25,0.103787,0.144618,0,0,0
8503734,"Willerzell, Grüene Aff",,0.000026,69,1,2,3,2678,2678,5356,31,0.068578,0.09636,519,0,0
8503744,"Euthal, Rüti",,0.000024,69,1,3,4,9518,9252,18770,27,0.087741,0.118948,5102.25,0,0
8503746,"Unteriberg, Jessenenbrücke",,0.00002,69,2,1,3,7282,7282,14564,26,0.093619,0.121314,5453,0,0
8503757,"Oberiberg, Neuseewen",,0.00003,69,2,2,4,7468,7733,15201,25,0.10308,0.142923,5972.333333,0,0
8505084,"Ibach, Kirche",,0.000016,91,1,4,5,27989,48709,76698,24,0.109194,0.161363,162.25,0,0
8572493,"Kleindöttingen, Breite",,0.000035,57,1,1,2,4919,5217,10136,27,0.07594,0.089673,21118,0,0.000002
8503686,"Goldingen, Ennetbach",,0.000028,67,1,2,3,5903,6254,12157,47,0.03922,0.054933,2478,0,0
8503763,"Atzmännig, Schutt",,0.000023,67,1,1,2,5642,5903,11545,47,0.03919,0.05417,0,0,0
8503687,"Kaiserstuhl AG, Bahnhof",,0.00002,107,1,2,3,12100,12109,24209,22,0.103832,0.126451,962,0,0.000017
8503702,"Bülach, Bahnhof",,0.000019,107,1,8,9,1869,75231,77100,21,0.115727,0.151384,1907,0,0.000705
8503688,"Frauenfeld, Aumühle",,0.000011,65,0,1,1,0,8830,8830,40,0.042372,0.063204,0,0,0
8506679,"Affeltrangen, Dorf",,0.000011,65,0,1,1,0,6112,6112,40,0.042372,0.063204,0,0,0
8503690,"Stallikon, Dorf",,0.00004,85,3,1,4,5192,5943,11135,19,0.120699,0.135774,1375.526288,0.018182,0
8503691,"Stallikon, Bleiki",,0.000045,85,1,2,3,5943,5943,11886,18,0.137111,0.159736,2209.526288,0,0
8503694,"Stallikon, Gamlikon",,0.00003,85,1,2,3,4614,4612,9226,18,0.136997,0.159347,44,0,0
8503695,"Hausen am Albis, Türlersee",,0.000024,85,1,1,2,1933,1932,3865,18,0.136862,0.158385,0,0,0
8503692,"Wettswil a.A., Dorf",,0.000017,85,1,2,3,968,5107,6075,18,0.128629,0.150052,234.078767,0.017286,0.002274
8573714,"Ringlikon, Langwis",,0.000039,85,3,3,6,7268,7278,14546,21,0.118512,0.136796,3934.478738,0.000562,0.00236
8573726,"Bonstetten-Wettswil, Bahnhof",,0.000138,85,5,7,12,15611,15628,31239,19,0.138286,0.169599,13316.580162,0.000198,0.009354
8573729,"Bonstetten, Isenbach",,0.000028,85,1,3,4,2277,2101,4378,19,0.136303,0.162123,0,0.000216,0.008344
8573731,"Stallikon, Diebis",,0.000074,85,3,4,7,5938,5937,11875,19,0.13417,0.158283,4565.21532,0.000362,0.020902
8503698,"Birmensdorf ZH, Untere Risi",,0.000017,85,1,1,2,4792,4787,9579,18,0.132799,0.153934,1504,0.017286,0
8576153,"Kloten, Rankstrasse",,0.000023,107,2,2,4,44419,44413,88832,26,0.107527,0.131404,2839.452381,0.000152,0.003534
8506961,"Winterthur, Steigmühle",,0.000016,107,1,3,4,4110,4113,8223,22,0.103863,0.125042,118.966503,0,0.000017
8576158,"Bassersdorf, Talgüetli",,0.000024,107,1,2,3,36497,36501,72998,23,0.101993,0.120205,2189,0.000004,0.000008
8503783,"Neerach, Post",,0.000022,107,2,1,3,22493,22950,45443,22,0.099754,0.115513,13,0.000017,0.000017
8503781,"Bachenbülach, Alte Post",,0.000022,107,1,2,3,26886,26891,53777,21,0.111163,0.132419,952,0,0.00002
8503788,"Winkel, Zentrum",,0.00002,107,1,3,4,12274,14013,26287,21,0.111477,0.13445,28,0,0.000125
8503782,"Höri, Gemeindehaus",,0.000022,107,1,2,3,12063,12537,24600,23,0.095396,0.114702,947,0,0.000073
8573235,"Neerach, Gemeindehaus",,0.000031,107,3,2,5,10700,10711,21411,20,0.102473,0.122512,851.25,0.000822,0.00018
8573236,"Oberglatt ZH, Mösli Hofstetten",,0.000046,107,4,1,5,26738,26653,53391,20,0.102336,0.121195,554.7171,0.000159,0.000021
8503856,"Bülach, Kantonsschule",,0.000033,107,4,6,10,12660,11759,24419,22,0.10482,0.131761,1883.265123,0.000051,0.000871
8503871,"Höri, Oberhöri",,0.000025,107,2,3,5,12537,12536,25073,21,0.108508,0.131951,294.903059,0.000022,0.0009
8557119,"Bülach, Pfarrgässli",,0.000016,107,1,1,2,4245,4245,8490,17,0.112871,0.130495,0,0.00002,0.000548
8573206,"Bachenbülach, Schmiede",,0.000038,107,3,2,5,26896,26894,53790,21,0.104484,0.126185,277.196429,0.000454,0.000978
8573211,"Kloten, Zum Wilden Mann",,0.000029,107,2,12,14,141127,141091,282218,19,0.128462,0.166713,4520.813118,0.000561,0.006431
8573237,"Oberglatt ZH, Bahnhof",,0.000066,107,3,7,10,35635,37071,72706,19,0.113831,0.145032,2806.133766,0.000021,0.006112
8573239,"Oberglatt ZH, Zentrum",,0.000027,107,2,4,6,19577,19604,39181,19,0.112947,0.138673,311.333333,0.000151,0.005298
8573256,"Bülach, Spital",,0.000048,107,1,1,2,12414,12408,24822,17,0.112871,0.130495,1632.9,0,0.000548
8506755,"Flaach, Wesenplatz",,0.000024,68,2,4,6,5188,10235,15423,45,0.056363,0.089178,1536.2,0,0
8573694,"Winterthur, Schützenhaus",,0.000029,68,2,3,5,14792,14785,29577,15,0.149597,0.20972,492,0,0
8557101,"Schlieren, Kampstrasse",,0.000014,85,1,1,2,2636,2620,5256,22,0.106075,0.118507,0,0.000248,0.000562
8506525,"Lachen SZ, Obersee-Center",,0.000027,67,2,2,4,5866,5659,11525,22,0.093377,0.12077,332.5,0,0
8503718,"Avry-sur-Matran, CO",,0.000011,126,0,4,4,0,3651,3651,50,0.059755,0.108862,0,0,0
8504004,"Onnens FR, Pierra Fatta",,0.000013,126,1,2,3,1711,7410,9121,49,0.053123,0.075637,232.833333,0,0
8504548,"Lentigny, village",,0.000017,126,1,3,4,7101,7324,14425,48,0.05602,0.08403,2215.833333,0,0
8503889,"Fribourg/Freiburg, gare/Colisée",,0.000011,126,0,5,5,0,100394,100394,33,0.090091,0.138594,0,0,0
8504796,"Corserey, anc. poste",,0.000038,13,2,2,4,5251,5251,10502,45,0.066202,0.114008,21360.74733,0,0
8504862,"Marly, Cité",,0.000071,126,5,4,9,93711,100082,193793,32,0.087483,0.128844,26502.026384,0,0
8504864,"Misery, village",,0.000051,126,2,1,3,13686,13686,27372,33,0.089626,0.134318,6979.304762,0,0
8504865,"Le Mouret, village",,0.000026,126,1,4,5,12682,12682,25364,33,0.089926,0.136856,150.1,0,0
8504869,"Plasselb, Dorf",,0.000028,126,1,2,3,12050,12056,24106,33,0.089656,0.134931,1659.132013,0,0
8504870,"Posieux, village",,0.000056,126,3,2,5,21992,22104,44096,33,0.089686,0.134954,18855.214465,0,0
8504871,"Rechthalten, Dorf",,0.000028,126,1,1,2,10539,10548,21087,33,0.089626,0.134318,1537.486191,0,0
8504877,"Tafers, Dorf",,0.000107,126,7,7,14,36159,36671,72830,33,0.089971,0.138562,28155.020463,0,0
8504878,"Vuisternens-en-Ogoz, croisée",,0.000072,126,4,3,7,19763,15832,35595,33,0.090467,0.138891,13357.442772,0,0
8503721,"Einsiedeln, Rüti-Säge",,0.000011,69,0,1,1,0,4269,4269,22,0.097212,0.146062,0,0,0
8503726,"Bennau, Schnabelsberg",,0.000011,69,0,2,2,0,4341,4341,22,0.097892,0.152631,0,0,0
8503727,"Bennau, Burgeren",,0.000016,69,1,1,2,2212,2212,4424,22,0.096677,0.144599,1.5,0,0
8503728,"Bennau, Wettertannen",,0.000024,69,1,2,3,2212,2212,4424,21,0.106187,0.177359,127.5,0,0
8503737,"Willerzell, Kirche",,0.000047,69,4,4,8,5574,8744,14318,30,0.072965,0.109415,3514.138889,0,0
8503747,"Horgenberg b. Einsied., Tanks.",,0.000021,69,1,1,2,2387,2678,5065,21,0.106099,0.173422,0,0,0
8503775,"Euthal, Schulhaus",,0.000074,69,4,5,9,14010,14098,28108,21,0.11044,0.211935,858.27381,0,0
8503870,"Hoch-Ybrig, Talst. Laucheren",,0.000038,69,2,2,4,3455,3455,6910,21,0.106723,0.181483,259.02381,0,0
8557000,"Einsiedeln, Alpstrasse",,0.000016,69,1,1,2,2129,2129,4258,21,0.106099,0.173422,126.5,0,0
8557001,"Einsiedeln, Grotzenmühlestr.",,0.00002,69,1,2,3,4269,4269,8538,21,0.106845,0.179879,128,0,0
8557002,"Einsiedeln, Rütiweg",,0.000019,69,1,1,2,2135,2135,4270,21,0.106099,0.173422,0,0,0
8573756,"Einsiedeln, Bahnhof",,0.000116,69,8,9,17,22111,32940,55051,20,0.117757,0.238867,2411.22619,0,0
8503730,"Einsiedeln, Badeanstalt",,0.000011,69,0,2,2,0,2752,2752,31,0.068877,0.096848,0,0,0
8503732,"Egg SZ, Langrüti",,0.000024,69,1,3,4,2678,5356,8034,31,0.06884,0.099139,515,0,0
8503736,"Einsiedeln, Birchli/Stollern",,0.000032,69,1,2,3,10438,10438,20876,31,0.068373,0.095587,538.138889,0,0
8503731,"Egg SZ, Schlapprig",,0.000016,69,1,1,2,2678,2678,5356,32,0.064524,0.086238,7,0,0
8573789,"Einsiedeln, Brüel",,0.000147,69,9,6,15,17542,17641,35183,6,0.363636,0.511111,984.642857,0,0
8573791,"Einsiedeln, Blüemenen",,0.000024,69,1,1,2,2686,2678,5364,6,0.30303,0.386667,10,0,0
8503733,"Egg SZ, Postplatz",,0.000018,69,1,1,2,2077,2678,4755,32,0.064296,0.084804,15,0,0
8503735,"Einsiedeln, Birchli/Sternen",,0.000024,69,2,1,3,7740,10438,18178,32,0.064116,0.08425,39.138889,0,0
8503739,"Euthal, Steinbach",,0.000032,69,1,1,2,9518,9518,19036,30,0.071643,0.093952,501,0,0
8503738,"Gross, Ebenau",,0.000024,69,1,1,2,9134,9518,18652,31,0.066978,0.084475,8,0,0
8503740,"Euthal, Ruostel",,0.000048,69,2,2,4,13851,13851,27702,29,0.077018,0.107971,4457,0,0
8503742,"Studen SZ, Dörfli",,0.000024,69,1,2,3,4087,4087,8174,22,0.100853,0.168027,62.75,0,0
8503743,"Studen SZ, Ochsenboden",,0.000021,69,1,1,2,2721,2721,5442,22,0.100155,0.161578,0,0,0
8503759,"Unteriberg, Guggelstrasse",,0.000053,69,3,3,6,9852,9751,19603,22,0.101575,0.178235,496.297619,0,0
8503741,"Euthal, Höhport",,0.000031,69,1,2,3,13358,13605,26963,28,0.081736,0.109546,4692,0,0
8503753,"Hoch-Ybrig, Talst. Weglosen",,0.000026,69,1,1,2,1902,1990,3892,23,0.092857,0.143756,130,0,0
8503745,"Unteriberg, Waag",,0.000018,69,1,1,2,1823,1902,3725,24,0.085565,0.124384,14,0,0
8503748,"Tuggen, Linthhof",,0.000038,67,2,1,3,8818,8818,17636,24,0.077494,0.092374,39,0,0
8503749,"Siebnen, Mühle",,0.000047,67,1,1,2,4412,4412,8824,23,0.083226,0.099846,1292,0,0
8503751,"Wald ZH, Rehazentrum",,0.00002,67,1,1,2,855,849,1704,23,0.125763,0.172327,206,0,0
8506862,"Laupen ZH, Schulhaus",,0.000036,67,2,1,3,2044,2963,5007,23,0.125763,0.172327,1655,0,0
8503755,"Innerthal, Post",,0.000051,67,1,1,2,4412,4412,8824,22,0.090429,0.110962,1543,0,0
8573778,"Unteriberg, Nidlau",,0.000045,69,1,3,4,9164,9164,18328,7,0.295918,0.391708,196.5,0,0
8503979,"Ricken SG, Rittmarren",,0.000051,67,2,4,6,6011,6055,12066,44,0.043472,0.071193,10598.27381,0,0
8503771,"Bülach, Kaserne",,0.000013,107,1,1,2,11802,12063,23865,24,0.087172,0.100941,3,0.000016,0
8503772,"Bülach, Mettmenriet",,0.000013,107,1,1,2,26739,26886,53625,22,0.100137,0.115016,6,0.000016,0
8573772,"Einsiedeln, Friedhof",,0.000031,69,2,3,5,10731,10820,21551,7,0.272109,0.356726,240,0,0
8573774,"Gross, Grossbach",,0.000028,69,1,1,2,9134,9518,18652,11,0.155738,0.2014,38,0,0
8573783,"Willerzell, Schönbächli",,0.000049,69,1,3,4,4333,4333,8666,7,0.292135,0.398443,97.5,0,0
8573784,"Studen SZ, Adelmatt",,0.000037,69,2,3,5,2721,2721,5442,7,0.287356,0.394381,75.59127,0,0
8580525,"Willerzell, Stöfeli",,0.000056,69,3,3,6,4333,4333,8666,6,0.347826,0.55625,67.944444,0,0
8581746,"Willerzell, Bodenmattli",,0.000113,69,4,2,6,4056,3550,7606,4,0.461538,0.597222,321.666667,0,0
8503777,"Untersiggenthal, Spiracher",,0.000032,22,1,2,3,27297,27296,54593,27,0.081859,0.104375,11344.041021,0,0
8503778,"Turgi, Wil",,0.000018,22,1,1,2,12124,12124,24248,23,0.106924,0.123671,537.80943,0,0
8572572,"Ennetbaden, Goldwand",,0.000024,22,2,1,3,12037,12037,24074,23,0.105528,0.120861,7,0.000067,0.000069
8503786,"Stadel b. N., Zentrum",,0.000031,107,2,5,7,23107,23726,46833,21,0.110689,0.13428,967.5,0.000017,0.005088
8503854,"Windlach, Kreuz",,0.000016,107,1,2,3,12091,12104,24195,22,0.099477,0.114772,0,0.000117,0.000262
8503860,"Riedt bei Neerach, Riedacher",,0.000023,107,2,1,3,10708,10714,21422,21,0.109904,0.128712,887.8,0.000124,0.00012
8504802,"Hochfelden, Grabenstrasse",,0.000037,107,1,4,5,12418,12414,24832,21,0.111031,0.13478,979.771429,0,0.005147
8573247,"Weiach, Gemeindehaus",,0.00003,107,3,1,4,12072,12097,24169,21,0.086505,0.095069,42.571429,0.004352,0.004588
8503791,"Thalwil, Ebnet",,0.000039,115,2,3,5,3150,3152,6302,28,0.065114,0.077416,4821,0.000021,0
8573159,"Langnau am Albis, Mittelalbis",,0.000041,63,1,1,2,1229,1228,2457,29,0.060763,0.067676,1515,0,0
8573160,"Langnau am Albis, Dorf",,0.000057,63,2,1,3,2556,2558,5114,28,0.064566,0.072066,2016,0,0
8573505,"Wermatswil, Chammerholzstr.",,0.000021,84,1,1,2,5036,5036,10072,13,0.15493,0.224772,1529.5,0,0
8503795,"Wädenswil, Hangenmoos",,0.000011,63,0,2,2,0,22508,22508,18,0.108326,0.144719,0,0,0
8503797,"Wädenswil, Sandhof",,0.000024,63,2,1,3,7912,7932,15844,18,0.108147,0.142329,172.837662,0,0
8503866,"Wädenswil, Winterberg",,0.000018,63,2,6,8,22502,22507,45009,13,0.177305,0.263929,38.333333,0,0
8503990,"Wädenswil, Neubühl",,0.000035,63,3,4,7,6874,6872,13746,14,0.15798,0.223143,210,0,0
8573570,"Wädenswil, Feld",,0.000059,63,2,3,5,11696,11706,23402,13,0.170251,0.236066,1829.766667,0,0
8573572,"Wädenswil, Chalchtaren",,0.000034,63,1,2,3,1790,1790,3580,14,0.153213,0.202275,93,0,0
8573573,"Wädenswil, Hintere Rüti West",,0.000055,63,5,3,8,25820,25830,51650,13,0.175238,0.241732,1259.366667,0,0
8573575,"Wädenswil, Krähbach",,0.000056,63,1,2,3,17258,17256,34514,16,0.129125,0.197562,356.266667,0,0
8573576,"Wädenswil, Schwanen",,0.000037,63,2,4,6,13451,13545,26996,15,0.14378,0.237644,202.433333,0,0
8590490,"Au ZH, Appital",,0.000013,63,1,1,2,6670,6670,13340,12,0.135593,0.175861,0,0,0
8590493,"Au ZH, Bahnhof",,0.000057,63,3,2,5,7411,7411,14822,10,0.177122,0.237616,818.54329,0,0
8573577,"Wädenswil, Schmiedstube",,0.000056,63,5,4,9,23751,23849,47600,14,0.154399,0.243356,1254.180952,0,0
8590856,"Wädenswil, Coop",,0.000124,63,7,5,12,25368,25357,50725,5,0.384615,0.515833,1538.966667,0,0
8580292,"Wädenswil, Ceder",,0.000043,63,2,2,4,10271,10268,20539,7,0.293333,0.374675,142.166667,0,0
8590858,"Wädenswil, Forschungsanstalt",,0.000059,63,1,4,5,12239,12237,24476,5,0.458333,0.616667,77.166667,0,0
8590859,"Wädenswil, Frohmatt",,0.000032,63,1,1,2,3278,3281,6559,5,0.333333,0.404545,0,0,0
8503880,"Endingen, Israelit. Friedhof",,0.000042,22,2,2,4,12406,12406,24812,26,0.082053,0.098911,2549.926407,0,0.000038
8573205,"Zürich Flughafen, Bahnhof",,0.000075,107,8,8,16,115333,383826,499159,19,0.139248,0.180505,26752.652466,0.000216,0.017663
8573541,"Hittnau, Furt",,0.000029,84,1,1,2,4897,4900,9797,14,0.125786,0.166261,118,0,0
8503864,"Schönenberg ZH, Mühlestalden",,0.000019,63,3,3,6,8230,8209,16439,15,0.126347,0.166717,46.866667,0,0
8503865,"Hütten, Segel",,0.000018,63,2,2,4,7685,7704,15389,15,0.12549,0.160207,14.866667,0,0
8503867,"Horgen, Enderholz",,0.000021,63,1,2,3,1117,1118,2235,13,0.142694,0.186176,125,0,0
8573166,"Thalwil, Mühlebachplatz",,0.000072,63,1,2,3,3173,3173,6346,22,0.103815,0.130502,10046,0,0
8503899,"Horgen, Waldegg",,0.000021,63,2,4,6,5204,5203,10407,13,0.152898,0.217113,179.885714,0,0
8507447,"Hirzel, Wässeri",,0.000028,63,1,3,4,883,862,1745,21,0.092676,0.156741,488.5,0,0
8507477,"Hirzel, Wässeri",,0.000036,63,2,1,3,860,854,1714,22,0.084304,0.122945,2.5,0,0
8573168,"Thalwil, Bahnhof",,0.000047,63,2,5,7,3543,2927,6470,21,0.098805,0.194077,2292,0,0
8573167,"Thalwil, Zentrum",,0.000043,63,2,7,9,4924,9721,14645,21,0.11542,0.156574,10915,0,0
8573552,"Horgen, Altes Gemeindehaus",,0.000063,63,5,1,6,3902,3939,7841,21,0.091317,0.142917,122,0,0
8577867,"Horgen, Waidli",,0.000036,63,2,2,4,3700,3700,7400,13,0.158209,0.228377,389.5,0,0
8579190,"Horgen, Plattenhof",,0.000036,63,1,2,3,2165,2165,4330,13,0.128641,0.183777,159,0,0
8580724,"Horgen, Baumgärtlihof",,0.000027,63,2,2,4,3178,3178,6356,12,0.173285,0.248679,205.5,0,0
8588986,"Horgen, Reithy",,0.000038,63,2,2,4,3700,3700,7400,11,0.191057,0.272823,927.666667,0,0
8590502,"Au ZH, Unter Ort",,0.000082,63,3,3,6,7411,7411,14822,7,0.263514,0.341087,914,0,0
8590651,"Horgen, Dorfgasse",,0.000063,63,4,3,7,7845,6546,14391,7,0.283333,0.416246,910.333333,0,0
8590652,"Horgen, Glärnischhof",,0.00004,63,2,1,3,2653,2654,5307,7,0.25,0.326871,98.166667,0,0
8573257,"Bülach, Sonnenhof",,0.000115,107,10,9,19,74660,72553,147213,16,0.127009,0.157948,6138.116357,0.000548,0.007507
8580619,"Bachenbülach, Bramenländli",,0.000042,107,2,3,5,18771,18825,37596,10,0.230769,0.400375,489.5,0.000125,0.000033
8580621,"Bülach, Kreuzstrasse",,0.000031,107,2,2,4,6434,6386,12820,12,0.153061,0.287621,89,0.000178,0.000032
8580622,"Bülach, Bahnhof Ost",,0.000024,107,1,1,2,4964,4961,9925,12,0.14433,0.236737,0,0.000005,0.000032
8503857,"Winkel, Bühlhof",,0.000026,107,3,1,4,13973,14005,27978,21,0.10946,0.12726,1993.149544,0.000054,0
8503862,"Langnau a.A.,Schwerzi-Wildpark",,0.000022,115,1,1,2,1231,1230,2461,32,0.051668,0.057595,72,0,0
8503863,"Horgen, Hanegg",,0.000012,63,1,1,2,1118,1117,2235,14,0.125749,0.155216,7,0,0
8573567,"Schönenberg ZH, Neubad",,0.000038,63,1,3,4,805,802,1607,14,0.159869,0.227402,2245.6,0,0
8503868,"Wädenswil, Gisenrüti",,0.000013,63,1,2,3,1791,1791,3582,15,0.13885,0.185401,0,0,0
8503869,"Wädenswil, Herrlisberg",,0.000019,63,2,1,3,1790,1790,3580,15,0.13764,0.177088,0,0,0
8503874,"Teufen ZH, Unterteufen",,0.000011,107,0,1,1,0,8035,8035,23,0.092121,0.10386,0,0,0
8506889,"Embrach, Gemeindehaus",,0.000016,107,1,3,4,391,35476,35867,22,0.100782,0.117067,342.166667,0.00002,0
8572511,"Gebenstorf, Cherne",,0.000043,22,4,4,8,26446,26011,52457,22,0.119991,0.149245,1969.023408,0.000006,0.00019
8572524,"Untersiggenthal, Hardacker",,0.000029,57,1,3,4,3847,4590,8437,22,0.117775,0.141772,1620,0,0.000005
8572577,"Untersiggenthal, Schönegg",,0.000043,22,2,1,3,17516,17516,35032,22,0.117673,0.139312,1187.133333,0,0.000005
8572558,"Niederrohrdorf, Oberdorf",,0.000063,22,2,3,5,17880,17173,35053,21,0.107798,0.127267,61494.792321,0.000027,0.000895
8572512,"Gebenstorf, Rieden",,0.00002,22,1,1,2,6797,7219,14016,25,0.087898,0.098112,13.5,0.000004,0.000069
8507585,"Baden, Utostrasse",,0.000011,22,0,2,2,0,22718,22718,28,0.082024,0.109482,0,0,0.000024
8510075,"Baden, Dammstrasse",,0.000023,22,1,2,3,5746,5746,11492,21,0.132385,0.16277,549,0,0.001234
8572515,"Birmenstorf AG, Heigelweg",,0.000051,22,1,4,5,18709,19145,37854,22,0.118651,0.146464,1671.1,0,0.00087
8503887,"Langnau am Albis,Oberrenggstr.",,0.00003,115,1,1,2,1230,1222,2452,31,0.054376,0.060541,555,0,0
8504622,"Fribourg, Bellevue",,0.000013,126,1,2,3,26927,27546,54473,17,0.166011,0.205566,30.316667,0,0
8570492,"Rosé, gare",,0.000109,126,6,7,13,34610,34590,69200,18,0.132301,0.178154,13026.246424,0,0
8577784,"Fribourg, Beauregard",,0.000031,126,3,2,5,53075,96590,149665,16,0.157539,0.196368,885.636194,0,0
8503896,"Horgenberg, Moorschwand",,0.000025,63,3,2,5,1718,1717,3435,23,0.079924,0.121857,158,0,0
8503897,"Schönenberg ZH, Müsli",,0.000022,63,1,1,2,803,803,1606,23,0.079345,0.114887,0,0,0
8573565,"Hirzel, Spitzen",,0.000072,63,2,3,5,2835,2837,5672,11,0.169466,0.2273,3808.385714,0,0
8503950,Altdorf Dorf,,0.000015,66,1,1,2,2114,2615,4729,16,0.116205,0.150301,20,0,0
8503951,Bargen Dorf,,0.000015,66,1,2,3,697,5207,5904,13,0.147601,0.222115,90,0,0
8573471,Buchbergstrasse,,0.00003,66,2,2,4,6608,9915,16523,13,0.146154,0.224156,192,0,0
8573477,Bargen Schinderwies,,0.000042,66,1,1,2,4907,4907,9814,13,0.136,0.189253,102,0,0
8505344,"Uhwiesen, Wassergasse",,0.000041,66,1,2,3,12690,12682,25372,42,0.051235,0.091776,1506,0,0
8506768,"Rheinau, Unterstadt",,0.00002,66,1,1,2,6411,6408,12819,42,0.050457,0.084152,502,0,0
8503955,Büttenhardt Dorf,,0.000022,66,2,2,4,5526,5526,11052,16,0.11493,0.151552,41,0,0
8573746,Dörflingen Unterberg,,0.000025,66,1,3,4,6120,6120,12240,4,0.419355,0.525641,100.666667,0,0
8573754,Ramsen Dorf,,0.000018,66,1,1,2,606,606,1212,4,0.37037,0.433333,0,0,0
8503958,"Feuerthalen, Zentrum Kohlfirst",,0.000021,66,2,1,3,12684,12691,25375,45,0.044651,0.066305,63,0,0
8503959,"Flurlingen, AROVA",,0.000029,66,1,1,2,12691,12689,25380,44,0.046645,0.072192,546,0,0
8503962,Hemmental Gehren,,0.000015,66,1,1,2,5025,5425,10450,18,0.09146,0.106035,20,0,0
8503970,Stetten Vorderdorf,,0.000038,66,3,2,5,5325,5326,10651,14,0.140903,0.181728,285.833333,0,0
8510041,Thayngen Sägi,,0.000037,66,2,2,4,302,302,604,14,0.142061,0.190279,12,0,0
8573484,Lohn Kreuz,,0.000029,66,1,3,4,5824,5824,11648,5,0.433333,0.547436,244,0,0
8573486,Büttenhardt Reiathöfe,,0.000019,66,1,1,2,3119,3119,6238,6,0.342857,0.426389,0,0,0
8503971,"Uhwiesen, Kapelle",,0.000036,66,1,1,2,12689,12690,25379,43,0.04883,0.080039,1027,0,0
8503972,"Hirzel, Wolfisbühl",,0.00004,63,2,2,4,1717,1714,3431,22,0.085499,0.132978,390,0,0
8509852,"Obstalden, Post",,0.000034,106,1,3,4,6101,6105,12206,12,0.191558,0.27223,227,0,0
8503978,"Ricken SG, Uznacherstrasse",,0.000055,67,3,2,5,12863,13040,25903,45,0.041696,0.063396,4153.466667,0,0
8503975,"Wattwil, Hinterer Hummelwald",,0.000013,67,1,1,2,6800,6800,13600,48,0.037147,0.049919,6,0,0
8503976,"Wattwil, Vorderer Hummelwald",,0.000022,67,1,1,2,6800,6800,13600,47,0.038548,0.053343,1193,0,0
8503980,Steg SG (Gebertingen),,0.000045,67,2,1,3,8294,8295,16589,46,0.040182,0.059665,48.304762,0,0
8503981,"Uetliburg SG, Birkenhalde",,0.000027,67,2,3,5,11400,10037,21437,46,0.040471,0.064872,203.166667,0,0
8506486,"Gebertingen, Schulhaus",,0.00003,67,1,3,4,1811,1811,3622,44,0.042847,0.067149,839.585714,0,0
8506490,"Ernetschwil, Hof",,0.000019,67,1,1,2,974,978,1952,44,0.042734,0.064772,0,0,0
8573843,"Uznach, Neumühle",,0.000028,67,1,1,2,3690,3690,7380,44,0.042734,0.064772,2169,0,0
8506494,"Gommiswald, Schönenbach",,0.000027,67,2,2,4,4705,6214,10919,16,0.157793,0.193472,263.37619,0,0
8503983,"Wattwil, Tüetlisberg",,0.000011,97,0,2,2,0,4053,4053,42,0.051891,0.075734,0,0,0
8503984,"Hemberg, Schlatt",,0.000016,97,1,1,2,3605,3605,7210,42,0.051853,0.075023,0,0,0
8503986,"Heiterswil, alte Post",,0.000029,97,2,1,3,4053,4053,8106,41,0.054646,0.083571,2598,0,0
8503987,"Wattwil, Eggberg",,0.000035,97,1,4,5,4053,4053,8106,40,0.057761,0.09592,3894,0,0
8506608,"Schwellbrunn, Winkfeld",,0.000023,97,1,2,3,4623,4623,9246,43,0.053698,0.083292,3266.5133,0,0
8506705,"Brunnadern, Furth",,0.00004,97,1,3,4,7497,7497,14994,41,0.057973,0.096825,3678.8,0,0
8506751,"Bächli, Dorf",,0.00003,97,2,2,4,519,2233,2752,41,0.0535,0.090381,94.333333,0,0
8506757,"Hemberg, Dorf",,0.000031,97,2,3,5,5361,5401,10762,40,0.056063,0.102111,1442.033333,0,0
8506770,"St. Peterzell, Dorf",,0.000085,97,5,5,10,12861,13100,25961,40,0.056425,0.105325,17699.704591,0,0
8509781,"Grabs, Post",,0.000031,73,2,8,10,14016,31408,45424,41,0.082274,0.126722,14912.2,0,0
8573850,"Gebertingen, Frohe Aussicht",,0.000041,67,2,4,6,8291,8295,16586,41,0.048384,0.085538,22363.380952,0,0
8573860,"Eschenbach SG, Dorftreff",,0.00011,67,5,9,14,34476,36920,71396,41,0.04841,0.094044,47002.259524,0,0
8574007,"Lichtensteig, Hof",,0.000073,97,3,2,5,24656,24656,49312,41,0.046611,0.073556,126500.566667,0,0
8503988,"Freudwil, Im Dörfli",,0.000017,84,1,1,2,5030,5036,10066,17,0.106011,0.123492,5,0,0
8573502,"Pfäffikon ZH, Ruetschbergstr.",,0.000029,84,1,1,2,9057,9056,18113,17,0.106011,0.123492,11221,0,0
8573568,"Schönenberg ZH, Zweierhof",,0.000034,63,3,1,4,8226,8211,16437,15,0.129161,0.1594,1675.066667,0,0
8573569,"Wädenswil, Beichlen",,0.000048,63,2,1,3,10001,10004,20005,14,0.146789,0.187034,1704.066667,0,0
8503991,Bürg,,0.000042,67,2,1,3,6515,6229,12744,46,0.040755,0.05842,4948,0,0
8503994,"Rieden SG, Freigaden",,0.000021,67,1,2,3,5509,5509,11018,46,0.039867,0.060791,539.690476,0,0
8573846,"Gommiswald, Hansjunger",,0.000037,67,1,2,3,5704,5704,11408,43,0.044278,0.068126,1186,0,0
8503996,"Kaltbrunn, Dorf",,0.000047,67,3,1,4,9712,9430,19142,44,0.043165,0.067032,4962.911905,0,0
8504000,Pully-Nord,,0.000023,4,1,2,3,19275,19275,38550,32,0.066994,0.079811,444,0,0
8504003,Bossière,,0.000021,4,1,2,3,9013,9013,18026,32,0.06698,0.079786,114,0,0
8504001,"Gletterens, Fin de Gros-Bois",,0.000011,126,0,2,2,0,7513,7513,33,0.078102,0.094422,0,0,0
8504531,"Belfaux, Laiterie",,0.000016,126,1,2,3,3186,6953,10139,33,0.080479,0.099696,255.869048,0,0
8504005,"Granges-de-Vesin, village",,0.000011,13,0,4,4,0,1852,1852,19,0.130602,0.200687,0,0,0
8504153,"Combremont-le-Petit, poste",,0.000018,13,1,2,3,5260,5260,10520,36,0.070746,0.092636,121.666667,0,0
8504718,"Aumont, village",,0.000021,13,2,2,4,2183,5370,7553,19,0.128499,0.181222,176,0,0
8504721,Frasses,,0.000022,13,2,1,3,6265,7058,13323,19,0.127389,0.173034,0,0,0
8504723,"Montet (Broye), village",,0.000041,13,3,2,5,7803,6701,14504,18,0.144526,0.214954,449.333333,0,0
8504010,La Conversion,,0.000032,4,2,1,3,19175,19275,38450,33,0.062748,0.072651,126,0,0
8504013,Chexbres-Village,,0.00004,4,1,1,2,9114,9114,18228,2,0.666667,0.75,250,0,0
8504014,Palézieux,,0.000073,4,4,4,8,38216,46111,84327,30,0.077118,0.098641,21016,0,0
8504021,Vauderens,,0.000033,4,1,1,2,2837,2837,5674,30,0.076721,0.096564,2540,0,0
8504015,Vevey-Funi,,0.000045,4,1,1,2,9114,9114,18228,1,1,1,126,0,0
8504016,Palézieux-Village,,0.000026,4,1,1,2,17934,17934,35868,36,0.051817,0.056215,1410,0,0
8504017,Châtillens,,0.000033,4,1,1,2,17934,17934,35868,35,0.054625,0.05969,3598,0,0
8504018,Ecublens-Rue,,0.000039,4,1,1,2,17934,17934,35868,34,0.057757,0.063699,5784,0,0
8504020,Oron,,0.000026,4,1,1,2,2837,2837,5674,31,0.07128,0.086154,141,0,0
8504066,Vuadens-Sud,,0.000058,4,1,1,2,15323,15030,30353,30,0.075938,0.09359,15186,0,0
8504079,La Tour-de-Trême Ronclina,,0.000065,11,1,1,2,4312,4312,8624,30,0.075938,0.09359,83124.5,0,0
8504084,Vaulruz-Nord,,0.00002,11,1,1,2,1475,728,2203,30,0.075938,0.09359,0,0,0
8504024,Villaz-St-Pierre,,0.00002,11,1,1,2,15377,15377,30754,35,0.05513,0.061289,864,0,0
8504025,Chénens,,0.000028,11,1,1,2,15377,15377,30754,34,0.058324,0.065588,3255,0,0
8504026,Cottens FR,,0.000035,11,1,1,2,15377,15377,30754,33,0.061912,0.070639,5644,0,0
8504027,Neyruz FR,,0.00004,11,1,1,2,15377,15377,30754,32,0.065972,0.076688,8031,0,0
8504028,Rosé,,0.000045,11,1,1,2,15377,15377,30754,31,0.070604,0.084121,10416,0,0
8504029,Matran,,0.000049,11,1,1,2,15377,15377,30754,30,0.075938,0.09359,12799,0,0
8504041,"Gumefens, village",,0.000012,126,1,1,2,335,335,670,37,0.068074,0.086103,1,0,0
8504043,"Chandossel, village",,0.000011,13,0,2,2,0,1974,1974,32,0.074463,0.092788,0,0,0
8504049,"Villarepos, Fin de Plan",,0.000016,13,1,1,2,987,987,1974,32,0.07439,0.091825,0,0,0
8504044,"Corjolens, village",,0.000019,126,2,1,3,687,707,1394,49,0.052963,0.073897,222.666667,0,0
8504045,"Corjolens, Champ Thomas",,0.000027,126,1,1,2,707,707,1414,48,0.055897,0.082061,2201.666667,0,0
8504639,"Noréaz, Le Haut",,0.000034,126,2,2,4,5406,5418,10824,48,0.055911,0.082704,4185.166667,0,0
8504267,"Vuippens, village",,0.000049,126,5,6,11,18639,19258,37897,35,0.078684,0.111584,4503.531277,0,0
8504060,Bossonnens,,0.000026,4,1,1,2,15068,15323,30391,35,0.055147,0.061364,846,0,0
8504061,Remaufens,,0.000033,4,1,1,2,15323,15323,30646,34,0.058343,0.065693,3241,0,0
8504062,Châtel-St-Denis,,0.000039,4,1,1,2,15323,15068,30391,33,0.061933,0.070808,5634,0,0
8504063,Semsales,,0.000044,4,1,2,3,15068,15323,30391,32,0.065996,0.077053,8025,0,0
8504064,La Verrerie,,0.00003,4,1,1,2,11235,11935,23170,32,0.065972,0.076688,0,0,0
8504065,Vaulruz-Sud,,0.000055,4,2,1,3,16023,15323,31346,31,0.070604,0.084121,12801,0,0
8504071,Lessoc,,0.000048,11,1,1,2,4312,4312,8624,37,0.049692,0.054329,66464.5,0,0
8504072,Albeuve,,0.000052,11,1,1,2,4312,4312,8624,36,0.052269,0.057576,68850.5,0,0
8504073,Neirivue,,0.000055,11,1,1,2,4312,4312,8624,35,0.05513,0.061289,71234.5,0,0
8504074,Villars-sous-Mont,,0.000058,11,1,1,2,4312,4301,8613,34,0.058324,0.065588,73616.5,0,0
8504075,Enney,,0.00006,11,1,1,2,4301,4312,8613,33,0.061912,0.070639,75996.5,0,0
8504077,Gruyères,,0.000062,11,1,1,2,4312,4312,8624,32,0.065972,0.076688,78374.5,0,0
8504078,Le Pâquier-Montbarry,,0.000063,11,1,1,2,4312,4312,8624,31,0.070604,0.084121,80750.5,0,0
8504091,"Romont FR, Electroverre",,0.000023,126,3,2,5,9138,12919,22057,46,0.056835,0.080907,2489.509524,0,0
8504092,"Lussy FR, bif.",,0.000021,126,1,1,2,6180,6180,12360,45,0.060145,0.089981,4481.509524,0,0
8504096,"Villargiroud, bif.",,0.000029,126,1,2,3,6739,6739,13478,45,0.060173,0.090434,2014,0,0
8504097,"Villarlod, poste",,0.000023,126,1,1,2,6573,6573,13146,45,0.060145,0.089981,0,0,0
8504093,"Billens, village",,0.000011,13,0,6,6,0,7155,7155,46,0.056332,0.090264,0,0,0
8504154,"Vers-chez-Perrin, bif.",,0.000012,13,1,2,3,1840,2682,4522,46,0.055287,0.076652,185.455195,0,0
8504155,"Villars-Bramard, village",,0.000018,13,2,3,5,2324,3427,5751,45,0.057064,0.082255,1641.215152,0,0
8504158,"Vers-chez-Perrin, Etrabloz",,0.000021,13,2,2,4,2682,2682,5364,46,0.057202,0.082485,1718.876415,0,0
8504697,"Prez-vers-Siviriez, village",,0.000031,13,1,1,2,1898,1898,3796,22,0.108583,0.134715,1117.820455,0,0
8504891,"Porsel, village",,0.000031,13,2,4,6,5648,5670,11318,21,0.119461,0.152698,854.154654,0,0
8504894,"Chavannes-sous-Ors, centre",,0.000051,126,3,3,6,6857,6739,13596,23,0.133558,0.170343,9599.860173,0,0
8504944,"Posieux, Froideville",,0.000058,13,4,5,9,22100,22104,44204,17,0.165753,0.211234,9633.95303,0,0
8504969,Le Châtelard-d'en-Haut,,0.000019,13,1,3,4,5896,5896,11792,20,0.126247,0.161047,183.583333,0,0
8504977,"Esmonts, bif.",,0.000028,13,1,4,5,15258,15258,30516,22,0.109551,0.142254,614.75,0,0
8504978,"Promasens, église",,0.000026,13,2,2,4,11021,11020,22041,21,0.117902,0.147529,499.537057,0,0
8504979,"Gillarens, village",,0.000018,13,1,1,2,335,335,670,22,0.108583,0.134715,0,0,0
8504996,"Mossel, village",,0.000017,13,1,1,2,335,335,670,22,0.108583,0.134715,0,0,0
8506090,"Romont FR, La Maula haut",,0.000027,13,1,1,2,164,164,328,22,0.108583,0.134715,1000,0,0
8504935,"Romont FR, CO de la Glâne",,0.000034,13,2,3,5,13608,13608,27216,19,0.134189,0.172158,2656.546032,0,0
8504981,"Sédeilles, village",,0.000067,13,3,7,10,10721,11404,22125,43,0.0618,0.111018,25345.440546,0,0
8504998,"Rossens VD, village",,0.000019,13,1,3,4,4380,4380,8760,43,0.061454,0.106512,32,0,0
8507596,"Vuadens, Les Kâ",,0.000064,13,3,4,7,38845,38845,77690,18,0.148115,0.189795,5586.141089,0,0
8509430,"Romont FR, Epicentre",,0.000144,13,11,4,15,6901,6623,13524,21,0.121585,0.163626,14619.320346,0,0
8557079,"Lucens, Pré au Loup",,0.000049,13,2,2,4,3981,4282,8263,21,0.109673,0.143768,1072.026321,0,0
8570393,"Moudon, gare",,0.000199,13,8,5,13,14088,13954,28042,21,0.114059,0.156237,122882.614386,0,0
8570449,"Oron-le-Châtel, poste",,0.000045,13,3,3,6,5464,6212,11676,18,0.145957,0.18523,19248.381072,0,0
8570457,"La Verrerie, gare",,0.000073,13,1,2,3,7169,7302,14471,19,0.132474,0.166158,3402.928571,0,0
8570463,"Romont FR, Belle-Croix",,0.00002,13,1,1,2,14062,14063,28125,21,0.109375,0.140283,483,0,0
8570465,"Romont FR, gare",,0.000245,13,16,16,32,69105,72304,141409,20,0.122553,0.179229,139866.392968,0,0
8504095,"Villargiroud, village",,0.000021,126,1,1,2,6739,6739,13478,46,0.056784,0.080324,10,0,0
8504281,"Villars-sur-Glâne, Daillettes",,0.000029,126,3,3,6,9490,11040,20530,39,0.05936,0.071582,60.833333,0,0
8504641,"Onnens FR, église",,0.000053,126,3,4,7,7961,8123,16084,47,0.059177,0.093628,14420.753968,0,0
8504771,"Prez-vers-Noréaz, croisée",,0.000029,13,2,2,4,1274,5251,6525,46,0.062178,0.09782,17029.413997,0,0
8504634,"Villars-sur-Glâne, Le Moléson",,0.000072,126,1,2,3,22104,22104,44208,35,0.077387,0.104002,9618,0,0
8504792,"Estavayer-le-Gibloux, village",,0.000028,13,1,2,3,2242,2242,4484,36,0.073186,0.097668,2748,0,0
8504855,"Farvagny-le-Grand, centre",,0.000067,126,4,4,8,23273,23148,46421,35,0.078854,0.111339,5977.413203,0,0
8504857,"Grangeneuve FR, Inst. Agricole",,0.000056,126,2,3,5,18625,18750,37375,34,0.083471,0.118966,10592.533077,0,0
8504754,"Villarzel, village",,0.000023,13,2,2,4,3427,3672,7099,44,0.059308,0.088978,4918.831679,0,0
8504980,"Châtonnaye, poste",,0.000047,13,3,1,4,7838,8415,16253,44,0.058249,0.093896,12581.25,0,0
8504866,"Orsonnens, village",,0.000047,126,3,3,6,6851,6739,13590,34,0.083883,0.121377,8442.252734,0,0
8504102,Schmitten FR,,0.000018,11,1,2,3,18965,19560,38525,28,0.084863,0.106355,0,0,0
8504126,Avenches,,0.000057,11,2,3,5,13128,14561,27689,31,0.069685,0.081047,7122,0,0
8504127,Faoug,,0.000027,11,1,1,2,12416,12416,24832,31,0.069626,0.07994,0,0,0
8504128,Murten/Morat,,0.000071,11,3,3,6,27645,37603,65248,30,0.074804,0.088495,10144.25,0,0
8504140,Muntelier-Löwenberg,,0.000064,11,3,3,6,29212,28987,58199,29,0.078151,0.09356,17534.25,0,0
8516161,Bern Wankdorf,,0.000247,11,9,1,10,92320,19098,111418,1,1,1,61.5,0,0
8504104,Thörishaus Station,,0.000021,11,1,1,2,19747,19776,39523,31,0.067637,0.077415,0,0,0
8504105,Niederwangen,,0.000038,11,2,1,3,38121,37056,75177,30,0.072492,0.084581,2987,0,0
8504106,Bern Bümpliz Süd,,0.000043,11,1,1,2,37056,37056,74112,29,0.078102,0.093589,4070,0,0
8504108,Bern Europaplatz,,0.000048,11,1,2,3,37056,35963,73019,28,0.084659,0.10558,5151,0,0
8504113,Wünnewil,,0.000031,11,1,1,2,18488,19030,37518,28,0.084603,0.104941,0,0,0
8504116,"Hattenhausen, Golfpanorama",,0.000029,65,2,1,3,4799,4801,9600,51,0.039899,0.052262,3360,0,0
8505531,"Felben, Ost",,0.000011,65,0,2,2,0,11071,11071,51,0.039953,0.053714,0,0,0
8504120,Moudon,,0.000044,4,1,1,2,17934,17934,35868,33,0.061271,0.068404,7968,0,0
8504121,Lucens,,0.000049,4,1,1,2,17934,17934,35868,32,0.065242,0.074078,10150,0,0
8504122,Granges-Marnand,,0.000052,4,1,3,4,17934,17710,35644,31,0.069765,0.08135,12330,0,0
8504123,Corcelles-Nord,,0.000026,11,1,2,3,10467,11414,21881,32,0.065222,0.074443,306,0,0
8504129,Galmiz,,0.000031,11,1,2,3,20100,20178,40278,30,0.072683,0.085002,2212,0,0
8504133,Cugy FR,,0.000047,11,1,1,2,17729,17729,35458,31,0.069589,0.079906,6954,0,0
8504125,Domdidier,,0.000042,11,1,1,2,11177,12655,23832,32,0.065172,0.073861,2322,0,0
8504124,Dompierre FR,,0.000037,11,2,1,3,11177,11177,22354,33,0.061209,0.068238,148,0,0
8504134,Payerne,,0.000095,11,4,4,8,39316,32368,71684,30,0.074761,0.088564,31092.5,0,0
8504130,Yvonand,,0.000031,11,1,1,2,17256,17729,34985,34,0.057636,0.063298,942,0,0
8504131,Cheyres,,0.000038,11,1,1,2,17729,17729,35458,33,0.061135,0.067863,2948,0,0
8504132,Estavayer-le-Lac,,0.000043,11,1,1,2,17729,17729,35458,32,0.065087,0.073281,4952,0,0
8504139,Belfaux CFF,,0.000051,11,1,1,2,17257,17257,34514,32,0.069384,0.079506,9240,0,0
8504135,Corcelles-Sud,,0.000031,11,1,1,2,17257,17257,34514,36,0.054392,0.059226,1328,0,0
8504136,Cousset,,0.000037,11,1,1,2,17257,17257,34514,35,0.057496,0.063119,3309,0,0
8504137,Léchelles,,0.000043,11,1,1,2,17257,17257,34514,34,0.060977,0.067645,5288,0,0
8504138,Grolley,,0.000047,11,1,1,2,17257,17257,34514,33,0.064908,0.073,7265,0,0
8504141,Henniez,,0.000049,11,2,1,3,10765,9966,20731,29,0.078623,0.095327,9635,0,0
8504314,La Chaux-de-Fonds,,0.00025,11,7,5,12,55864,60318,116182,29,0.084425,0.113445,126180.577135,0,0
8504150,"Ménières, village",,0.000011,13,0,1,1,0,4077,4077,38,0.06423,0.080704,0,0,0
8505816,"Villeneuve FR, grande salle",,0.000014,13,1,3,4,371,1109,1480,43,0.052736,0.080519,0,0,0
8507969,"Villars-Epeney, Fontaine",,0.000038,35,1,2,3,2786,2786,5572,42,0.053122,0.082609,1138.566667,0,0
8509344,"Cugy FR, CO",,0.000018,13,2,2,4,248,210,458,43,0.052694,0.07975,0,0,0
8557077,"Granges-près-Marnand,Le Canard",,0.00006,13,7,4,11,3108,3134,6242,42,0.054304,0.086841,24628.905556,0,0
8557139,"Marnand, village",,0.000053,13,2,1,3,2085,2085,4170,29,0.066651,0.083096,905,0,0
8570313,"Démoret, bas du village",,0.000048,35,3,5,8,4129,3692,7821,38,0.054587,0.082829,29143.53993,0,0
8570321,"Cuarny, église",,0.000025,35,2,4,6,2390,2786,5176,29,0.068906,0.095881,7326.455952,0,0
8504699,"Billens, Les Mottes",,0.000026,13,3,3,6,6322,6322,12644,45,0.057644,0.085491,1717.779459,0,0
8504156,"Rueyres-les-Prés, anc. poste",,0.000011,13,0,2,2,0,4909,4909,18,0.144377,0.217055,0,0,0
8504902,"Vesin, village",,0.00002,13,1,4,5,5417,5370,10787,18,0.143279,0.222823,57.5,0,0
8506913,"Aumont, école",,0.000024,13,2,2,4,1856,1852,3708,18,0.140741,0.206461,30.5,0,0
8510081,"Châtillon FR, Tilleul",,0.000037,13,1,1,2,616,686,1302,18,0.140325,0.199444,380,0,0
8570383,"Cheiry, village",,0.000015,13,1,2,3,2065,2065,4130,17,0.151757,0.219711,42.5,0,0
8570390,La Gaité (Champtauroz),,0.000063,13,1,3,4,5799,5799,11598,18,0.144949,0.221688,7577.828571,0,0
8570410,"Rueyres-les-Prés, village",,0.000043,13,3,3,6,9261,9261,18522,18,0.150855,0.227794,1106.1,0,0
8577610,"Châbles FR, Pales",,0.00002,13,1,1,2,4735,4735,9470,18,0.140325,0.199444,95,0,0
8577612,"Estavayer-le-Lac, gare",,0.000132,13,9,6,15,25979,27745,53724,17,0.161512,0.268705,9967.095238,0,0
8577616,"Vuissens, école",,0.000042,13,1,2,3,4214,4214,8428,12,0.205357,0.326227,46,0,0
8504162,"Syens, Champ-du-Chêne",,0.000011,13,0,1,1,0,665,665,31,0.059714,0.06612,0,0,0
8504163,"Vucherens, village",,0.00002,13,1,1,2,665,1438,2103,30,0.063458,0.071047,1321,0,0
8504164,"Vulliens, Praz-Botsard",,0.000028,13,1,1,2,1438,1438,2876,29,0.067706,0.076985,2640,0,0
8504165,"Carrouge VD, centre",,0.000035,13,1,1,2,1438,2039,3477,28,0.072568,0.084422,3957,0,0
8504166,"Mézières VD, station",,0.00004,13,1,3,4,2039,8643,10682,27,0.078187,0.09457,5272,0,0
8504169,"Les Cullayes, village",,0.000022,13,1,2,3,5811,6265,12076,28,0.075925,0.090914,5,0,0
8504171,"Lausanne, En Marin",,0.000032,13,2,4,6,3223,22269,25492,27,0.082091,0.102772,5194.421745,0,0
8504173,"Savigny, centre",,0.000034,13,1,1,2,5690,5690,11380,27,0.074023,0.086429,917,0,0
8570353,"Thierrens, Prouty",,0.000079,35,1,3,4,5972,5904,11876,22,0.094754,0.125417,62300.34591,0,0
8570425,"Carrouge VD, Croix d'Or",,0.00005,13,2,3,5,5104,4818,9922,21,0.105885,0.139207,7123.156827,0,0
8579238,"Lausanne, Sallaz",,0.000044,10,3,3,6,46586,137544,184130,20,0.115352,0.151664,9268.582295,0,0
8504172,"Savigny, Claie-aux-Moines",,0.000027,13,2,1,3,6265,5690,11955,28,0.068991,0.078651,7,0,0
8504176,"Lausanne, Tunnel",,0.000016,10,1,7,8,28921,216878,245799,31,0.073495,0.110601,1201.5,0,0
8579235,"Le Mont-sur-Lausanne, Coppoz",,0.000016,10,1,2,3,35593,35588,71181,17,0.142123,0.182285,315.075397,0,0
8579253,"Lausanne, Montbenon",,0.000011,10,0,1,1,0,70286,70286,17,0.132641,0.163542,0,0,0
8573634,"Cugy VD, village",,0.000056,10,2,2,4,26286,26288,52574,18,0.131974,0.166971,9113.131651,0,0
8579254,"Lausanne, St-François",,0.000029,10,3,8,11,104471,196777,301248,16,0.152464,0.206975,899.666667,0,0
8588431,"Lausanne, Béthusy",,0.000024,10,2,2,4,98003,98002,196005,18,0.12749,0.161814,28673.072118,0,0
8588434,"Pully, Rosiaz",,0.000035,10,2,2,4,79419,103055,182474,16,0.143631,0.180793,28144.368882,0,0
8588445,"Pully, gare",,0.000072,10,5,6,11,136115,151892,288007,15,0.155316,0.203577,35200.654729,0,0
8587357,"Lausanne, Bellevaux",,0.000047,10,4,4,8,89100,136180,225280,17,0.146991,0.2004,8162.410984,0,0
8587853,"Le Mont-s.-Laus., Petit-Mont",,0.000021,10,1,4,5,35589,35591,71180,16,0.157765,0.214032,5215.736097,0,0
8589522,"Lausanne, place du Nord",,0.000048,10,4,4,8,133961,133781,267742,14,0.175573,0.226183,15643.132857,0,0
8589523,"Lausanne, Bessières",,0.000021,10,1,2,3,34566,34573,69139,14,0.175319,0.219849,789.924064,0,0
8590442,"Lausanne, Riponne-M. Béjart",,0.000046,10,5,9,14,195864,229892,425756,14,0.197115,0.268169,8174.077872,0,0
8592021,"Lausanne, Cottages",,0.000024,10,1,2,3,28977,28936,57913,15,0.133464,0.174826,407.013636,0,0
8592047,"Lausanne, Forêt",,0.000066,10,7,5,12,118342,144763,263105,13,0.185874,0.261866,3608.679746,0,0
8592051,"Lausanne, Georgette",,0.000101,10,6,7,13,165095,145082,310177,14,0.168067,0.244581,7738.38343,0,0
8504177,"Le Mont-s.-Laus., Grand-Mont",,0.000013,10,1,2,3,42758,61882,104640,30,0.071863,0.091631,1759.822574,0,0
8504178,"Cugy VD, poste",,0.000016,10,1,2,3,26289,26288,52577,29,0.073009,0.086506,2761.747177,0,0
8504180,"Gammen, Schulhaus",,0.000011,126,0,1,1,0,3833,3833,17,0.086199,0.099214,0,0,0
8504182,Belfaux-Village,,0.000054,11,1,1,2,15189,17736,32925,33,0.060683,0.066755,1700,0,0
8504183,Pensier,,0.000057,11,1,1,2,17736,17741,35477,32,0.064575,0.071837,3647,0,0
8504184,Courtepin,,0.000059,11,1,1,2,17741,17506,35247,31,0.069003,0.077891,5592,0,0
8504185,Cressier FR,,0.000061,11,1,1,2,17506,17506,35012,30,0.074085,0.085276,7535,0,0
8504186,Münchenwiler-Courgevaux,,0.000063,11,1,1,2,17506,17083,34589,29,0.079978,0.094601,9476,0,0
8504188,Sugiez,,0.000064,11,1,2,3,17083,17077,34160,28,0.086892,0.107099,11415,0,0
8504220,Neuchâtel-Serrières,,0.000084,11,1,1,2,23607,23607,47214,30,0.079906,0.09549,29790,0,0
8504400,Kerzers,,0.000131,11,4,4,8,40172,47727,87899,28,0.085272,0.108596,103552.749584,0,0
8504468,Ins Dorf,,0.000035,11,1,2,3,15100,14699,29799,28,0.084978,0.106566,9820,0,0
8504475,Gerolfingen,,0.000067,11,1,1,2,27194,14362,41556,28,0.084723,0.105275,7010,0,0
8504480,St-Blaise-Lac,,0.000057,11,2,2,4,18544,18249,36793,28,0.084829,0.106193,5929.999792,0,0
8504481,Marin-Epagnier,,0.000035,11,1,2,3,18001,18301,36302,28,0.084779,0.105913,421,0,0
8504482,Gampelen,,0.000026,11,1,1,2,10026,9756,19782,28,0.084723,0.105275,0,0,0
8504189,Laupenau,,0.00002,126,1,1,2,3833,3833,7666,16,0.0938,0.107782,177,0,0
8504191,Flamatt Dorf,,0.000036,11,2,1,3,18584,18605,37189,29,0.07791,0.092886,648,0,0
8504192,Neuenegg,,0.000041,11,1,1,2,18605,18065,36670,28,0.084433,0.104322,1719,0,0
8504197,"Kriechenwil, Schulhaus",,0.000028,126,1,1,2,3833,3833,7666,15,0.102924,0.118579,352,0,0
8504198,"Kriechenwil, Oberdorf",,0.000035,126,1,1,2,3833,3833,7666,14,0.114081,0.13275,525,0,0
8504199,"Laupen BE, Betagtenzentrum",,0.00004,126,1,1,2,3833,3833,7666,13,0.128035,0.152642,696,0,0
8570554,"Bösingen, Abzw. Tuftera",,0.000046,126,2,1,3,5234,5233,10467,13,0.128035,0.152642,1045,0,0
8504203,Concise,,0.000029,4,1,1,2,2952,2952,5904,37,0.051368,0.055407,4677,0,0
8504204,Vaumarcus,,0.000036,4,1,1,2,2952,2910,5862,36,0.054126,0.058723,6624,0,0
8504205,Gorgier-St-Aubin,,0.000041,11,1,1,2,2910,9475,12385,35,0.057199,0.062511,8569,0,0
8504206,Bevaix,,0.000046,11,1,1,2,9475,9280,18755,34,0.060642,0.066892,10512,0,0
8504208,Boudry,,0.00005,11,1,1,2,9280,9475,18755,33,0.064529,0.072034,12453,0,0
8504209,Colombier NE,,0.000053,11,1,1,2,9475,9449,18924,32,0.06895,0.078188,14392,0,0
8504218,Bôle,,0.000034,11,1,1,2,14266,14266,28532,32,0.06895,0.078188,9255,0,0
8504217,Champ-du-Moulin,,0.000028,11,1,1,2,14266,14266,28532,33,0.064529,0.072034,6975,0,0
8504219,Auvernier,,0.000085,11,2,1,3,23715,23607,47322,31,0.074024,0.085758,27862,0,0
8504232,Corcelles-Peseux,,0.000035,11,1,1,2,32914,454,33368,33,0.065924,0.075162,2037,0,0
8504222,St-Blaise CFF,,0.000029,11,1,1,2,13916,13916,27832,36,0.053621,0.058501,2548,0,0
8504223,Cornaux NE,,0.000035,11,1,1,2,13916,13916,27832,35,0.056629,0.062216,4074,0,0
8504224,Cressier NE,,0.000041,11,1,1,2,13916,13916,27832,34,0.059997,0.0665,5598,0,0
8504225,Le Landeron,,0.000046,11,1,1,2,13916,13600,27516,33,0.063792,0.071509,7120,0,0
8504226,La Neuveville,,0.00005,11,1,1,2,13600,13600,27200,32,0.068103,0.077468,8640,0,0
8504227,Ligerz,,0.000053,11,1,1,2,13600,13600,27200,31,0.073041,0.084718,10158,0,0
8504228,Twann,,0.000056,11,1,1,2,13600,13600,27200,30,0.078755,0.09383,11674,0,0
8504231,Les Deurres,,0.000029,11,1,1,2,32914,32914,65828,34,0.061876,0.069511,364,0,0
8504234,Chambrelien,,0.000059,11,2,1,3,28403,28488,56891,32,0.070543,0.082018,154511.256519,0,0
8504236,Les Geneveys-sur-Coffrane,,0.000061,11,1,1,2,28488,28488,56976,31,0.075859,0.090611,156180.256519,0,0
8504261,"Neuchâtel, Place Pury",,0.000089,48,7,15,22,79533,271231,350764,15,0.180787,0.23973,95986.760208,0,0
8504739,"La Chaux-de-Fonds, bif. Bul-Va",,0.000036,134,2,2,4,3395,3395,6790,21,0.15059,0.215333,651,0,0
8504744,"Les Joux-Derrière,anc.collège",,0.000026,134,1,2,3,3140,3395,6535,21,0.150838,0.215933,32,0,0
8504251,"Fontainemelon, centre",,0.000022,48,1,2,3,16831,16830,33661,20,0.13072,0.155177,119431.346355,0,0
8504255,"Dombresson, collège",,0.000015,48,1,1,2,16795,16656,33451,20,0.12944,0.150303,53,0,0
8504252,"Cernier, centre",,0.00002,48,1,5,6,16801,46250,63051,19,0.135086,0.16448,18087.694048,0,0
8579604,Landeyeux,,0.000029,48,1,2,3,9131,9134,18265,17,0.107303,0.128948,263,0,0
8579605,Jonchère,,0.000026,48,2,2,4,12079,12022,24101,17,0.107303,0.128948,8630,0,0
8579606,Les Bassins,,0.000037,48,3,2,5,11110,11118,22228,16,0.116,0.137001,4176.583333,0,0
8579607,Le Pavé,,0.000042,48,4,3,7,11554,11554,23108,16,0.119287,0.147198,9727.216667,0,0
8579609,Bois du Pâquier,,0.000044,48,1,2,3,21156,14930,36086,14,0.135,0.169892,4089.5,0,0
8504257,Le District,,0.000024,48,2,2,4,21244,21194,42438,18,0.137196,0.161311,23615.135714,0,0
8504259,La Cure,,0.00002,48,1,1,2,12039,12037,24076,18,0.136827,0.159316,64,0,0
8504741,"Corcelles NE, haut du village",,0.000023,48,2,1,3,6947,6947,13894,17,0.119949,0.14188,774,0,0
8571795,"Chambrelien, gare",,0.000029,48,1,2,3,13252,13252,26504,17,0.12414,0.157006,358.6,0,0
8571797,Carrefour,,0.000029,48,1,3,4,2929,2928,5857,16,0.140796,0.182328,1155.488095,0,0
8571799,L'Erable,,0.000032,48,1,2,3,2512,2512,5024,16,0.168975,0.221061,3452.065476,0,0
8579624,Terreaux Muséum,,0.000023,48,1,3,4,147039,148244,295283,16,0.169089,0.225769,10488.966667,0,0
8504285,Couvet,,0.000035,11,1,1,2,14266,14266,28532,20,0.085583,0.097322,36715.863095,0,0
8504740,"La Chaux-du-Milieu, village",,0.000034,48,1,4,5,6918,10225,17143,17,0.129114,0.161988,18488.915909,0,0
8504746,"Peseux, temple",,0.000032,48,2,4,6,59582,59354,118936,16,0.140582,0.172248,10301.791593,0,0
8557069,"Fresens, village centre",,0.000021,35,1,2,3,575,1199,1774,19,0.112072,0.138911,2183.333333,0,0
8557080,"St-Aubin NE, Petites Vignes",,0.00002,35,1,3,4,1132,1132,2264,19,0.114644,0.14779,83,0,0
8570274,"Champagne, Le Moulin",,0.000037,35,1,2,3,8847,8847,17694,19,0.115036,0.146059,5026.533333,0,0
8570285,"Provence, La Grangette",,0.000039,35,3,2,5,2333,2333,4666,19,0.114373,0.145511,4190.333333,0,0
8570287,"Provence, village",,0.000033,35,2,3,5,2316,2316,4632,19,0.117001,0.158469,891,0,0
8504753,"Lignières, cimetière",,0.000011,117,0,3,3,0,2205,2205,19,0.142241,0.195332,0,0,0
8504763,"Nods, école",,0.000023,117,2,5,7,5375,5375,10750,19,0.142857,0.204654,331.5,0,0
8571526,"Gals, Neuhaus",,0.000044,117,3,3,6,6295,5781,12076,19,0.139476,0.189902,26491.133333,0,0
8571848,Ecluse,,0.000029,48,1,3,4,59503,59500,119003,16,0.15003,0.189861,14836.316667,0,0
8571896,"La Neuveville, poste",,0.000035,117,4,4,8,4672,5276,9948,18,0.15509,0.212251,37916.133333,0,0
8579592,"Fleurier, gare",,0.000133,49,4,6,10,18994,19533,38527,19,0.096468,0.140351,20855,0,0
8579602,"Valangin, centre",,0.000035,48,2,3,5,21130,21193,42323,18,0.098493,0.122513,10282,0,0
8571910,"St-Blaise, centre",,0.000032,48,3,2,5,72584,72275,144859,17,0.163934,0.2224,33554.233333,0,0
8579611,Grand-Chézard,,0.000052,48,1,3,4,23091,23075,46166,13,0.162195,0.205753,3840.166667,0,0
8579623,St-Honoré,,0.000044,48,3,3,6,169985,171113,341098,17,0.159653,0.218506,27626.2,0,0
8593557,Couviers,,0.000066,48,1,4,5,72520,72529,145049,9,0.202346,0.270945,5826.833333,0,0
8593586,Croix-du-Marché,,0.000061,48,1,2,3,52585,52403,104988,16,0.108883,0.196072,5788.5,0,0
8504262,"Rueyres-St-Laurent, village",,0.000011,13,0,1,1,0,2242,2242,38,0.063926,0.078801,0,0,0
8504263,"Lovatens, Prassy",,0.000011,13,0,1,1,0,2263,2263,43,0.046052,0.058519,0,0,0
8504265,"Villaraboud, école",,0.000016,13,1,1,2,1898,1898,3796,24,0.089494,0.103569,31.820455,0,0
8504266,"Villaraboud, bif.",,0.000024,13,1,1,2,1898,1898,3796,23,0.09811,0.116575,575.820455,0,0
8504521,"Magnedens, bif. Bulle",,0.000019,126,1,1,2,1671,1671,3342,40,0.055966,0.065047,0.833333,0,0
8504546,"Rossens FR, village",,0.000032,126,3,1,4,15803,16036,31839,40,0.055966,0.065047,3.833333,0,0
8504816,"Villaz-st-Pierre, Le Vivier",,0.000033,126,1,1,2,5896,5896,11792,35,0.077778,0.105726,2728,0,0
8504270,"Ste-Croix, Ma Retraite",,0.000011,35,0,1,1,0,6483,6483,24,0.085861,0.10747,0,0,0
8504271,"Ste-Croix, Crêt-Junod",,0.00002,35,1,1,2,6483,6483,12966,23,0.093458,0.120221,200,0,0
8504272,"Bullet, village",,0.000028,35,1,2,3,6483,7262,13745,22,0.102577,0.13941,398,0,0
8504274,"Bullet, Les Cluds",,0.000021,35,1,2,3,2021,2096,4117,22,0.101809,0.136595,14.5,0,0
8504277,"Mauborget, bif. La Magnenaz",,0.000036,35,1,2,3,1008,992,2000,20,0.124125,0.175158,461,0,0
8504273,"Bullet, bif. Les Cluds",,0.000023,35,1,2,3,2211,2136,4347,22,0.10102,0.132797,9,0,0
8504275,"Bullet, bif. Granges Champod",,0.000029,35,2,1,3,1008,1008,2016,21,0.110922,0.145366,271,0,0
8504299,"Les Rasses, village",,0.000051,35,1,5,6,6483,6483,12966,20,0.125081,0.190617,898,0,0
8570268,"Villars-Burquin, Bassugnet",,0.000043,35,1,3,4,890,890,1780,20,0.129164,0.195594,991.833333,0,0
8504279,"Vuarmarens, village",,0.000011,13,0,1,1,0,5267,5267,24,0.084611,0.094589,0,0,0
8504789,"Palézieux-Village, centre",,0.000016,13,1,6,7,19320,19597,38917,25,0.095043,0.124683,2248.365188,0,0
8504609,"Ecuvillens, La Tuffière",,0.000061,126,3,1,4,19390,19390,38780,39,0.059241,0.069923,2767.333333,0,0
8504282,"Bourguillon, La Tour",,0.000011,126,0,3,3,0,16147,16147,35,0.071273,0.090498,0,0,0
8504535,"Düdingen, Jetschwil",,0.000014,126,1,3,4,5418,10358,15776,34,0.076639,0.101326,1758,0,0
8504603,"Brünisried, Dorf",,0.000014,126,1,1,2,10548,10548,21096,37,0.064025,0.077811,0,0,0
8504283,"St. Silvester, Dorf",,0.000011,126,0,3,3,0,7532,7532,34,0.074828,0.098004,0,0,0
8504630,"Marly, Préalpes",,0.000011,126,0,1,1,0,12058,12058,34,0.072169,0.089032,0,0,0
8504644,"Tentlingen, Dorf",,0.000023,126,2,2,4,12828,12633,25461,33,0.077737,0.100275,2145.9,0,0
8504854,"Eichholz, alte Post",,0.000021,126,1,2,3,11558,12056,23614,32,0.080974,0.104242,2196.233333,0,0
8504856,"Giffers, Dorf",,0.000033,126,3,5,8,19064,18642,37706,33,0.080727,0.11164,3147.681813,0,0
8510083,"St. Silvester, Plenefy",,0.000025,126,1,2,3,1134,1134,2268,5,0.333333,0.456667,10,0,0
8577874,"Tentlingen, Dürrenberg",,0.000035,126,3,2,5,12809,12133,24942,5,0.36,0.485185,5020,0,0
8577878,"Oberschrot, Ried",,0.000051,126,1,1,2,12056,498,12554,5,0.333333,0.456667,15,0,0
8504284,La Presta Mines d'asphalte,,0.000029,11,1,1,2,14171,14266,28437,21,0.079041,0.088998,36724.863095,0,0
8504286,Môtiers NE,,0.000046,11,2,2,4,14295,14295,28590,19,0.09333,0.108698,36784.863095,0,0
8504287,Fleurier,,0.00003,11,1,1,2,14266,16252,30518,1,1,1,387,0,0
8504290,"Ste-Croix, Les Replans",,0.000047,35,3,1,4,6478,6483,12961,21,0.111687,0.152044,712,0,0
8504291,La Brinaz,,0.000043,4,1,1,2,13772,13772,27544,7,0.25,0.370408,2387,0,0
8504292,Valeyres-sous-Montagny,,0.000047,4,1,1,2,13772,13772,27544,6,0.285714,0.408333,2052,0,0
8504293,Essert-sous-Champvent,,0.000051,4,1,1,2,13772,13772,27544,5,0.333333,0.456667,1715,0,0
8504294,Vuiteboeuf,,0.000054,4,1,1,2,13772,13772,27544,4,0.4,0.520833,1376,0,0
8504295,Baulmes,,0.000057,4,1,1,2,13772,13772,27544,3,0.5,0.611111,1035,0,0
8504296,Six-Fontaines,,0.000059,4,1,1,2,13772,13772,27544,2,0.666667,0.75,692,0,0
8504298,Ste-Croix,,0.000061,4,1,1,2,13772,11154,24926,1,1,1,347,0,0
8571782,"La Vraconnaz, Noirvaux-Dessus",,0.000043,35,1,1,2,1222,1222,2444,6,0.25641,0.310833,172,0,0
8571784,"L'Auberson, Vers-chez-Gueissaz",,0.000027,35,1,2,3,2922,3795,6717,6,0.25974,0.335833,20,0,0
8570269,"Mauborget, village",,0.000047,35,3,5,8,1819,1051,2870,19,0.138158,0.213603,2393.166667,0,0
8571786,"Ste-Croix, Col-des-Etroits",,0.000067,35,3,2,5,6104,7076,13180,5,0.327586,0.408772,199,0,0
8571787,"Ste-Croix, poste",,0.000068,35,4,1,5,8818,6875,15693,5,0.315789,0.375926,18,0,0
8504301,Frinvillier-Taubenloch,,0.000026,11,1,1,2,9930,9930,19860,35,0.056343,0.063485,0,0,0
8504302,Reuchenette-Péry,,0.000048,11,2,1,3,10180,10180,20360,34,0.059671,0.068133,2035,0,0
8504304,Sonceboz-Sombeval,,0.000083,11,3,2,5,32528,17851,50379,32,0.067673,0.080778,45848.580386,0,0
8504306,Cortébert,,0.00005,11,1,1,2,10585,10585,21170,32,0.0676,0.07997,1657,0,0
8504305,Corgémont,,0.000046,11,1,1,2,10585,10585,21170,33,0.063355,0.073308,378,0,0
8504307,Courtelary,,0.000089,11,2,2,4,17851,17852,35703,31,0.072457,0.08856,49685.580386,0,0
8504309,Villeret,,0.000052,11,1,1,2,10585,10585,21170,31,0.072379,0.08776,1654,0,0
8504308,Cormoret,,0.000049,11,1,1,2,10585,10585,21170,32,0.067532,0.079563,381,0,0
8504311,Sonvilier,,0.00005,11,1,1,2,10335,10335,20670,31,0.072307,0.087362,384,0,0
8504315,Le Crêt-du-Locle,,0.000053,11,1,1,2,41552,41548,83100,4,0.428571,0.513889,0,0,0
8504316,Le Locle,,0.000099,11,2,3,5,41868,32420,74288,3,0.625,0.766667,2095,0,0
8504318,douane,,0.000011,49,0,1,1,0,3875,3875,31,0.076938,0.101129,0,0,0
8504322,"Pontarlier, gare",,0.00002,49,1,2,3,3875,3875,7750,30,0.083146,0.115683,407,0,0
8504399,"Les Bayards, village",,0.000019,49,1,3,4,500,9414,9914,29,0.090403,0.1347,806,0,0
8504325,Colombier NE Littorail,,0.000011,31,0,1,1,0,21443,21443,7,0.244444,0.337229,0,0,0
8504334,"Zweisimmen, Bahnhof Ost",,0.000011,13,0,1,1,0,1952,1952,23,0.079517,0.087581,0,0,0
8504335,"Zweisimmen, Talst. Rinderberg",,0.00002,13,1,1,2,1952,1952,3904,22,0.086174,0.095262,407,0,0
8504336,"Zweisimmen, Zentrum",,0.000028,13,1,1,2,1952,1952,3904,21,0.094069,0.104751,812,0,0
8504337,"Zweisimmen, Spital",,0.000035,13,1,1,2,1952,1952,3904,20,0.103581,0.116918,1215,0,0
8504731,"Boltigen, Eschihalten",,0.000028,13,1,1,2,2346,2346,4692,20,0.103581,0.116918,810,0,0
8504353,Biel/Bienne Magglingenb.(Funi),,0.000011,136,0,2,2,0,6724,6724,1,1,1,0,0,0
8504354,Biel/Bienne Hohfluh,,0.000016,136,1,1,2,2906,2906,5812,1,1,1,0,0,0
8504381,La Chaux-de-Fonds-Grenier,,0.000053,11,1,1,2,8586,8586,17172,7,0.25,0.337619,4180,0,0
8504382,Le Reymond,,0.000056,11,1,1,2,8586,8586,17172,6,0.3,0.392593,3771,0,0
8504383,La Corbatière,,0.000059,11,1,2,3,8586,8964,17550,5,0.380952,0.514583,3360,0,0
8504384,La Sagne-Eglise,,0.000036,11,1,1,2,8775,8775,17550,5,0.35,0.445238,0,0,0
8504385,La Sagne,,0.000066,11,2,2,4,8964,8964,17928,4,0.461538,0.597222,2532,0,0
8504387,Petit-Martel,,0.000044,11,1,1,2,8775,8775,17550,4,0.4,0.520833,4,0,0
8504386,Les Coeudres,,0.000039,11,1,1,2,8775,8775,17550,5,0.333333,0.456667,423,0,0
8504388,Les Ponts-de-Martel,,0.000077,11,2,1,3,8964,8774,17738,3,0.5,0.611111,1275,0,0
8504391,Les Frêtes,,0.000039,11,1,1,2,10139,10139,20278,2,0.666667,0.75,840,0,0
8504392,Les Brenets,,0.000044,11,1,1,2,10139,10139,20278,1,1,1,421,0,0
8504394,"Biaufond, douane",,0.000011,134,0,2,2,0,510,510,23,0.117084,0.149649,0,0,0
8504395,"Les Planchettes, village",,0.000016,134,1,2,3,255,3140,3395,22,0.131928,0.175863,109,0,0
8504649,"Biaufond, La Rasse",,0.000022,134,2,1,3,510,510,1020,22,0.131404,0.172083,109,0,0
8504396,"La Tourne, Col",,0.000019,48,1,1,2,6918,6918,13836,19,0.102956,0.117645,18226.915909,0,0
8504398,"Neuchâtel,Place Pury Littorail",,0.00002,31,1,2,3,21443,21440,42883,6,0.294118,0.423333,10,0,0
8504509,"Neuchâtel, Port-de-Serrières",,0.000019,31,1,1,2,21346,21347,42693,6,0.272727,0.359259,0,0,0
8504736,Le Crêt-sud,,0.000038,49,1,1,2,11052,10767,21819,22,0.077421,0.097361,622,0,0
8504484,Müntschemier,,0.000095,11,1,2,3,12891,12891,25782,28,0.084679,0.105854,796.858333,0,0
8504401,Fräschels,,0.000039,11,1,1,2,9553,9553,19106,31,0.067644,0.077433,1536,0,0
8504402,Kallnach,,0.000044,11,1,1,2,9553,9553,19106,30,0.0725,0.084598,2518,0,0
8504403,Bargen BE,,0.000048,11,1,1,2,9553,9553,19106,29,0.078111,0.093589,3498,0,0
8516444,Kerzers Papiliorama,,0.000035,11,1,1,2,6039,6039,12078,1,1,1,0,0,0
8504415,Busswil BE,,0.000035,11,1,1,2,31530,18962,50492,29,0.07791,0.092886,1064,0,0
8504416,Brügg BE,,0.000041,11,1,1,2,18962,18960,37922,28,0.084433,0.104322,1927,0,0
8504419,Biel Mett,,0.000026,11,1,1,2,19169,19169,38338,2,0.666667,0.75,748,0,0
8504432,"Ollon VD,collège de Perrosalle",,0.00002,103,1,1,2,324,325,649,12,0.135593,0.169786,48,0,0
8504435,"Ollon VD, Vergers",,0.000028,103,1,1,2,325,324,649,11,0.153595,0.191237,94,0,0
8504436,"Ollon VD, cimetière",,0.000035,103,1,1,2,324,325,649,10,0.177606,0.224336,138,0,0
8504663,"Vionnaz, Village",,0.00004,103,3,3,6,6078,6687,12765,21,0.107069,0.180002,415,0,0
8504669,"Torgon, La Lanche",,0.00005,103,1,2,3,1469,1469,2938,10,0.186235,0.253114,230,0,0
8510072,"Villars-sur-Ollon, centre",,0.000056,103,1,1,2,1667,1734,3401,10,0.177606,0.224336,368,0,0
8570585,"Rennaz, village",,0.000064,103,1,2,3,7584,7584,15168,15,0.138675,0.188157,700,0,0
8504453,"Vorimholz, Kaltenbrunnen",,0.000011,44,0,1,1,0,452,452,24,0.098012,0.111272,0,0,0
8504454,"Wiler bei Seedorf, Stücki",,0.000011,44,0,1,1,0,3471,3471,24,0.115189,0.135151,0,0,0
8504717,"Herrenschwanden, Dorf",,0.000011,44,0,3,3,0,14391,14391,24,0.124124,0.152867,0,0,0
8504455,"Vorimholz, Spritzenhaus",,0.00002,44,1,1,2,452,1024,1476,23,0.108519,0.126876,763,0,0
8504457,"Lyss, Lehn",,0.000028,44,1,6,7,1024,1106,2130,22,0.12157,0.150394,1524,0,0
8508718,"Mülchi, Spritzenhaus",,0.000024,87,1,3,4,536,536,1072,25,0.094964,0.109905,764.5,0,0
8508721,"Zuzwil BE, Dorfplatz",,0.000028,87,1,3,4,1550,1550,3100,25,0.094964,0.109492,1520,0,0
8508773,"Messen, Post",,0.000029,87,3,3,6,905,937,1842,25,0.094863,0.108977,17.666667,0,0
8508782,"Ruppoldsried, Dorfplatz",,0.000038,87,4,2,6,1196,1196,2392,24,0.104465,0.120971,2763.019048,0,0
8508796,"Wengi b. Büren, Dorfplatz",,0.000031,87,2,3,5,484,484,968,23,0.116207,0.138161,3530.352381,0,0
8508871,"Ammerzwil BE, Dorf",,0.00002,87,1,1,2,420,420,840,23,0.10689,0.122028,0,0,0
8507994,"Frienisberg, Dorf",,0.000045,44,4,5,9,4888,4888,9776,22,0.132711,0.164383,4246.920635,0,0
8508872,"Grossaffoltern, Post",,0.00004,44,3,1,4,1024,1024,2048,22,0.119524,0.141,2119.871429,0,0
8504460,"Lüscherz, Dorf",,0.000011,117,0,1,1,0,3812,3812,27,0.102343,0.118727,0,0,0
8504701,"Gals, Dorf",,0.00002,117,1,3,4,2834,4439,7273,26,0.116561,0.141781,808,0,0
8504703,"Tschugg, Matte",,0.00002,117,1,1,2,4654,4655,9309,27,0.102343,0.118727,808,0,0
8504461,Nidau,,0.000026,11,1,1,2,27194,27194,54388,35,0.053552,0.059301,4862,0,0
8504462,Lattrigen,,0.000033,11,1,1,2,27194,27194,54388,34,0.056542,0.063226,5902,0,0
8504463,Täuffelen,,0.000039,11,1,2,3,27194,27425,54619,33,0.059888,0.068052,6940,0,0
8504466,Siselen-Finsterhennen,,0.00004,11,1,2,3,15381,15712,31093,30,0.07277,0.085963,7780,0,0
8504464,Hagneck,,0.000027,11,1,1,2,15381,15381,30762,32,0.063606,0.07211,5714,0,0
8504465,Lüscherz,,0.000034,11,1,1,2,15381,15381,30762,31,0.067879,0.078236,6748,0,0
8504467,Brüttelen,,0.000028,11,1,1,2,14961,15100,30061,29,0.078374,0.094271,8792,0,0
8504469,Nidau Beunden,,0.000059,11,3,1,4,26860,27194,54054,33,0.059687,0.0666,1910,0,0
8504470,Ipsach Herdi,,0.000061,11,1,1,2,27194,27194,54388,32,0.06343,0.071552,2934,0,0
8504471,Ipsach,,0.000063,11,1,1,2,27194,27194,54388,31,0.067678,0.077436,3956,0,0
8504472,Sutz,,0.000064,11,1,1,2,27194,27194,54388,30,0.072539,0.084586,4976,0,0
8504474,Mörigen,,0.000066,11,1,1,2,27194,27194,54388,29,0.078157,0.093539,5994,0,0
8504478,"Collombey, St Didier",,0.000049,103,1,1,2,620,620,1240,13,0.123711,0.185733,144,0,0
8504487,Rosshäusern,,0.000045,11,1,2,3,19127,19123,38250,28,0.084589,0.105528,1045.141667,0,0
8504488,Riedbach,,0.00003,11,1,1,2,10105,10104,20209,28,0.084533,0.104888,0,0,0
8504490,Zihlbrücke,,0.000067,11,2,1,3,10026,486,10512,28,0.084433,0.104322,275.858333,0,0
8504496,"Collombey, centre",,0.000053,103,1,1,2,620,620,1240,12,0.135294,0.198764,161,0,0
8504500,"Monthey, Vers le Nant de Choëx",,0.000019,103,1,1,2,2115,2238,4353,20,0.13601,0.174092,160,0,0
8509023,"Bex, Planche-de-Fy",,0.000011,103,0,1,1,0,519,519,11,0.181185,0.227641,0,0,0
8510820,"Bex, Pont-Neuf",,0.000028,103,1,1,2,352,352,704,11,0.181185,0.227641,104,0,0
8570595,"Vouvry, gare",,0.000046,103,2,3,5,5756,5756,11512,10,0.21147,0.28412,653,0,0
8504504,"Choëx, Grand Clos",,0.000045,103,1,1,2,545,545,1090,14,0.122324,0.160078,200,0,0
8504507,"Choëx, Chez Bollut",,0.000049,103,1,1,2,545,545,1090,13,0.135889,0.173973,234,0,0
8504510,Auvernier Littorail,,0.000036,31,2,1,3,21441,21439,42880,5,0.333333,0.420833,24,0,0
8504511,Boudry Littorail,,0.000041,31,1,2,3,21439,21440,42879,4,0.4375,0.559524,28,0,0
8530710,"Neuchâtel, Serrières Ruau",,0.000041,31,1,1,2,21346,21346,42692,4,0.4,0.520833,8,0,0
8504516,"Breil/Brigels, Plaun Rueun",,0.000011,110,0,1,1,0,653,653,11,0.13602,0.170358,0,0,0
8504518,"Trimmis, Cholplatzweg",,0.000011,109,0,1,1,0,3165,3165,17,0.090602,0.099177,0,0,0
8509720,"Untervaz, Dorf",,0.000011,109,0,7,7,0,15194,15194,22,0.116505,0.161475,0,0,0
8570814,"Zizers, Tennishalle",,0.000017,109,2,5,7,13335,14763,28098,22,0.116202,0.1589,430.175,0,0
8571309,"Chur, Stelleweg",,0.000033,109,1,2,3,15308,22455,37763,22,0.108128,0.140196,1639.514286,0,0
8571706,"Chur, Fortunastrasse",,0.000037,109,2,2,4,43545,44111,87656,28,0.080479,0.099528,1476.5,0,0
8571847,"Chur, Austrasse",,0.000045,109,2,3,5,69751,70573,140324,25,0.098826,0.142459,3112.666667,0,0
8573157,"Untervaz, Kirchgasse",,0.000037,109,4,5,9,7888,7720,15608,17,0.139095,0.183808,2179.619048,0,0
8573183,"Chur, Schönmattweg",,0.000024,109,2,2,4,33983,37355,71338,17,0.129839,0.181377,503.409524,0,0
8574569,"Landquart, Bahnhof",,0.0001,109,7,7,14,22734,26539,49273,17,0.140175,0.19162,272722.891667,0,0
8574616,"Sargans, Castels",,0.000037,73,2,4,6,18469,21341,39810,17,0.10607,0.130056,59232.302198,0,0
8504523,"Roveredo GR, Centro",,0.000014,108,1,1,2,241,241,482,30,0.093193,0.113179,1,0,0
8504527,"Roveredo GR, Mondan",,0.000023,108,1,1,2,241,241,482,29,0.102592,0.130044,574,0,0
8505224,"Claro, Ponton",,0.000014,108,1,2,3,16875,16864,33739,28,0.112992,0.150801,562.5,0,0
8504547,"Portalban, village",,0.000022,126,2,3,5,7789,7368,15157,32,0.084594,0.106279,1930.839286,0,0
8504533,"Ependes FR, village",,0.000011,126,0,1,1,0,10334,10334,36,0.064933,0.077747,0,0,0
8504612,"Schwarzsee, Kaspera",,0.000011,126,0,2,2,0,9088,9088,34,0.073296,0.091161,0,0,0
8504626,"Alterswil FR, Wengliswil",,0.000016,126,1,3,4,14260,14260,28520,35,0.073884,0.098583,177,0,0
8504629,"St. Ursen, Römerswil",,0.000042,126,1,3,4,16147,16147,32294,34,0.0791,0.110383,5254,0,0
8504637,"Düdingen, Angstorf",,0.000028,126,1,1,2,4281,4281,8562,35,0.073501,0.096464,3496,0,0
8504536,"Praz (Vully), village",,0.000011,126,0,1,1,0,5949,5949,28,0.090366,0.106406,0,0,0
8504537,"Sugiez, poste",,0.00002,126,1,3,4,5949,5949,11898,27,0.099228,0.121895,861,0,0
8504782,"Kerzers, Bahnhof",,0.000017,126,1,6,7,2975,6753,9728,26,0.107823,0.13684,1397.333333,0,0
8504892,"Mur, village",,0.000019,126,2,2,4,2974,4806,7780,28,0.092294,0.113434,473.666667,0,0
8504538,Kleingurmels,,0.000011,126,0,1,1,0,4227,4227,34,0.076355,0.099953,0,0,0
8504643,"Düdingen, Mariahilf",,0.000055,126,4,2,6,14639,14639,29278,34,0.079287,0.111016,8838.392814,0,0
8504767,"Bösingen, Dorf",,0.000011,126,0,2,2,0,5234,5234,34,0.077066,0.102837,0,0,0
8504539,"Ulmiz FR, Dorf",,0.000011,126,0,1,1,0,3466,3466,14,0.110368,0.126558,0,0,0
8504540,"Broc, bif. Botterens",,0.000016,13,1,1,2,1492,1492,2984,36,0.06552,0.079978,39.457576,0,0
8504797,"Cerniat FR, village",,0.000011,13,0,2,2,0,1527,1527,36,0.066003,0.082265,0,0,0
8504541,"Gruyères, ville",,0.000011,13,0,1,1,0,5833,5833,22,0.091624,0.104439,0,0,0
8504542,"Buttes, bif. Les Gouttettes",,0.000011,35,0,2,2,0,4620,4620,15,0.110294,0.192918,0,0,0
8504543,"La Côte-aux-Fées,Les Bourquins",,0.000016,35,1,1,2,1222,1222,2444,15,0.107011,0.165087,0,0,0
8504545,"Meinisberg, Dorfplatz",,0.000011,87,0,1,1,0,17702,17702,24,0.108916,0.135288,0,0,0
8571201,"Biel/Bienne, Badhausstrasse",,0.000051,87,1,3,4,31623,76649,108272,21,0.107782,0.134883,4662,0,0
8571202,"Nidau, Kirche/Eglise",,0.000025,87,1,2,3,44594,48889,93483,21,0.107658,0.133768,0,0,0
8571204,"Nidau, Grasgarten",,0.000036,87,2,2,4,41055,40954,82009,21,0.108986,0.13493,768,0,0
8571206,"Nidau, Friedhof Schürlirain",,0.000026,87,1,3,4,8400,8400,16800,21,0.110335,0.136826,855,0,0
8571228,"Merzligen, Linde",,0.000047,87,1,2,3,1851,1851,3702,24,0.109054,0.136521,2829.5,0,0
8571229,"Aarberg, Murtenstrasse",,0.000044,87,2,1,3,4942,4942,9884,24,0.108916,0.135288,3863.171429,0,0
8571255,"Lyss, Mühleplatz",,0.000057,44,3,4,7,4577,5506,10083,21,0.135569,0.169727,8957.71746,0,0
8504886,"Donatyre, village",,0.000017,126,1,2,3,7006,6998,14004,33,0.070821,0.090733,628.994268,0,0
8504887,"St-Aubin FR, église",,0.000024,126,2,3,5,7435,7159,14594,32,0.074572,0.097257,879.110935,0,0
8506640,"Givisiez, gare",,0.000054,126,4,7,11,49254,49243,98497,31,0.082038,0.118091,63626.564024,0,0
8507595,"Belfaux, Arsenal",,0.000018,126,1,3,4,6733,6733,13466,31,0.079644,0.111245,0,0,0
8577793,"Corjolens, Prez-bif.",,0.000036,126,3,2,5,6732,6683,13415,15,0.127838,0.171776,4478.174209,0,0
8577795,"Lovens, Les Esserts",,0.000054,126,1,2,3,2216,2216,4432,15,0.12605,0.165524,186.333333,0,0
8504591,"Niedermuhren, Burg",,0.000011,126,0,1,1,0,5353,5353,38,0.059573,0.071429,0,0,0
8504592,"Lanthen, Käserei",,0.000011,126,0,1,1,0,4281,4281,37,0.064147,0.078115,0,0,0
8504593,"Lehwil, Dorf",,0.00002,126,1,1,2,5353,5353,10706,37,0.06331,0.07797,1710,0,0
8504594,"Schmitten FR, Ried b. Berg",,0.00002,126,1,1,2,4281,4281,8562,36,0.068505,0.086087,1749,0,0
8504595,"Niedermuhren, Dorf",,0.000028,126,1,2,3,5353,5353,10706,36,0.067549,0.086456,3418,0,0
8504636,"Tafers, Abzw. Rohr",,0.000028,126,2,1,3,11434,11367,22801,36,0.071432,0.091031,164.166667,0,0
8504596,"Les Verrières, gare",,0.000025,49,2,1,3,10717,11052,21769,24,0.067428,0.081031,6,0,0
8504597,"Les Verrières, Meudon",,0.000032,49,1,1,2,11052,11052,22104,23,0.072072,0.088068,315,0,0
8504598,"Ueberstorf, Abzw. Grossried",,0.000011,126,0,1,1,0,5108,5108,14,0.109158,0.131774,0,0,0
8504599,"Ueberstorf, Abzw. Steinhaus",,0.00002,126,1,2,3,5108,5108,10216,13,0.121495,0.153,117,0,0
8504766,"Albligen, Dorf",,0.000019,126,1,2,3,4690,4689,9379,13,0.120708,0.150008,2,0,0
8504600,"Fuyens, laiterie",,0.000018,126,1,1,2,5896,5896,11792,37,0.067397,0.08397,28,0,0
8504601,"Massonnens, Malapalud",,0.000026,126,1,1,2,5896,5896,11792,36,0.072215,0.093295,1379,0,0
8504604,"Belfaux, Château-du-Bois",,0.000024,126,2,1,3,10039,13686,23725,35,0.076196,0.099564,1555.304762,0,0
8504605,"Corminboeuf, anc. poste",,0.000011,126,0,3,3,0,39498,39498,33,0.078268,0.102961,0,0,0
8504607,"Corminboeuf, Les Avudrans",,0.000014,126,1,1,2,18167,18162,36329,33,0.077955,0.100652,0,0,0
8504606,"St. Ursen, Tasberg",,0.00003,126,3,1,4,16147,16147,32294,36,0.068365,0.085702,1760,0,0
8504608,"Arconciel, Rialet",,0.00002,126,1,1,2,10334,10334,20668,35,0.069401,0.085443,1709,0,0
8504610,"Belfaux, Cutterwil",,0.000031,126,1,3,4,13686,13686,27372,34,0.082421,0.114513,2914.304762,0,0
8504616,"Cournillens, village",,0.00002,126,1,1,2,6688,6688,13376,35,0.076102,0.098975,0,0,0
8504648,"Cormérod, village",,0.000036,126,2,1,3,6968,6968,13936,34,0.08231,0.113211,1360,0,0
8504611,"Chésopelloz, village",,0.000014,126,1,3,4,2157,4309,6466,13,0.168293,0.204535,51.323622,0,0
8506926,"La Corbaz, ancienne école",,0.000037,126,1,1,2,3957,3957,7914,13,0.164015,0.187879,402,0,0
8577806,"Corminboeuf, Montaubert",,0.000053,126,2,1,3,37337,37343,74680,13,0.164015,0.187879,7822.135714,0,0
8577807,"Corminboeuf, village",,0.000091,126,3,2,5,41476,41476,82952,12,0.194729,0.232212,8041.001003,0,0
8504628,Menziswil,,0.000037,126,1,4,5,21015,21015,42030,33,0.080834,0.111844,5608.734113,0,0
8504615,"Senèdes, bif.",,0.000028,126,1,1,2,10334,10334,20668,34,0.074533,0.095309,3416,0,0
8504617,"Ponthaux, école",,0.000018,126,2,2,4,1660,2455,4115,49,0.053002,0.074662,229.166667,0,0
8504632,Seedorf FR,,0.000018,126,1,1,2,2230,5181,7411,49,0.052976,0.074195,0,0,0
8504619,"St. Ursen, Dorf",,0.000036,126,1,1,2,16147,16147,32294,35,0.07334,0.095962,3508,0,0
8504620,"Alterswil FR, Galteren",,0.000019,126,2,3,5,12813,14318,27131,33,0.079027,0.102365,3430,0,0
8504621,"St. Antoni, Weissenbach",,0.000023,126,1,2,3,4954,11367,16321,35,0.069791,0.087684,1892.180519,0,0
8504647,Zollhaus FR,,0.00004,126,1,2,3,9088,9589,18677,32,0.080508,0.102062,3635.886926,0,0
8504769,"Düdingen, Bahnhof",,0.000048,126,3,7,10,19697,52982,72679,33,0.08262,0.11644,7199.960952,0,0
8570514,"Avenches, gare",,0.000064,126,7,10,17,11886,21394,33280,30,0.08505,0.120915,80293.764439,0,0
8577812,"Fribourg, Ste-Thérèse",,0.000035,126,1,4,5,88130,90584,178714,12,0.23301,0.291066,7529.390831,0,0
8577819,"Granges-Paccot, Chantemerle",,0.000045,126,1,2,3,16382,16382,32764,12,0.202786,0.244345,573.5,0,0
8504623,"Villars-sur-Glâne, Planafaye",,0.000071,126,2,1,3,20828,22104,42932,38,0.062926,0.07575,5550,0,0
8504624,"Villars-sur-Glâne, La Glâne",,0.000071,126,1,1,2,22104,22104,44208,37,0.067102,0.082879,6908,0,0
8504625,"Granges-Paccot,ch. des Rosiers",,0.000011,126,0,1,1,0,16382,16382,32,0.075887,0.099747,0,0,0
8504631,"Marly, Les Rittes",,0.000026,126,2,3,5,37336,96148,133484,32,0.084497,0.116534,3366.676378,0,0
8504900,"Courtion, bif.",,0.000025,126,2,1,3,6722,6998,13720,32,0.075887,0.099747,911.583285,0,0
8504627,"Fribourg, Heitera",,0.000031,126,3,1,4,20782,21015,41797,34,0.074829,0.096993,3911.734113,0,0
8504850,"Alterswil FR, Dorfplatz",,0.000047,126,4,2,6,14318,14318,28636,32,0.083765,0.112755,15331.582121,0,0
8504868,"Plaffeien, Dorf",,0.000098,126,5,5,10,38100,38084,76184,31,0.087454,0.117374,41751.422863,0,0
8504874,"St. Antoni, Dorf",,0.000024,126,1,2,3,11323,11367,22690,34,0.08262,0.115815,5747.210262,0,0
8504635,Sales (Sarine),,0.000035,126,1,1,2,10334,10334,20668,33,0.080488,0.108688,5121,0,0
8504853,"Corbières, village",,0.000017,126,2,3,5,6721,17242,23963,33,0.08082,0.111416,2832.426243,0,0
8504860,"Jaun, Dorf",,0.000031,13,1,2,3,9955,9955,19910,33,0.081082,0.112105,6397.492412,0,0
8504633,"Fribourg, Rte de la Glâne",,0.000072,126,1,1,2,22104,22104,44208,36,0.071877,0.091901,8264,0,0
8504638,"Rechthalten, Rotkreuz",,0.000023,126,1,1,2,10548,10548,21096,33,0.074512,0.090435,2430.240693,0,0
8504947,"Lovens, village",,0.000028,126,2,4,6,4128,4202,8330,19,0.118582,0.152566,896.5,0,0
8504640,"Plaffeien, Rufenen",,0.000028,126,3,1,4,9088,9088,18176,34,0.069416,0.082076,257.886926,0,0
8508298,"Avry-sur-Matran, Marie-Favre",,0.000037,126,2,2,4,5059,5079,10138,19,0.117898,0.147766,830,0,0
8570490,"Corjolens, Maison Rouge",,0.000064,126,1,2,3,5251,5251,10502,19,0.117345,0.146212,6493.645151,0,0
8570491,"Corjolens, La Croisée",,0.000038,126,1,1,2,4803,4803,9606,19,0.117094,0.144135,0,0,0
8504642,"Schwarzsee, Lichtena",,0.000035,126,1,1,2,9088,9088,18176,33,0.07455,0.090676,1947.886926,0,0
8504645,"St. Ursen, Struss",,0.00003,126,1,1,2,10548,10548,21096,32,0.080464,0.101534,4123.240693,0,0
8504646,"Villarepos, centre",,0.000029,13,2,2,4,1974,3717,5691,31,0.080283,0.104681,1882,0,0
8510187,"Portalban, école",,0.000036,126,4,4,8,2262,2106,4368,31,0.078846,0.106823,4246.941381,0,0
8557053,"Ins, Witzwil",,0.000011,126,0,2,2,0,1957,1957,25,0.126584,0.160885,0,0,0
8570413,"Vallon, village",,0.000035,13,1,3,4,8817,3671,12488,31,0.078624,0.103835,11850.341359,0,0
8570511,"Guévaux, croisée",,0.000033,126,2,4,6,4806,4806,9612,27,0.101331,0.130414,1636.666667,0,0
8504651,"Ferreyres, village",,0.000011,5,0,1,1,0,4346,4346,30,0.067545,0.081591,0,0,0
8506903,"Bussigny, Sottelles",,0.00002,5,2,4,6,17921,17949,35870,29,0.072361,0.091309,1297,0,0
8570096,"Cossonay-Ville, Pré aux Moines",,0.000037,5,1,1,2,7087,7087,14174,30,0.067545,0.081591,64242,0,0
8570108,"Senarclens, village",,0.000058,5,1,1,2,7421,7421,14842,30,0.067545,0.081591,12434,0,0
8570049,"Aubonne, Sermaret",,0.000026,5,2,1,3,541,541,1082,21,0.071994,0.099314,90,0,0
8510528,"St-Sulpice VD, Pré-Fleuri",,0.000037,5,1,1,2,17253,17253,34506,39,0.045782,0.057777,3963,0,0
8504654,"Lussy-sur-Morges, village",,0.000016,5,1,4,5,24138,24138,48276,38,0.048358,0.067932,1327.5,0,0
8589248,"Morges, ch. du Bochet",,0.000096,5,6,2,8,48007,48017,96024,10,0.186667,0.255761,1424.404329,0,0
8592270,"Morges, Les Emetaux",,0.000083,5,2,4,6,36145,36116,72261,6,0.352113,0.454667,470.524242,0,0
8592271,"Morges, Moulin",,0.000068,5,2,3,5,18420,18162,36582,5,0.4,0.496875,470.203896,0,0
8592274,"Morges, Auguste-Forel",,0.000076,5,3,5,8,34954,34945,69899,5,0.4375,0.549206,2033.613636,0,0
8592278,"Morges, temple",,0.000111,5,5,3,8,39910,39911,79821,6,0.333333,0.435965,1261.723737,0,0
8504659,"Eclépens, village",,0.000016,5,1,2,3,4105,4223,8328,13,0.154639,0.292009,4,0,0
8505426,"Orny, village",,0.000017,5,1,1,2,2234,2234,4468,13,0.145833,0.241438,0,0,0
8504664,Beffeux,,0.000022,103,1,1,2,1469,1469,2938,15,0.103659,0.136732,40,0,0
8504665,"Torgon, Bonne-Année",,0.00003,103,1,1,2,1469,1469,2938,14,0.113379,0.146944,82,0,0
8504666,"Torgon, Le Chêne",,0.000036,103,1,1,2,1469,1469,2938,13,0.12532,0.160166,122,0,0
8504667,Mayen-sur-Vionnaz,,0.000042,103,1,1,2,1469,1469,2938,12,0.140351,0.178211,160,0,0
8504668,Revereulaz,,0.000046,103,1,1,2,1469,1469,2938,11,0.159864,0.205041,196,0,0
8570617,"Vionnaz, gare",,0.000056,103,1,2,3,1475,1475,2950,4,0.4375,0.559524,222,0,0
8504672,"Liddes, Fontaine",,0.000028,104,1,1,2,1095,1095,2190,4,0.333333,0.40625,16,0,0
8504677,Hérémence,,0.000031,39,2,2,4,3284,3297,6581,21,0.118932,0.151542,268,0,0
8504678,"Pralong, (Val d'Hérémence)",,0.000024,39,1,1,2,552,552,1104,21,0.118397,0.147191,0,0,0
8504679,"Les Collons, Office Tourisme",,0.000017,39,1,2,3,1254,1383,2637,22,0.111805,0.139761,468,0,0
8504686,Thyon 2000,,0.000018,39,1,1,2,1254,1254,2508,22,0.1113,0.135372,0,0,0
8504682,"Liddes, Rive-Haute",,0.000035,104,1,1,2,1095,1095,2190,3,0.4375,0.5,21,0,0
8579444,"Orsières, Biolley",,0.000031,104,1,1,2,1351,1395,2746,3,0.4375,0.5,42,0,0
8579446,"Praz-de-Fort, Le Revers",,0.000057,104,1,2,3,1271,1271,2542,4,0.423077,0.507576,64,0,0
8579450,"La Seiloz, L'Amônaz",,0.00005,104,1,1,2,955,955,1910,3,0.4375,0.5,21,0,0
8504687,"Antagnes, Glutières",,0.000028,103,1,1,2,1734,1734,3468,16,0.093525,0.126092,104,0,0
8504688,"Ollon VD, bif. Forchex",,0.000035,103,1,1,2,1734,1734,3468,15,0.10119,0.133589,153,0,0
8504689,"Auliens, halte",,0.00004,103,1,1,2,1734,1734,3468,14,0.110375,0.142794,200,0,0
8504690,"Granges (Veveyse), Sokymat",,0.000011,13,0,1,1,0,933,933,20,0.122753,0.152997,0,0,0
8504790,"Ecoteaux, collège",,0.000013,13,1,3,4,2224,3327,5551,25,0.097236,0.128552,263.089069,0,0
8504960,"Attalens, village",,0.000011,13,0,1,1,0,8735,8735,20,0.122753,0.152997,0,0,0
8504970,"Ursy, village",,0.000044,13,2,4,6,16956,21791,38747,20,0.126793,0.162833,2502.085173,0,0
8557076,"Forel (Lavaux), rte Industrie",,0.000014,13,1,1,2,176,1555,1731,20,0.122753,0.152997,500.166667,0,0
8557143,"Puidoux, Drugex",,0.00004,13,1,1,2,2949,2949,5898,20,0.122753,0.152997,2547,0,0
8570439,"Oron-la-Ville, Pré à l'Abbé",,0.000104,13,6,2,8,19540,19597,39137,20,0.126829,0.159996,20792.259246,0,0
8504691,"Frenières-sur-Bex, bif.",,0.00002,103,1,1,2,352,352,704,12,0.155882,0.192163,53,0,0
8504694,"Lovatens, village",,0.00002,13,1,1,2,2263,2263,4526,42,0.048223,0.062595,917,0,0
8504695,"Sarzens, village",,0.000028,13,1,1,2,2263,2130,4393,41,0.050611,0.067504,1832,0,0
8504696,"Brenles, village",,0.000035,13,1,1,2,2130,2130,4260,40,0.05325,0.073598,2745,0,0
8504698,Chesalles-sur-Moudon,,0.00004,13,1,1,2,2130,2130,4260,39,0.056184,0.081534,3656,0,0
8504700,"Gals, Bethlehem",,0.000011,117,0,1,1,0,2834,2834,27,0.104508,0.121575,0,0,0
8504760,"Erlach, Stedtli",,0.000043,117,3,5,8,10534,15830,26364,26,0.11387,0.138333,2435,0,0
8504991,"Tschugg, Unterdorf",,0.000018,117,1,2,3,4655,4655,9310,26,0.108684,0.129775,0,0,0
8570550,"Kerzers, Mühlegasse",,0.000044,126,1,3,4,3068,3068,6136,24,0.125431,0.166285,7139.333333,0,0
8571243,"Vinelz, Strand",,0.000047,117,2,2,4,7253,7252,14505,26,0.108426,0.129014,1620,0,0
8571522,"Ins, Brennerei",,0.000029,117,1,4,5,5884,5884,11768,20,0.126667,0.176737,25535.133333,0,0
8571525,"Erlach, unter den Halden",,0.000024,117,2,1,3,3930,3923,7853,20,0.123054,0.155153,652,0,0
8504702,"Mullen, Dorf",,0.000011,117,0,1,1,0,4654,4654,28,0.092946,0.105173,0,0,0
8504704,"Aarberg, Bifang",,0.000011,44,0,1,1,0,4713,4713,23,0.117276,0.13645,0,0,0
8504706,"Lyss, Stigli",,0.00002,44,1,2,3,4713,5610,10323,22,0.132683,0.162041,762,0,0
8504756,"Seedorf BE, Gemeindeverwaltung",,0.000023,44,2,4,6,3652,9195,12847,23,0.130021,0.161435,948.084921,0,0
8507995,"Detligen, Jucher",,0.00004,44,2,1,3,7206,7206,14412,23,0.126347,0.149055,1329.666667,0,0
8571218,"Aarberg, Aarezelg",,0.000061,44,1,1,2,4942,4942,9884,23,0.126347,0.149055,6306,0,0
8571253,"Aarberg, Spital",,0.000024,44,1,1,2,4713,4713,9426,22,0.130452,0.154989,907.44127,0,0
8571261,"Seedorf BE, Unterdorf",,0.000073,44,3,2,5,4189,5224,9413,22,0.13164,0.157689,3631.64127,0,0
8571383,"Baggwil, Dorf",,0.000061,44,1,2,3,4888,4888,9776,22,0.130819,0.157264,26801.583333,0,0
8571463,"Diessbach bei Büren, Gäu",,0.000043,87,1,1,2,957,957,1914,22,0.130452,0.154989,3488,0,0
8571466,"Grossaffoltern, Schmidebach",,0.000037,44,1,2,3,1024,1024,2048,22,0.131381,0.157649,1579,0,0
8571467,"Vorimholz, Hof Aeschwald",,0.000027,44,1,2,3,452,452,904,22,0.131495,0.158177,253,0,0
8571468,Waltwil,,0.000051,87,3,3,6,1035,1035,2070,22,0.131584,0.159369,5596.690476,0,0
8571510,"Messen, Ischbad",,0.000043,87,1,2,3,536,536,1072,22,0.130504,0.156011,1879.104762,0,0
8576436,"Lyss, Lyssbachpark",,0.00009,87,2,1,3,17950,17950,35900,22,0.130452,0.154989,10628.5,0,0
8504708,"Pringy, village",,0.00002,13,1,1,2,5833,5833,11666,21,0.100632,0.117197,430,0,0
8504710,"Radelfingen b. A., Mühlethal",,0.000011,44,0,1,1,0,7206,7206,28,0.082882,0.091162,0,0,0
8504711,"Radelfingen b. A., Salzmatt",,0.00002,44,1,1,2,7206,7206,14412,27,0.090258,0.100453,794,0,0
8504712,Chardonne,,0.000011,12,0,1,1,0,7623,7623,13,0.128205,0.187192,0,0,0
8504713,"Châtel-St-Denis, Fruence",,0.000011,12,0,2,2,0,5663,5663,8,0.244186,0.336565,0,0,0
8504867,"Les Paccots, Ermitage",,0.000031,12,1,1,2,5633,5637,11270,8,0.225,0.290807,36,0,0
8504962,"Monts-de-Corsier, Longpraz",,0.000051,12,1,2,3,9738,9738,19476,8,0.234568,0.328133,114,0,0
8504963,"Corsier-Vevey, Cure d'Attalens",,0.000033,12,1,1,2,7623,7623,15246,8,0.225,0.290807,0,0,0
8504715,"Les Paccots, Les Rosalys",,0.000016,12,1,1,2,5633,5637,11270,10,0.168067,0.227877,2,0,0
8504716,"Châtel-St-Denis, Le Scé",,0.000024,12,1,1,2,5637,5633,11270,9,0.191919,0.252527,20,0,0
8507777,"Kirchlindach, Kirche",,0.000023,44,1,3,4,11225,11225,22450,24,0.131387,0.164429,793,0,0
8507778,"Meikirch, Postgässli",,0.000029,44,2,2,4,4789,4789,9578,23,0.128932,0.156491,819.333333,0,0
8507779,"Wohlen b. Bern, Gemeindehaus",,0.000032,44,2,1,3,10317,13319,23636,24,0.122788,0.147607,3057.357143,0,0
8504719,"Autavaux, bif.",,0.000011,13,0,2,2,0,6195,6195,19,0.133423,0.18843,0,0,0
8510078,"Montbrelloz, école",,0.000016,13,1,1,2,1382,1382,2764,19,0.132254,0.180149,0,0,0
8557020,"Grandcour, rte de Chevroux",,0.000034,13,2,2,4,3143,3143,6286,19,0.133515,0.190013,903.1,0,0
8504720,"Bollion, village",,0.000011,13,0,1,1,0,4214,4214,21,0.105723,0.139627,0,0,0
8504722,"Lully FR, village",,0.00002,13,1,3,4,4214,5606,9820,20,0.117137,0.166352,108,0,0
8510079,"Seiry, village",,0.000017,13,1,1,2,636,686,1322,20,0.111494,0.144126,0,0,0
8504724,"Murist, village",,0.000017,13,1,1,2,4214,4214,8428,23,0.087175,0.110848,18,0,0
8504725,"Bollion, Mussillens",,0.000025,13,1,1,2,4214,4214,8428,22,0.094582,0.120427,119,0,0
8504726,La Vounaise,,0.000032,13,1,1,2,4214,4214,8428,21,0.103448,0.132884,218,0,0
8504727,"Vuissens, poste",,0.000038,13,1,1,2,4214,4214,8428,20,0.114253,0.14997,315,0,0
8570387,"Rovray, village",,0.000043,13,1,2,3,2548,2548,5096,19,0.122573,0.169207,8272.828571,0,0
8504728,"Jongny, Reposoir",,0.00002,12,1,1,2,7623,7623,15246,12,0.141176,0.202267,24,0,0
8504729,"Boltigen, Eschi Abzw.",,0.000011,13,0,1,1,0,2346,2346,22,0.086174,0.095262,0,0,0
8504730,"Boltigen, Eschiegg",,0.00002,13,1,1,2,2346,2346,4692,21,0.094069,0.104751,406,0,0
8504732,"Boltigen, Reidenbach",,0.000064,13,2,2,4,4298,4298,8596,19,0.115264,0.133752,2828,0,0
8577763,"Boltigen, Sommerau",,0.000047,13,1,1,2,2346,2346,4692,9,0.212766,0.332897,1500,0,0
8504737,Haut-de-la-Tour,,0.000049,49,2,2,4,11245,11484,22729,21,0.083648,0.111232,1480.5,0,0
8504750,"La Brévine, poste",,0.000024,49,2,7,9,4161,12593,16754,28,0.094131,0.152638,11008.590909,0,0
8506934,"Fleurier, Hôtel de ville",,0.000033,49,1,2,3,5743,5753,11496,20,0.089732,0.120883,453,0,0
8507920,"La Brévine, Ferme Baillod",,0.000028,49,2,3,5,4570,4585,9155,21,0.082972,0.110145,973.666667,0,0
8571798,École,,0.000049,48,2,2,4,2541,2541,5082,19,0.109091,0.146685,17988.565476,0,0
8504738,"Les Petits-Ponts, Les Attis",,0.000027,48,1,1,2,6918,6918,13836,18,0.114548,0.135077,18358.915909,0,0
8504747,"Les Petits-Ponts, carrefour",,0.000018,134,1,2,3,6918,7917,14835,15,0.121045,0.15263,8832.672545,0,0
8507922,"La Châtagne, Le Moulinet",,0.000023,49,1,4,5,2567,2567,5134,29,0.061907,0.113435,372,0,0
8571806,"Le Prévoux, Haut du Prévoux",,0.000047,134,1,1,2,5289,5289,10578,29,0.059736,0.094139,1730,0,0
8504745,"Montmollin, Route de la Tourne",,0.000017,48,1,1,2,6918,6918,13836,17,0.12349,0.142895,0,0,0
8571789,Rue de l'Etang,,0.000035,48,3,1,4,6322,6327,12649,19,0.103881,0.118242,103.5,0,0
8571889,"La Chaux-de-Fonds, Bassets-Cr",,0.000032,134,1,2,3,3395,3395,6790,7,0.276596,0.394322,3522,0,0
8571791,Sous-le-Pré,,0.00006,48,3,1,4,13421,13424,26845,18,0.11559,0.134828,18768.416667,0,0
8570324,"St-Aubin NE, Pattus",,0.000028,35,1,3,4,4762,4762,9524,17,0.130084,0.158617,40979.333333,0,0
8571792,"Bôle, collèges",,0.000069,48,2,3,5,13482,13482,26964,17,0.13032,0.160008,18977.952381,0,0
8571845,"Corcelles NE, église",,0.00004,134,1,1,2,6918,6918,13836,17,0.122405,0.14573,6399.5,0,0
8571836,"Les Ponts-de-Martel, Pt-Bois",,0.000035,134,1,2,3,7610,7610,15220,15,0.119515,0.148951,4744.5,0,0
8571837,"Les Ponts-de-Martel, rue Pury",,0.00005,134,2,1,3,7576,7576,15152,15,0.119201,0.146403,4744.5,0,0
8506930,Séchoir,,0.000035,49,2,2,4,8109,9388,17497,22,0.077289,0.100364,788,0,0
8571801,"Le Locle, Lux",,0.000019,134,2,3,5,2644,10916,13560,34,0.051137,0.096724,744.224242,0,0
8504751,"La Côte-aux-Fées, poste",,0.000029,35,2,1,3,4620,4620,9240,14,0.115702,0.176079,56,0,0
8504752,"Lamboing, village",,0.000011,117,0,1,1,0,4168,4168,21,0.112466,0.140692,0,0,0
8504762,"Diesse, village",,0.00002,117,1,2,3,4168,4332,8500,20,0.125954,0.166973,165,0,0
8557110,"Cressier NE, Sansfoin",,0.000028,117,1,1,2,2605,2605,5210,19,0.091707,0.128979,230,0,0
8571527,"Gals, Gemeindehaus",,0.000023,117,1,2,3,4439,2313,6752,19,0.092593,0.14049,191,0,0
8504757,"Wiler bei Seedorf, Dorf",,0.000016,44,1,1,2,3471,3471,6942,24,0.114335,0.132504,0,0,0
8504758,"Mézières VD, village",,0.000058,13,3,5,8,8522,7999,16521,26,0.079854,0.097755,5409.421112,0,0
8557059,"Vulliens, Le Corria",,0.000021,13,1,1,2,1606,1606,3212,28,0.068758,0.077948,0,0,0
8557060,"Vulliens, village",,0.000038,13,2,2,4,1727,1727,3454,27,0.073753,0.085646,931,0,0
8557075,"Carrouge VD, Le Borgeau",,0.000027,13,1,2,3,1606,1606,3212,27,0.073684,0.08519,12,0,0
8557078,"Vucherens, église",,0.000022,13,1,1,2,773,773,1546,27,0.073609,0.084184,0,0,0
8557026,"Servion, Vieux-Collège",,0.000022,13,1,2,3,6265,6265,12530,25,0.082666,0.096073,2748.435714,0,0
8557141,"Mézières VD, collège Raffort",,0.000068,13,4,2,6,2039,2039,4078,26,0.079371,0.093339,3703.266667,0,0
8507654,"Bioley-Magnoux, collège",,0.000011,35,0,4,4,0,2180,2180,27,0.080521,0.103598,0,0,0
8504992,"Vinelz, Dorf",,0.000026,117,2,2,4,5896,5896,11792,27,0.098039,0.113812,13,0,0
8504761,Mont-de-Buttes,,0.000035,35,1,1,2,4620,4620,9240,13,0.126168,0.191021,81,0,0
8571899,"Prêles, Louvain",,0.000042,117,1,1,2,3082,3082,6164,6,0.285714,0.379167,4552,0,0
8571900,"Prêles, gare",,0.000051,117,2,1,3,4130,4130,8260,5,0.35,0.445238,3990,0,0
8504764,"La Chaux-de-Fonds, gare",,0.000096,134,5,16,21,4348,263393,267741,20,0.171725,0.288929,76311.17345,0,0
8504994,"La Maison-Monsieur, bif.",,0.000016,134,1,2,3,510,510,1020,21,0.136901,0.187796,0,0,0
8571883,Espacité,,0.000023,134,2,4,6,56446,57446,113892,20,0.155449,0.228199,2716.190476,0,0
8571884,Gr Fontaine,,0.000023,134,2,6,8,87310,89661,176971,20,0.153543,0.231351,3132.809524,0,0
8571885,Moulins,,0.000019,134,2,3,5,48093,47961,96054,12,0.206897,0.259076,4824.688095,0,0
8579002,rte cantonale,,0.000024,134,3,4,7,20790,22089,42879,19,0.13772,0.197178,11944.477874,0,0
8579617,Ferme Matile,,0.000052,48,2,2,4,16829,16829,33658,18,0.136154,0.177034,11359.235714,0,0
8579721,Musée paysan,,0.000024,134,3,1,4,58957,60166,119123,12,0.156331,0.187109,10.235714,0,0
8593625,Arc-en-Ciel,,0.000016,134,1,2,3,23234,23241,46475,15,0.113594,0.158953,438,0,0
8593630,Chapeau-Rablé,,0.000019,134,2,1,3,23142,23311,46453,15,0.127517,0.161719,28,0,0
8593624,Grillon,,0.000055,134,3,2,5,50227,48889,99116,10,0.222874,0.269998,5861.133333,0,0
8593629,Bonne-Fontaine,,0.000034,134,1,5,6,48701,49792,98493,9,0.271739,0.354291,3331.633333,0,0
8593632,"La Chaux-de-Fonds, Recorne",,0.000037,134,3,1,4,46435,46484,92919,14,0.144231,0.189085,157.066667,0,0
8593646,Pouillerel,,0.000027,134,1,1,2,23471,20031,43502,10,0.207317,0.253688,977,0,0
8593647,Fusion,,0.000067,134,2,2,4,44558,44534,89092,10,0.212851,0.272417,424,0,0
8593651,Paix,,0.000068,134,3,3,6,43134,45356,88490,9,0.25641,0.339437,1728,0,0
8593658,Armes-Réunies,,0.000064,134,1,3,4,44701,43853,88554,9,0.25641,0.339437,100,0,0
8593661,22 Cantons,,0.000054,134,1,1,2,6931,6932,13863,11,0.171233,0.205739,350,0,0
8593665,Bibliothèque,,0.000096,134,1,2,3,58554,58554,117108,9,0.248705,0.320594,1071,0,0
8593667,Stavay-Mollondin,,0.000052,134,1,1,2,44934,44940,89874,9,0.244792,0.306138,0,0,0
8593669,"La Chaux-de-Fonds, Foulets",,0.000051,134,3,2,5,45971,43743,89714,9,0.248677,0.322096,2342.666667,0,0
8504765,"Les Ponts-de-Martel, Gde-Rue",,0.000026,134,2,2,4,7369,7817,15186,26,0.065448,0.096928,5589.58326,0,0
8505534,"Le Locle, Chemin des Dolines",,0.000011,134,0,1,1,0,8026,8026,26,0.064697,0.091729,0,0,0
8571824,"La Chaux-du-Milieu, Clef-d'Or",,0.00007,134,1,2,3,9936,9936,19872,26,0.065156,0.097572,6964.5,0,0
8570553,"Bösingen, Riederberg",,0.000035,126,1,1,2,5112,5112,10224,14,0.114081,0.13275,829,0,0
8506715,"Düdingen, Am Bach",,0.000038,126,1,1,2,25544,25544,51088,18,0.1133,0.189332,69,0,0
8504778,"Gurmels, Dorf",,0.000017,126,1,2,3,4227,6727,10954,15,0.112276,0.138342,214.666667,0,0
8504795,"Middes, bif.",,0.000036,13,1,2,3,5156,5156,10312,45,0.063671,0.100899,1982,0,0
8504772,"Romont FR, poste",,0.000011,13,0,1,1,0,14062,14062,22,0.098776,0.119546,0,0,0
8504773,"Ueberstorf, Albligenstrasse",,0.000019,126,1,1,2,2344,2344,4688,13,0.11875,0.137289,0.5,0,0
8504982,Niedermettlen,,0.000028,126,2,3,5,2763,2764,5527,12,0.134911,0.169189,341.5,0,0
8505429,"Yverdon, Collège des Rives",,0.000014,35,1,2,3,18714,18150,36864,8,0.206186,0.26372,17.961905,0,0
8504988,"Chêne-Pâquier, anc. poste",,0.000019,35,1,1,2,2304,2304,4608,31,0.064757,0.0807,2,0,0
8504987,"Chavannes-le-Chêne, Hôtel",,0.000018,35,2,2,4,2312,2548,4860,31,0.065597,0.085493,73.033516,0,0
8507434,"Démoret, La Rapas",,0.00003,35,2,3,5,4129,4129,8258,30,0.069186,0.09085,1506.497375,0,0
8507651,"Arrissoules, village",,0.000019,35,1,2,3,1207,1207,2414,30,0.069136,0.090136,0,0,0
8507417,"Orbe, Gruvatiez",,0.000026,35,3,2,5,9632,9583,19215,44,0.047683,0.070419,1408.5,0,0
8507950,"Grandson, Péroset",,0.000044,35,2,2,4,950,950,1900,25,0.071416,0.085115,1670,0,0
8507957,"Grandson, Le Repuis",,0.000044,35,2,1,3,8847,8847,17694,25,0.071256,0.082899,304,0,0
8507958,"Romairon, village",,0.00003,35,1,1,2,581,581,1162,25,0.071256,0.082899,0,0,0
8510326,"Vallorbe, grottes",,0.000014,35,1,2,3,1042,1290,2332,43,0.048695,0.067827,14,0,0
8510327,"Vallorbe, Les Revinnoz",,0.000017,35,1,1,2,636,636,1272,43,0.048657,0.067048,0,0,0
8507964,"Treycovagnes, village",,0.000032,35,1,2,3,4356,4414,8770,43,0.049804,0.076447,3588,0,0
8507659,"Yverdon-les-Bains, Condémines",,0.000038,35,4,6,10,33910,33911,67821,30,0.069994,0.096794,2654.787668,0,0
8507954,"Prahins, village",,0.000042,35,2,2,4,5189,5189,10378,27,0.08056,0.103849,5950.32619,0,0
8507963,"Thierrens, poste",,0.000065,35,4,6,10,11647,12887,24534,26,0.085791,0.11356,23350.381835,0,0
8507967,"Valeyres-sous-Ursins, village",,0.000031,35,1,1,2,2881,2881,5762,42,0.05128,0.076179,1940.666667,0,0
8557044,"Donneloye, collège",,0.000024,35,2,3,5,3356,3866,7222,39,0.057752,0.087258,429.519231,0,0
8570199,"Corcelles-sur-Chav., rte Chav.",,0.00005,35,2,2,4,5017,5017,10034,26,0.087959,0.112653,1708.759524,0,0
8570238,"Echallens, gare",,0.000296,35,13,9,22,23726,23980,47706,24,0.100521,0.135621,179396.232007,0,0
8570239,"Yverdon-les-Bains, 24 Janvier",,0.000014,35,1,2,3,20147,20119,40266,42,0.051582,0.079996,0,0,0
8570240,"Yverdon, rue de Montagny",,0.000043,35,3,5,8,26338,26392,52730,42,0.052206,0.085786,8362,0,0
8510424,"Vallorbe, Le Day",,0.00004,35,1,5,6,2771,2760,5531,41,0.053809,0.085091,3641,0,0
8510425,"Vallorbe, La Raz",,0.000018,35,1,2,3,636,569,1205,41,0.053552,0.081282,0,0,0
8510428,"Vallorbe, La Promenade",,0.000033,35,1,2,3,654,654,1308,41,0.053552,0.081282,2382,0,0
8570288,"Yverdon, 4 Marronniers",,0.00018,35,13,4,17,73371,72329,145700,41,0.054006,0.088058,89908.096032,0,0
8570290,"Yverdon, Champs-Lovats",,0.000028,35,1,7,8,23717,23799,47516,21,0.121652,0.196889,11372.17381,0,0
8570275,"Bonvillars, La Cour",,0.000026,35,1,2,3,4143,4143,8286,24,0.082215,0.121301,295,0,0
8570289,"Yverdon-les-Bains, Les Bains",,0.00008,35,5,4,9,43696,43678,87374,40,0.056519,0.093511,63907.655433,0,0
8570336,"Champvent, village",,0.000033,35,1,1,2,6193,6255,12448,20,0.120863,0.175275,336,0,0
8573440,"Concise, Camp de Vaumarcus",,0.000027,35,1,2,3,4704,4704,9408,19,0.129106,0.187008,28598.4,0,0
8575769,"Grandson, Borné Nau",,0.00009,35,6,2,8,1678,1678,3356,19,0.129106,0.187008,2159.633333,0,0
8579289,"Yverdon-les-Bains, Clendy",,0.00002,35,1,2,3,34942,35379,70321,20,0.123529,0.189341,248.92619,0,0
8579294,"Yverdon-les-Bains, Bel-Air",,0.000219,35,15,8,23,74729,74473,149202,19,0.136661,0.232943,66353.019048,0,0
8504775,"Oron-la-Ville, centre",,0.000026,13,3,4,7,15934,22648,38582,26,0.090088,0.114926,2367.114863,0,0
8504787,"Crêt-près-S.,Champ-de-l'Eglise",,0.000025,13,1,1,2,5122,5122,10244,21,0.104998,0.118444,563,0,0
8504788,"Grattavache, village",,0.000037,13,2,2,4,7141,7169,14310,20,0.117108,0.136153,2130.821104,0,0
8504851,"Villariaz, village",,0.000021,13,2,4,6,2790,11450,14240,20,0.122582,0.152356,622.322222,0,0
8504776,"Lyss, Berufsschulhaus",,0.000011,87,0,1,1,0,957,957,26,0.078822,0.089866,0,0,0
8504777,"Radelfingen b. A., Dorf",,0.000028,44,1,1,2,7206,7206,14412,26,0.099088,0.112274,1586,0,0
8577899,"Jeuss, Schulhaus",,0.000039,126,1,1,2,4227,4227,8454,14,0.106827,0.125967,13429,0,0
8504780,"Payerne, gare",,0.000034,13,3,6,9,5877,15369,21246,45,0.05893,0.087429,11340.665168,0,0
8504973,"Missy, village",,0.000023,13,1,2,3,3469,4423,7892,33,0.07082,0.088176,303,0,0
8557136,"Payerne, Sansui",,0.000051,13,2,2,4,6274,6274,12548,24,0.081395,0.125798,411,0,0
8557138,"Payerne, Grand'Rue",,0.000039,13,1,1,2,3079,3079,6158,24,0.079533,0.109152,75,0,0
8570372,"Thierrens, Fontana-Bion",,0.000032,13,1,1,2,2461,2461,4922,24,0.079533,0.109152,150,0,0
8577639,"Rueyres-les-Prés, bif.",,0.000104,13,2,2,4,9261,9261,18522,3,0.555556,0.666667,986,0,0
8504985,"Môtier (Vully), village",,0.000034,126,1,2,3,5949,5949,11898,27,0.099494,0.121955,846,0,0
8570531,"Sugiez, gare",,0.000035,126,3,2,5,6011,6009,12020,26,0.100626,0.120156,2735,0,0
8570533,"Sugiez, Nant",,0.000026,126,1,2,3,5949,4461,10410,26,0.100526,0.119683,8,0,0
8571453,"Gümmenen, Bahnhof",,0.000097,126,4,3,7,10646,12995,23641,11,0.161515,0.206041,3028,0,0
8583438,"Wileroltigen, Kindergarten",,0.000013,126,1,1,2,615,615,1230,11,0.221053,0.323962,0,0,0
8504786,"Crêt-près-Semsales, école",,0.000016,13,1,1,2,386,5122,5508,22,0.095174,0.105584,4,0,0
8504883,"Vuisternens-dt-Romont, Poyet",,0.000042,13,1,2,3,6327,6327,12654,21,0.114879,0.138403,977.928571,0,0
8504936,"Siviriez, Les Genièvres",,0.000036,13,1,1,2,15258,15258,30516,21,0.112708,0.135216,1647,0,0
8570438,"Châtillens, gare",,0.000045,13,1,1,2,3656,3440,7096,21,0.112746,0.134212,10439.033333,0,0
8504791,"Autigny, Café de l'Ecu",,0.00002,13,1,1,2,2242,2242,4484,37,0.068242,0.0869,1375,0,0
8507303,"Rueyres-St-Laurent,En Borgogne",,0.000025,13,1,1,2,898,898,1796,18,0.078324,0.100412,138,0,0
8504794,"Torny-le-Grand, village",,0.000029,13,2,1,3,4958,5156,10114,46,0.059889,0.088386,25,0,0
8504852,"Charmey (Gruyère), village",,0.000029,13,2,2,4,2941,11404,14345,35,0.070073,0.088728,3245.392412,0,0
8504884,"Epagny, village",,0.000036,13,2,3,5,10799,14906,25705,19,0.124274,0.154133,1336.124242,0,0
8504798,"Fiaugères, croisée",,0.000027,13,1,2,3,2433,2433,4866,19,0.127859,0.153391,2441.321104,0,0
8504801,"Hochfelden, Martinsmühle",,0.000031,107,3,1,4,12405,12418,24823,22,0.100032,0.116051,59.771429,0.000138,0
8573252,"Stadel b. N., Musterplatz",,0.000029,107,1,2,3,18701,18687,37388,19,0.10315,0.113373,1495.583333,0.000004,0.000277
8504812,"Satigny, Nant-d'Avril",,0.000011,120,0,1,1,0,26409,26409,20,0.137577,0.158614,0,0,0
8504813,"Satigny, Bergère",,0.00002,120,1,2,3,26409,38330,64739,19,0.159226,0.192828,535,0,0
8587418,"Petit-Lancy, Les Esserts",,0.000049,120,8,6,14,201020,200695,401715,19,0.170417,0.216179,2398.674961,0,0
8587907,"Genève, Plainpalais",,0.000056,120,7,8,15,192046,191851,383897,19,0.17552,0.222775,7869.019086,0,0
8587914,"Grand-Saconnex, place",,0.000078,120,5,5,10,137009,139983,276992,18,0.175467,0.219829,8871.411768,0,0
8587918,"Meyrin, CERN",,0.000023,120,2,2,4,26178,40415,66593,19,0.158619,0.193903,637.118838,0,0
8504819,"Walenstadt, Tisa",,0.000011,124,0,1,1,0,4936,4936,9,0.215909,0.30071,0,0,0
8574776,"Flums, Bahnhof",,0.000071,124,2,3,5,7801,7617,15418,8,0.259259,0.387812,231,0,0
8504934,"La Joux FR, Scierie",,0.000044,13,2,2,4,6327,6327,12654,20,0.118744,0.144173,1414.890476,0,0
8504968,"Estévenens, dessous",,0.000024,13,1,2,3,2995,2916,5911,4,0.407407,0.492424,17,0,0
8577683,"Grangettes, La Neirigue",,0.000021,13,1,2,3,880,959,1839,4,0.416667,0.508333,7,0,0
8587307,"Vuisternens-dt-Romont, Lanciau",,0.000031,13,2,2,4,13039,13263,26302,5,0.351852,0.422807,3739.661905,0,0
8594247,"Vaulruz-Nord, gare",,0.000085,13,1,2,3,11987,11987,23974,5,0.354839,0.457576,1688,0,0
8577742,"Marly, Grand Pré",,0.000046,126,1,5,6,137425,137425,274850,21,0.131244,0.185042,24870.985714,0,0
8577887,"St. Silvester, Ebnet",,0.000082,126,1,1,2,7532,7532,15064,1,1,1,614,0,0
8504858,"Heitenried, Dorf",,0.000047,126,2,3,5,11766,12204,23970,35,0.076871,0.103112,4746.986147,0,0
8504888,"Berg FR, Restaurant",,0.000024,126,1,1,2,4281,4281,8562,18,0.113902,0.131525,23.233333,0,0
8577856,"Heitenried, St. Michael",,0.000068,126,1,5,6,16720,13340,30060,11,0.204839,0.253459,12154.598413,0,0
8504859,"Im Fang, Dorf",,0.000023,13,1,1,2,9955,9955,19910,34,0.075042,0.097501,4694.492412,0,0
8504880,Moléson-sur-Gruyères,,0.000028,13,1,2,3,5833,6066,11899,20,0.111632,0.135433,858,0,0
8504861,"Jaunpass, Restaurant",,0.000038,13,1,1,2,2346,2346,4692,18,0.127491,0.147647,3144,0,0
8504921,"Im Fang, Zur Eich",,0.00004,13,1,2,3,9955,9955,19910,18,0.13012,0.154366,713.833333,0,0
8504932,Villarsel-sur-Marly,,0.000043,126,3,4,7,18881,18885,37766,16,0.15619,0.193342,3159.540476,0,0
8504928,"Treyvaux, Le Pratzey",,0.000036,126,2,2,4,13986,14233,28219,18,0.121454,0.142261,382.8,0,0
8577844,"Oberschrot, Büel",,0.000071,126,1,4,5,24808,24808,49616,9,0.215652,0.260045,5536.583333,0,0
8504912,"Bulle, Château-d'en-Bas",,0.000128,13,9,6,15,67074,92216,159290,20,0.150433,0.189476,10473.631716,0,0
8504875,"Sangernboden, Dorf",,0.000028,126,1,1,2,501,501,1002,30,0.07959,0.0913,37827.406017,0,0
8504890,"Schmitten FR, Dorf",,0.000062,126,1,3,4,9634,9634,19268,16,0.145881,0.181749,478.609219,0,0
8504943,"Zumholz, Dorf",,0.00003,126,2,2,4,24803,24808,49611,16,0.141399,0.171946,136.785714,0,0
8504945,"Alterswil FR, Beniwil",,0.000042,126,3,2,5,14318,14318,28636,15,0.161752,0.201814,348.789191,0,0
8577810,"Fribourg, Place Georges Python",,0.000126,126,9,6,15,141440,178782,320222,14,0.189296,0.250739,51534.545446,0,0
8577839,"Tafers, Am Kreuz",,0.000065,126,4,4,8,20374,19888,40262,12,0.205414,0.251597,6964.705313,0,0
8504879,"Drognens, caserne",,0.000022,13,2,1,3,14595,15258,29853,23,0.092264,0.104557,561,0,0
8577736,"Villars-sous-Mont, gare",,0.00004,13,2,1,3,862,872,1734,12,0.168421,0.223993,1459.621212,0,0
8504905,"Le Bry, village",,0.000043,126,1,2,3,12744,12744,25488,23,0.123342,0.144042,601.766667,0,0
8504927,"Hauteville, village",,0.000046,126,2,2,4,13035,13035,26070,19,0.118664,0.140025,502.166667,0,0
8504929,"Essert FR, La Riedera",,0.000038,126,3,2,5,12954,12858,25812,17,0.136091,0.161345,720.019048,0,0
8504931,"La Roche FR, Villaret",,0.00005,126,1,4,5,13035,13035,26070,17,0.151776,0.19336,1011.161905,0,0
8504906,"Corpataux, village",,0.000049,126,3,3,6,15924,16036,31960,22,0.140392,0.171089,1848.683983,0,0
8504923,"Sorens, Gérignoz",,0.000029,13,1,3,4,19258,19258,38516,17,0.157637,0.192594,1291.52381,0,0
8504924,"Sorens, village",,0.000019,13,1,2,3,6179,6179,12358,17,0.157378,0.19116,142.583333,0,0
8504939,"La Roche FR, Serbache",,0.000051,126,3,2,5,12690,12690,25380,16,0.166011,0.206938,3885.528571,0,0
8506532,"Broc, Bataille",,0.000058,13,3,4,7,14161,14126,28287,17,0.154834,0.19804,2458.662771,0,0
8510280,"Bulle, Nicolas-Glasson",,0.00012,13,7,5,12,81496,73661,155157,17,0.15625,0.203792,8810.272307,0,0
8577673,"Vuisternens-dt-Romont, forge",,0.00005,13,3,4,7,17549,17546,35095,17,0.14776,0.190859,69318.343319,0,0
8577681,"Oron-le-Châtel, gare",,0.000052,13,1,4,5,7796,7750,15546,17,0.155478,0.19803,5700,0,0
8577684,"Le Châtelard FR, Sâles",,0.000041,13,1,2,3,5896,5896,11792,17,0.155139,0.193765,42879.021627,0,0
8577703,"Villaz-St-Pierre, Le Biolex",,0.000038,13,2,3,5,6180,6180,12360,17,0.15677,0.199362,7361.876764,0,0
8504941,"Arconciel, village",,0.000025,126,1,1,2,10334,10334,20668,23,0.119644,0.161555,446.114286,0,0
8504946,"Bonnefontaine, village",,0.000028,126,1,1,2,6203,6203,12406,23,0.119644,0.161555,296,0,0
8504949,"Eichholz, Guglera",,0.000028,126,2,2,4,12053,12056,24109,23,0.120227,0.166027,550.745181,0,0
8504975,"Marly, Jonction",,0.000026,126,1,1,2,58805,58805,117610,23,0.119644,0.161555,503.075683,0,0
8508035,"Corminboeuf, Jo-Siffert",,0.000032,126,2,3,5,21428,16382,37810,23,0.122112,0.171694,1616.648163,0,0
8510190,"Marly, Pré de la Croix",,0.000048,126,1,1,2,36218,36218,72436,23,0.119644,0.161555,1184,0,0
8510665,"Villars-sur-Glâne,Petit-Moncor",,0.000025,126,1,1,2,9078,9411,18489,23,0.119644,0.161555,296,0,0
8577725,"Bulle, gare routière",,0.000176,13,13,16,29,46578,53251,99829,16,0.178018,0.247526,149153.598763,0,0
8504940,"St. Antoni, Niedermonten",,0.000047,126,3,2,5,11365,11367,22732,15,0.163127,0.199549,1707.832537,0,0
8504948,"Brünisried, Brügi",,0.000024,126,1,2,3,10548,10548,21096,15,0.161616,0.19921,109.37619,0,0
8577741,"Fribourg, Charmettes",,0.000207,126,11,5,16,168232,197516,365748,22,0.135445,0.204142,100481.467329,0,0
8577743,"Marly, Gérine",,0.000019,126,1,5,6,88024,88023,176047,20,0.140269,0.205517,9098.85,0,0
8577771,"Fribourg, Passage du Cardinal",,0.000013,126,1,1,2,26625,26625,53250,15,0.159867,0.193531,13.769048,0,0
8577785,"Fribourg, Bertigny",,0.000039,126,3,4,7,98909,106276,205185,15,0.175926,0.225021,4973.328881,0,0
8577786,"Villars-sur-Glâne,Villars-Vert",,0.000019,126,1,5,6,73281,73281,146562,15,0.187895,0.252917,360.318675,0,0
8577837,"Fribourg, Bourg",,0.000044,126,3,3,6,44156,35331,79487,8,0.255422,0.301494,1317.840997,0,0
8577851,"Schwarzsee, Bad",,0.000061,126,1,2,3,9088,9088,18176,9,0.207031,0.239334,636,0,0
8577860,"Schwarzenburg, Bahnhof",,0.000174,126,6,7,13,11492,10844,22336,9,0.218579,0.280241,17622.065079,0,0
8583787,"Wünnewil, Schule",,0.000088,126,4,3,7,7058,5539,12597,9,0.208577,0.246443,2001.177489,0,0
8592365,"Fribourg, Auge Sous-Pont",,0.000017,126,1,1,2,38761,36272,75033,5,0.333333,0.420833,0,0,0
8587238,"Givisiez, Mont Carmel",,0.000205,126,7,8,15,89469,93351,182820,7,0.315152,0.391758,129755.26073,0,0
8588856,"Granges-Paccot, Chamblioux",,0.000047,126,3,3,6,21427,16382,37809,8,0.237113,0.298741,293.020455,0,0
8589155,"Fribourg, Fries",,0.000169,126,2,5,7,157026,157033,314059,6,0.366972,0.450833,11999.622272,0,0
8589161,"Fribourg, St-Pierre",,0.000216,126,8,9,17,231129,236067,467196,5,0.438202,0.54359,33934.943048,0,0
8589173,"Villars-sur-Glâne, Les Dailles",,0.000041,126,2,3,5,55456,55455,110911,5,0.381818,0.469841,1964.916667,0,0
8589177,"Granges-Paccot, Agy",,0.000068,126,1,2,3,57685,57685,115370,4,0.380952,0.458333,64,0,0
8589271,"Fribourg, Schönberg Dunant",,0.000047,126,3,3,6,48809,54449,103258,4,0.395349,0.490196,101.225,0,0
8591766,"Fribourg, Boschung",,0.000122,126,5,2,7,53873,43504,97377,4,0.380952,0.458333,542.716037,0,0
8591767,"Fribourg, Route-de-Tavel",,0.000155,126,6,2,8,45076,15756,60832,4,0.380952,0.458333,702.182703,0,0
8592370,"Fribourg, Champ-Fleuri",,0.000188,126,1,3,4,38565,38565,77130,4,0.424242,0.529762,84.150501,0,0
8592371,"Fribourg, Cité-Levant",,0.000092,126,1,1,2,53080,53080,106160,4,0.375,0.4375,60,0,0
8592373,"Fribourg, Jardin botanique",,0.000158,126,4,3,7,20160,16798,36958,4,0.40625,0.519231,2560.101508,0,0
8504882,"La Joux FR, village",,0.000037,13,3,1,4,5991,6327,12318,22,0.103207,0.11947,427.928571,0,0
8504893,"Bouloz, école",,0.000018,13,1,1,2,923,923,1846,21,0.106329,0.123752,41.5,0,0
8504917,"Châtel-sur-Montsalvens, Rest.",,0.000031,13,1,2,3,9919,9919,19838,19,0.122283,0.145653,1848.131831,0,0
8577828,"Domdidier, gare",,0.000091,126,3,2,5,11845,11836,23681,12,0.1968,0.233595,4457.409682,0,0
8504889,"Lanthen, Abzw.",,0.000061,126,4,1,5,9701,9634,19335,17,0.127884,0.150921,401.609219,0,0
8504895,"Le Châtelard FR, village",,0.000027,126,1,1,2,5896,5896,11792,22,0.115965,0.131689,31,0,0
8504896,"Estévenens, dessus",,0.000015,13,1,1,2,2452,2995,5447,5,0.307692,0.370833,9,0,0
8504899,"Siviriez, village",,0.00003,13,1,1,2,15258,15258,30516,22,0.101457,0.117466,1105,0,0
8504901,"Nuvilly, village",,0.000031,13,2,3,5,6412,7266,13678,19,0.129458,0.194337,44,0,0
8577619,"Combremont-le-Petit, village",,0.00013,13,4,3,7,7439,7201,14640,16,0.155452,0.237115,3889.1,0,0
8504903,"Chavannes-sur-Moudon, La Croix",,0.000045,13,1,2,3,2130,2263,4393,38,0.059463,0.092852,4565,0,0
8570338,"Moudon, L'Ochette",,0.000058,13,2,2,4,292,864,1156,37,0.061024,0.094149,79697.112987,0,0
8570346,"Peney-le-Jorat, Moulin Peney",,0.000055,13,1,2,3,3116,3116,6232,29,0.075529,0.1008,35945,0,0
8570347,"Villars-Mendraz, croisée",,0.000052,35,2,2,4,5401,5167,10568,28,0.077994,0.10237,35661.580952,0,0
8570355,"Thierrens, La Croix",,0.00004,13,1,1,2,1835,1835,3670,22,0.102564,0.128451,23403.469481,0,0
8570380,"Cremin, village",,0.000101,13,2,3,5,2488,2565,5053,22,0.104138,0.134605,9287.086291,0,0
8504904,"Avry-devant-Pont, La Cantine",,0.000037,126,2,1,3,12636,12744,25380,24,0.109963,0.124408,121.766667,0,0
8504907,"Le Bry, Geneivroz",,0.000043,126,2,1,3,12744,12744,25488,22,0.120113,0.137245,179.333333,0,0
8504910,"Botterens, village",,0.000026,126,3,1,4,7190,7191,14381,19,0.11895,0.136669,1812.348485,0,0
8504926,"Echarlens, En Champotey",,0.000043,13,1,2,3,16891,16891,33782,18,0.134572,0.16454,899.666667,0,0
8504938,"Jaun, Kappelboden",,0.000069,13,3,3,6,12301,12299,24600,17,0.145758,0.177391,6473.814286,0,0
8577749,"Corbières, Pont de Corbières",,0.000055,13,2,3,5,16891,16891,33782,14,0.138573,0.185093,1989,0,0
8577751,"Villarvolard, Verchaux",,0.000071,13,3,2,5,7191,6840,14031,15,0.123606,0.157379,351,0,0
8577778,"Echarlens, bif.",,0.000076,13,3,2,5,19258,19258,38516,15,0.123433,0.159394,1037.014286,0,0
8577781,"Rossens FR, La Rossinoise",,0.000058,13,1,4,5,16036,16036,32072,15,0.141256,0.193385,422.5,0,0
8504913,"Bulle, Chalamala",,0.000029,13,1,1,2,27601,27601,55202,22,0.094318,0.105601,673.75,0,0
8504914,"Bulle, Jéricho",,0.000036,13,1,1,2,27601,27601,55202,21,0.103934,0.118408,1047.75,0,0
8504915,"Morlon, La Croix",,0.000041,13,1,2,3,27601,27601,55202,20,0.115758,0.136088,1419.75,0,0
8504916,"Cerniat FR, bif.",,0.000047,13,4,2,6,11482,11446,22928,20,0.110823,0.130266,2132.131831,0,0
8504919,"Epagny, Motel",,0.000034,13,2,3,5,12402,12524,24926,18,0.137537,0.170285,3310.098498,0,0
8504937,"Estavannens, Dessous",,0.000028,13,1,2,3,4251,4251,8502,18,0.136459,0.167375,886,0,0
8507519,"Bulle, Musée gruérien",,0.000028,13,1,1,2,13532,13532,27064,18,0.135439,0.163064,772,0,0
8507598,"Vuadens, Le Maupas",,0.000025,13,1,1,2,26700,26700,53400,18,0.135439,0.163064,447.666667,0,0
8508280,"Neirivue, gare",,0.000043,13,1,2,3,872,872,1744,18,0.136396,0.166601,1158,0,0
8508330,"Bulle, Champ-Francey",,0.000029,13,1,2,3,28515,28515,57030,18,0.136686,0.168286,1069.07619,0,0
8504920,"Charmey (Gruyère), Les Fornis",,0.000034,13,2,1,3,9955,9955,19910,19,0.115385,0.131923,424.833333,0,0
8504922,"Grandvillard, village",,0.000021,13,1,1,2,3829,4251,8080,19,0.120345,0.140657,620,0,0
8504925,"Echarlens, village",,0.000038,13,3,1,4,20037,16891,36928,19,0.118863,0.138759,614.666667,0,0
8504930,"Hauteville, Le Ruz",,0.000046,126,2,1,3,13035,13035,26070,18,0.132057,0.156952,747.161905,0,0
8577746,"La Roche FR, Le Zible",,0.000035,13,2,1,3,12690,12690,25380,17,0.100514,0.121014,1769,0,0
8504933,"Treyvaux, village",,0.000032,126,2,2,4,10578,10581,21159,24,0.108197,0.142431,717.114286,0,0
8577769,"Treyvaux, Le Chêne",,0.000042,126,1,2,3,10334,10334,20668,2,0.75,0.833333,1416,0,0
8505297,"Romanens, Grotte",,0.000023,13,2,1,3,1423,4283,5706,19,0.129232,0.154212,467.905375,0,0
8506324,"Bulle, St-Joseph",,0.000028,13,1,1,2,27165,26700,53865,19,0.129232,0.154212,1695.25,0,0
8504942,"Le Mouret, Le Pafuet",,0.00002,126,1,1,2,6203,6203,12406,24,0.107182,0.136676,145,0,0
8577712,"Vuisternens-en-Ogoz, Le Haut",,0.000049,13,1,3,4,6573,6583,13156,18,0.11686,0.161916,552,0,0
8577774,"Ecuvillens, Champ du Nod",,0.00003,13,2,2,4,3519,3520,7039,17,0.121409,0.159711,1.916667,0,0
8504974,"Avry-sur-Matran, village",,0.000031,126,2,2,4,5193,5079,10272,20,0.105918,0.127911,75,0,0
8577791,"Avry-sur-Matran, bif.",,0.000018,126,1,3,4,3575,3385,6960,16,0.115016,0.159454,408,0,0
8577842,"Alterswil FR, Wilersguet",,0.000038,126,1,1,2,14260,14260,28520,11,0.152542,0.170834,261,0,0
8504955,"Monts-de-Corsier, Banderette",,0.000028,12,1,1,2,7623,9738,17361,11,0.157534,0.224449,46,0,0
8504956,"Monts-de-Corsier, L'Hautigny",,0.000035,12,1,2,3,9738,9738,19476,10,0.178862,0.267767,66,0,0
8504959,"Corsier-sur-Vevey, Châtillon",,0.000026,12,1,1,2,7623,7623,15246,10,0.172131,0.232899,0,0,0
8504961,"Monts-de-Corsier, La Chaux",,0.000047,12,2,1,3,9738,9738,19476,9,0.19802,0.264901,100,0,0
8504965,"Châtel-St-Denis, Bellière",,0.000092,12,4,2,6,15405,15403,30808,7,0.274194,0.367227,204,0,0
8504967,"Corseaux, Délassement",,0.000053,12,1,1,2,7623,7623,15246,7,0.254237,0.31619,15,0,0
8504966,"Jongny, village",,0.00005,12,1,1,2,7623,7623,15246,8,0.213333,0.275074,13,0,0
8577696,"Vauderens, gare",,0.000068,13,3,1,4,7200,7200,14400,6,0.277778,0.356667,1670.5,0,0
8570454,"Fiaugères, Planches-Tuchet",,0.000032,13,1,1,2,386,386,772,22,0.095275,0.107272,200,0,0
8504986,"Grandcour, poste",,0.000026,13,2,3,5,7537,7537,15074,33,0.071288,0.090716,10104.441359,0,0
8508231,"Corserey, village",,0.00003,126,2,2,4,494,448,942,20,0.105799,0.127738,480.666667,0,0
8504976,"Siviriez, En Jogne",,0.00002,13,1,1,2,14216,15258,29474,23,0.098897,0.120326,78.75,0,0
8570373,"Granges-près-Marnand, gare",,0.000102,13,8,3,11,5716,5523,11239,28,0.071283,0.094365,12064.188961,0,0
8570477,"Rossens VD, La Rapette",,0.000081,13,2,3,5,4380,4380,8760,24,0.080007,0.096481,10033.95267,0,0
8570485,"Villars-Bramard, Farzin",,0.00004,13,1,2,3,953,715,1668,22,0.093164,0.1096,6460.95267,0,0
8570486,"Châtonnaye, Station Radio",,0.000049,126,3,3,6,5156,5156,10312,21,0.102413,0.123446,11580.80417,0,0
8570556,"Flamatt, Bahnhof",,0.000035,126,2,1,3,4690,4690,9380,12,0.13357,0.155937,113,0,0
8570557,"Flamatt, Post",,0.000049,126,2,3,5,4963,5482,10445,11,0.152797,0.186933,450,0,0
8570558,"Albligen, Kurried",,0.000025,126,1,1,2,4688,2346,7034,12,0.131673,0.148987,0,0,0
8504984,"Lugnorre, place du Pommeré",,0.000027,126,3,1,4,5949,5949,11898,28,0.090588,0.1068,4,0,0
8505039,"Chevroux, Eglise",,0.000018,13,1,1,2,77,77,154,20,0.118848,0.158054,0,0,0
8504989,"Champagne, collège",,0.000014,35,1,3,4,8847,8847,17694,24,0.074537,0.089357,2154.666667,0,0
8507656,"Concise, Les Biolles",,0.000015,35,1,1,2,4023,4023,8046,25,0.069237,0.078679,0,0,0
8507658,"Bonvillars, village",,0.000027,35,2,1,3,4143,4143,8286,24,0.074211,0.085031,421,0,0
8571240,"Lüscherz, Post",,0.000029,117,2,1,3,3812,3812,7624,27,0.097929,0.11271,9,0,0
8504993,"Mühleberg, Post",,0.000011,44,0,2,2,0,9849,9849,14,0.124847,0.158888,0,0,0
8504997,"Servion, Zoo-Tropiquarium",,0.000027,13,3,2,5,8942,9921,18863,25,0.079853,0.091871,4761.052381,0,0
8504999,"Payerne, hôpital",,0.000016,13,1,1,2,6273,6274,12547,27,0.068908,0.102109,91,0,0
8505001,Meggen,,0.000021,9,1,1,2,11545,11504,23049,32,0.065196,0.07822,0,0,0
8507389,Zweilütschinen,,0.000074,11,1,1,2,16852,16484,33336,17,0.122581,0.210394,608,0,0
8507483,Spiez,,0.000223,11,5,1,6,60201,18466,78667,17,0.122581,0.210394,17860.5,0,0
8508081,Burgdorf Steinhof,,0.000036,11,1,4,5,30037,29860,59897,9,0.231481,0.329032,313.125,0,0
8508202,Konolfingen,,0.000173,11,7,5,12,49445,58631,108076,9,0.235955,0.355763,22511.392857,0,0
8508205,Signau,,0.000052,11,2,2,4,19219,19347,38566,9,0.198529,0.288595,824,0,0
8508206,Emmenmatt,,0.000033,11,1,1,2,19027,19027,38054,9,0.192593,0.261233,0,0,0
8508187,Huttwil,,0.00006,9,1,1,2,16374,14305,30679,4,0.407407,0.462121,110,0,0
8508213,Entlebuch,,0.000059,9,2,1,3,18980,19264,38244,4,0.407407,0.462121,4620,0,0
8508305,Brienz,,0.000182,11,3,2,5,15181,15181,30362,15,0.132479,0.231557,15391.5,0,0
8508306,Brienzwiler,,0.000088,11,1,1,2,9262,9262,18524,15,0.128755,0.205942,0,0,0
8508311,Kaiserstuhl OW,,0.000063,9,1,1,2,7556,7556,15112,11,0.163934,0.226172,9179,0,0
8508312,Giswil,,0.000074,9,2,1,3,26572,27160,53732,10,0.186275,0.250272,8715,0,0
8508316,Alpnach Dorf,,0.000046,9,1,2,3,21608,21608,43216,7,0.3125,0.422857,7664,0,0
8508317,Alpnachstad,,0.00003,9,1,1,2,19604,19604,39208,7,0.297872,0.381633,0,0,0
8508318,Hergiswil NW,,0.000066,9,3,4,7,44702,45245,89947,6,0.393939,0.560256,7254.5,0,0
8508319,Horw,,0.000035,9,2,3,5,42769,42784,85553,6,0.375,0.523611,2000,0,0
8515993,Baar Lindenpark,,0.000092,9,5,2,7,50874,50153,101027,4,0.421053,0.53125,163.333333,0,0
8505011,Merlischachen,,0.000032,9,2,1,3,11535,10934,22469,31,0.068048,0.081102,4350,0,0
8505005,Steinen,,0.000022,9,1,1,2,21297,21286,42583,34,0.057908,0.067074,0,0,0
8505007,Brunnen,,0.000046,9,1,4,5,29626,29109,58735,32,0.065413,0.080684,3352,0,0
8505111,Sisikon,,0.000038,9,2,1,3,10008,10022,20030,27,0.078252,0.121303,400,0,0
8505113,Altdorf UR,,0.00004,9,2,3,5,21880,21625,43505,25,0.086058,0.14566,2125,0,0
8505201,Airolo,,0.000021,28,1,2,3,8281,9007,17288,25,0.072529,0.132468,1820,0,0
8505209,Biasca,,0.000056,28,2,2,4,9193,28308,37501,25,0.070748,0.126882,949,0,0
8505212,Castione-Arbedo,,0.000035,28,1,1,2,27903,48402,76305,25,0.070281,0.120645,0,0,0
8505006,Schwyz,,0.000041,9,2,1,3,29615,29626,59241,33,0.061431,0.072853,2051,0,0
8508246,"Samedan, Porta Samedan",,0.000013,30,1,3,4,3792,5362,9154,10,0.23301,0.299912,2.97619,0,0
8574515,"St. Moritz, Bahnhof",,0.000037,30,5,6,11,5922,6955,12877,9,0.268908,0.362624,129.672619,0,0
8574941,"Punt Muragl, Talstation",,0.000079,30,3,5,8,13111,13633,26744,8,0.299465,0.390986,425.96746,0,0
8574945,"St. Moritz, Bären",,0.000045,30,1,2,3,14546,14546,29092,9,0.24424,0.303609,106.444444,0,0
8505057,"Steinebrunn, Bahnhof",,0.000011,71,0,1,1,0,16803,16803,19,0.122497,0.137023,0,0,0
8505062,Goldau A4,,0.000011,27,0,1,1,0,4755,4755,18,0.09009,0.147631,0,0,0
8505063,Arth-Goldau RB,,0.00002,27,1,1,2,4755,4755,9510,17,0.09571,0.153773,29,0,0
8505064,Kräbel,,0.000028,27,1,1,2,4755,4755,9510,16,0.10219,0.160964,56,0,0
8505065,Fruttli,,0.000035,27,1,1,2,4755,4755,9510,15,0.109756,0.169687,81,0,0
8505066,Rigi Klösterli,,0.00004,27,1,1,2,4755,4755,9510,14,0.118721,0.180916,104,0,0
8505067,Rigi Wölfertschen-First,,0.000045,27,1,1,2,4755,4755,9510,13,0.129534,0.197205,125,0,0
8505068,Rigi Staffel,,0.000049,27,1,2,3,4755,10149,14904,12,0.142857,0.230031,144,0,0
8505069,Rigi Kulm,,0.000032,27,1,1,2,9911,5203,15114,12,0.137725,0.196554,0,0,0
8505071,Grubisbalm,,0.000059,27,2,1,3,5441,6643,12084,11,0.152778,0.211834,176,0,0
8505072,Freibergen,,0.000061,27,1,1,2,6643,6643,13286,10,0.172131,0.232596,189,0,0
8505073,Romiti Felsentor,,0.000063,27,1,1,2,6643,6643,13286,9,0.19802,0.263948,200,0,0
8505074,Rigi Kaltbad-First,,0.000064,27,1,2,3,6643,6643,13286,8,0.234568,0.324749,209,0,0
8505075,Rigi Staffelhöhe,,0.000038,27,1,1,2,6568,6293,12861,8,0.225,0.287235,0,0,0
8505079,Mittlerschwanden,,0.000071,27,2,1,3,6368,6643,13011,7,0.274194,0.348599,221,0,0
8508463,Weggis,,0.000022,27,2,3,5,4037,4573,8610,6,0.354167,0.481373,30.6,0,0
8505081,"Bisisthal, Dürrenboden",,0.000011,91,0,1,1,0,1767,1767,25,0.101669,0.135749,0,0,0
8505083,"Ried (Muotathal), Seilb.Illgau",,0.000011,91,0,2,2,0,15570,15570,25,0.102045,0.13874,0,0,0
8505087,"Lauerz, Dorf",,0.000016,91,1,3,4,11545,13545,25090,24,0.108583,0.150716,96.916667,0,0
8505082,"Brunnen, Seeschlössli",,0.000011,91,0,2,2,0,28018,28018,23,0.111298,0.15162,0,0,0
8505085,"Morschach, Dorf",,0.000011,91,0,1,1,0,16018,16018,26,0.097394,0.128629,0,0,0
8505094,"Schwyz, Bahnhof",,0.000037,91,4,7,11,49707,52568,102275,23,0.116426,0.177093,3392.047619,0,0
8505095,"Schwyz, Zentrum",,0.000037,91,4,17,21,74676,111151,185827,23,0.121204,0.203823,6337.834921,0,0
8505097,"Ingenbohl, Klosterstrasse",,0.000017,91,1,3,4,34435,34387,68822,26,0.102849,0.142509,391.166667,0,0
8505092,"Rickenbach SZ, Rotenfluebahn",,0.000029,91,3,2,5,8990,17398,26388,24,0.108906,0.157917,6737.813492,0,0
8505093,"Muotathal, Post",,0.000029,91,3,4,7,17396,17331,34727,24,0.112931,0.166272,917.185714,0,0
8577424,"Seewen SZ, Barcarola",,0.000024,91,2,1,3,11235,13190,24425,26,0.088869,0.11912,1203,0,0
8507319,"Muotathal, Schulhaus",,0.000017,91,1,1,2,1289,1289,2578,18,0.111597,0.156162,0,0,0
8577462,"Muotathal, Weid",,0.000065,91,1,1,2,15570,15570,31140,18,0.111597,0.156162,4100,0,0
8505098,"Brunnen, Bahnhof",,0.000036,91,5,6,11,57359,51704,109063,25,0.107649,0.157006,6748.664286,0,0
8505099,"Brunnen, See/Schiffstation",,0.000016,91,1,7,8,48642,43217,91859,25,0.10883,0.16315,321,0,0
8577221,"Vitznau, Station",,0.000057,91,3,7,10,23916,20153,44069,29,0.110179,0.199771,28108.666667,0,0
8577225,"Gersau, Wehri",,0.000058,91,3,5,8,27086,28223,55309,25,0.127561,0.214233,11184.066667,0,0
8505096,"Ibach, Erlen",,0.000021,91,3,3,6,28859,35396,64255,27,0.097578,0.134992,96.916667,0,0
8577398,"Arth-Goldau, Bahnhof",,0.000041,91,6,5,11,18296,38058,56354,33,0.095191,0.166445,22511.202381,0,0
8577408,"Arth, Dorf",,0.000031,91,2,4,6,35441,33161,68602,31,0.102235,0.17789,4675.9,0,0
8577409,"Arth, Am See",,0.000023,91,2,3,5,31762,33663,65425,30,0.10179,0.169603,2398.2,0,0
8577423,"Seewen SZ, Stelzli",,0.000064,91,1,6,7,35423,33043,68466,30,0.111388,0.202781,12508.783333,0,0
8577429,"Ibach, Eigenwies",,0.000013,91,1,1,2,14101,15788,29889,30,0.080481,0.121167,0,0,0
8507302,"Schindellegi, Zündi",,0.000013,91,1,1,2,3287,3287,6574,17,0.121655,0.155362,0,0,0
8573768,"Bennau, Moos",,0.000032,91,1,1,2,2212,2212,4424,17,0.121655,0.155362,1729,0,0
8577428,"Lauerz, Mühle",,0.00005,91,1,4,5,13532,13307,26839,22,0.131215,0.222354,496.933333,0,0
8577432,"Schwyz, Steisteg",,0.000036,91,1,6,7,29946,33193,63139,28,0.093545,0.171995,2939.416667,0,0
8577406,"Arth, Feld",,0.000026,91,1,4,5,31460,34428,65888,31,0.100546,0.16997,4452.633333,0,0
8577452,"Schwyz, Bierkeller",,0.000045,91,1,2,3,15570,15570,31140,17,0.135857,0.206742,562,0,0
8573770,"Biberbrugg, Bahnhof",,0.000054,91,1,4,5,9267,9191,18458,15,0.157303,0.235516,2316.813492,0,0
8577443,"Brunnen, Schiller",,0.000059,91,1,3,4,32946,32937,65883,19,0.137982,0.204476,7641,0,0
8577445,"Gersau, Kindli-Strandbad",,0.000034,91,1,3,4,28018,26812,54830,19,0.157712,0.242596,698,0,0
8577431,"Schwyz, Lücken",,0.000036,91,1,5,6,27969,27739,55708,28,0.083538,0.161104,2657,0,0
8587531,"Seewen SZ, Bienenheimstrasse",,0.000034,91,1,1,2,9803,13615,23418,12,0.193676,0.251442,1286,0,0
8592397,"Ibach, Kieswerk",,0.000043,91,1,2,3,4635,4672,9307,8,0.234043,0.318669,348,0,0
8592398,"Ibach, Landsgemeindestrasse",,0.000029,91,1,2,3,2330,2330,4660,8,0.230769,0.317971,5,0,0
8588237,"Rickenbach SZ, Bol",,0.000103,91,1,3,4,17095,16228,33323,6,0.315789,0.425,343,0,0
8588733,"Seewen SZ, Seewen Markt",,0.000081,91,5,2,7,26035,12008,38043,6,0.303571,0.391176,3710,0,0
8592402,"Ibach, Rest. Rose",,0.000049,91,1,3,4,4672,4672,9344,6,0.346154,0.462037,26.5,0,0
8592403,"Ibach, Schützenstrasse",,0.00004,91,1,1,2,5813,5813,11626,6,0.298246,0.361765,136,0,0
8592404,"Ibach, Studenmatt",,0.000046,91,2,2,4,4201,3497,7698,6,0.333333,0.430392,109.5,0,0
8592408,"Schwyz, Dorfbach",,0.000022,91,1,1,2,6024,6048,12072,6,0.298246,0.361765,17,0,0
8592412,"Schwyz, Hinterdorf",,0.000049,91,1,1,2,5813,5630,11443,3,0.444444,0.541667,311,0,0
8505671,"Gersau, Schiffstation",,0.000022,91,2,4,6,27580,29496,57076,26,0.127598,0.184561,1161.7,0,0
8577224,"Gersau, Förstli",,0.000044,91,1,1,2,18070,18070,36140,26,0.11365,0.167172,10476.2,0,0
8505665,"Küssnacht, Seilbahn",,0.000023,91,3,3,6,13999,26295,40294,28,0.100738,0.133408,3607.995238,0,0
8505666,"Gersau, Rotschuo",,0.000017,91,1,2,3,18070,18070,36140,28,0.111714,0.152351,112,0,0
8577435,"Ingenbohl, Gätzli",,0.000036,91,1,1,2,34387,32918,67305,25,0.081761,0.111467,1009,0,0
8505669,"Greppen, Oberhaus",,0.000032,91,4,3,7,22027,18903,40930,27,0.120266,0.171463,3619.380952,0,0
8505207,Bodio TI,,0.00004,28,1,1,2,8803,8803,17606,26,0.066511,0.107393,432,0,0
8505121,Intschi Seilbahn,,0.000011,93,0,1,1,0,7340,7340,20,0.096892,0.116415,0,0,0
8505122,Gurtnellen Wiler/Gotthardstr.,,0.00002,93,1,1,2,7340,7340,14680,19,0.106613,0.129805,158,0,0
8505138,Giebenach Oberdorf,,0.000013,2,1,1,2,159,159,318,14,0.132107,0.152058,3,0,0
8505146,Lehmattweg,,0.000011,2,0,1,1,0,173,173,9,0.206349,0.297741,0,0,0
8505147,Schule Schönthal,,0.00002,2,1,1,2,173,173,346,8,0.24,0.349504,12,0,0
8589401,Frenkendorf-Füllinsdorf Bhf,,0.000075,2,4,5,9,34629,65971,100600,7,0.317073,0.451648,1116.014286,0,0
8589404,Friedhofweg,,0.000024,2,1,3,4,22207,22207,44414,7,0.292683,0.466071,51,0,0
8505163,Realp,,0.000052,28,2,1,3,10345,10644,20989,15,0.131429,0.166397,1745,0,0
8505180,Acla da Fontauna,,0.000065,28,1,1,2,6488,6488,12976,13,0.170659,0.229099,513,0,0
8509000,Chur,,0.00009,28,5,13,18,26053,92456,118509,23,0.09399,0.161388,346748.45,0,0
8509178,Sumvitg-Cumpadials,,0.000056,28,1,1,2,9022,8992,18014,13,0.170659,0.229099,311,0,0
8505170,Nätschen,,0.000038,28,1,1,2,6348,6348,12696,22,0.073991,0.103025,3735,0,0
8505172,Oberalppass,,0.000043,28,1,1,2,6348,6348,12696,21,0.078692,0.107653,3385,0,0
8505173,Tschamut-Selva,,0.000047,28,1,1,2,6348,6348,12696,20,0.0841,0.113057,3033,0,0
8505174,Dieni,,0.000051,28,1,1,2,6348,8308,14656,19,0.090387,0.119475,2679,0,0
8505175,Rueras,,0.000054,28,1,1,2,8308,8308,16616,18,0.097792,0.12725,2323,0,0
8505176,Sedrun,,0.000057,28,1,1,2,8308,6488,14796,17,0.106643,0.136913,1965,0,0
8505177,Bugnei,,0.000059,28,1,1,2,6488,6488,12976,16,0.117417,0.149325,1605,0,0
8505178,Mumpé Tujetsch,,0.000061,28,1,1,2,6488,6488,12976,15,0.13082,0.166014,1243,0,0
8505179,Segnas,,0.000063,28,1,1,2,6488,6488,12976,14,0.147959,0.190053,879,0,0
8505202,Ambrì-Piotta,,0.00002,28,1,1,2,8803,8803,17606,29,0.056486,0.081979,1161,0,0
8505204,Faido,,0.000028,28,1,1,2,8803,8803,17606,28,0.059455,0.087993,920,0,0
8505205,Lavorgo,,0.000034,28,1,1,2,8803,8803,17606,27,0.062774,0.095957,677,0,0
8505213,Bellinzona,,0.000096,28,5,4,9,62220,65335,127555,24,0.075054,0.152477,54349,0,0
8505214,Giubiasco,,0.000031,28,1,7,8,51331,67297,118628,24,0.074919,0.165418,2548,0,0
8505219,Lamone-Cadempino,,0.000037,28,1,1,2,20933,21009,41942,26,0.064797,0.115508,402,0,0
8505404,Cadenazzo,,0.000064,28,5,3,8,39456,33871,73327,24,0.06573,0.110696,1196.5,0,0
8505401,Tenero,,0.000063,28,4,3,7,45847,45535,91382,24,0.066555,0.114298,1184,0,0
8505410,Gerra (Gambarogno),,0.000051,28,2,2,4,4031,3907,7938,23,0.067029,0.098804,171.5,0,0
8505412,Riazzino,,0.000041,28,2,1,3,35767,37834,73601,24,0.06289,0.08665,55.5,0,0
8505300,Lugano,,0.000067,28,3,6,9,53142,53395,106537,25,0.068769,0.15042,6228,0,0
8505307,Chiasso,,0.000048,28,3,4,7,50916,27212,78128,25,0.063684,0.11823,723.5,0,0
8505400,Locarno,,0.000034,28,3,1,4,44421,45059,89480,25,0.062893,0.096715,0,0,0
8505402,Gordola,,0.000029,28,1,2,3,38464,38464,76928,25,0.062203,0.098637,1,0,0
8505216,Rivera-Bironico,,0.000015,28,1,1,2,20962,20899,41861,29,0.055331,0.083284,1179,0,0
8505217,Mezzovico,,0.000023,28,1,1,2,20899,20979,41878,28,0.058145,0.090088,922,0,0
8505218,Taverne-Torricella,,0.000031,28,1,1,2,20979,20933,41912,27,0.06128,0.099762,663,0,0
8505221,"Rodi, Colonia Von Mentlen",,0.000011,108,0,6,6,0,19650,19650,29,0.106802,0.14779,0,0,0
8505222,"Giornico, Paese",,0.000012,108,1,1,2,12510,12397,24907,29,0.104852,0.135353,0,0,0
8505767,"Osco, Paese",,0.000011,108,0,1,1,0,4017,4017,29,0.104852,0.135353,0,0,0
8505972,"Piotta, Funicolare",,0.000012,108,1,2,3,1007,1109,2116,30,0.095421,0.122176,34.583333,0,0
8579527,"Rodi, Posta",,0.00004,108,3,3,6,16578,16569,33147,17,0.131868,0.19782,1423.5,0,0
8580131,"Faido, Casa per Anziani",,0.000114,108,3,5,8,23591,23527,47118,15,0.167866,0.272279,2271.333333,0,0
8580135,"Dalpe, Cornone",,0.000043,108,3,1,4,3318,3318,6636,21,0.084488,0.116729,0,0,0
8505951,"Arbedo, Molinazzo",,0.000036,108,2,3,5,14410,17116,31526,28,0.114121,0.155788,1257,0,0
8505973,"Faido, Posta",,0.000032,108,3,4,7,17800,24776,42576,28,0.116909,0.16437,1511.916667,0,0
8505995,"Piotta, Posta",,0.000025,108,2,3,5,16650,19408,36058,28,0.114104,0.156258,973.333333,0,0
8507634,"Biasca, Mulino Sciaroni",,0.00006,108,3,1,4,19042,19178,38220,28,0.111135,0.146653,8301.2,0,0
8575220,"Biasca, Parco Emma",,0.000075,108,1,1,2,16509,21335,37844,28,0.111135,0.146653,23475,0,0
8505226,Grindelwald Terminal,,0.000011,11,0,1,1,0,8169,8169,23,0.080214,0.13287,0,0,0
8507376,Grindelwald Grund,,0.000035,11,1,1,2,7998,9188,17186,23,0.080214,0.13287,70,0,0
8572654,"Zofingen, Ackerstrasse",,0.00011,94,6,1,7,18585,18490,37075,5,0.383333,0.428986,971.75,0,0
8572683,"Aarburg-Oftringen, Bahnhof",,0.000155,94,4,3,7,57185,53701,110886,5,0.394366,0.4625,3099,0,0
8572693,"Rothrist, Weier",,0.000053,94,1,2,3,10286,10286,20572,5,0.367089,0.427586,352,0,0
8572699,"Murgenthal, Gadligen",,0.000058,94,1,2,3,5173,5173,10346,5,0.403509,0.465217,115,0,0
8572705,"Vordemwald, Iselishof",,0.000036,94,1,2,3,20237,20237,40474,5,0.396825,0.454667,200,0,0
8572707,"Vordemwald, Rest. Tannenbaum",,0.000033,94,1,1,2,7401,7401,14802,5,0.383333,0.428986,23,0,0
8572727,"Brittnau-Wikon, Bahnhof",,0.000057,94,1,1,2,6825,6825,13650,5,0.383333,0.428986,414,0,0
8572729,"Reiden, Sonne",,0.000047,94,1,1,2,15101,15100,30201,5,0.383333,0.428986,126.5,0,0
8572740,"Brittnau, Lärchenweg",,0.000047,94,1,1,2,15255,15255,30510,5,0.383333,0.428986,126.5,0,0
8572743,"Zofingen, Industrie Brühl",,0.000039,94,1,1,2,3356,3356,6712,5,0.383333,0.428986,46,0,0
8505251,Acquacalda,,0.000011,108,0,1,1,0,643,643,32,0.082541,0.101014,0,0,0
8505257,Acquarossa-Comprovasco,,0.000034,108,1,4,5,12415,23027,35442,31,0.090691,0.117456,1293,0,0
8505252,"Malvaglia, Chiesa",,0.000011,108,0,1,1,0,12415,12415,33,0.075571,0.087746,0,0,0
8505253,"Malvaglia, Rongie",,0.00002,108,1,1,2,12415,12415,24830,32,0.081606,0.096923,571,0,0
8505254,Motto-Ludiano,,0.000028,108,1,3,4,12415,19317,31732,31,0.088702,0.109931,1140,0,0
8505262,"Olivone, Posta",,0.000027,108,2,4,6,12843,15720,28563,31,0.089803,0.116462,819,0,0
8505267,"Biasca, Vallone",,0.000051,108,2,3,5,19178,19178,38356,29,0.101895,0.130771,4723.7,0,0
8505255,"Dongio, Piazza",,0.000019,108,1,1,2,12415,12415,24830,33,0.077006,0.091226,165,0,0
8505256,"Corzoneso Piano, Bivio",,0.000027,108,1,1,2,12415,12415,24830,32,0.083284,0.101723,730,0,0
8505263,Loderio,,0.000032,108,3,2,5,19089,19178,38267,30,0.092934,0.115242,3166.7,0,0
8505266,Marogno,,0.000032,108,1,1,2,12415,12415,24830,30,0.092632,0.112837,528,0,0
8505265,"Malvaglia, Brugaio",,0.000024,108,1,1,2,12415,12415,24830,31,0.084925,0.100436,9,0,0
8505276,"Semione, Municipio",,0.000039,108,1,2,3,6902,6902,13804,29,0.100559,0.127746,1306.5,0,0
8505277,"Torre, Paese",,0.000043,108,1,2,3,12422,12422,24844,29,0.102453,0.12894,1184,0,0
8505268,"Aquila, Paese",,0.000031,108,2,1,3,12511,12422,24933,31,0.085314,0.100125,164,0,0
8505269,Lukmanier Passhöhe,,0.000017,108,1,2,3,643,1358,2001,12,0.172249,0.232497,227.4,0,0
8505272,"Campo (Blenio), Paese",,0.000017,108,1,1,2,2655,4888,7543,12,0.164804,0.218027,123.4,0,0
8578836,"Olivone, Municipio",,0.000061,108,1,2,3,12422,12422,24844,12,0.184375,0.255039,1944,0,0
8505270,"Ponto Valentino, Paese",,0.000018,108,1,1,2,5362,5362,10724,8,0.222222,0.339732,48,0,0
8505271,"Leontica, Chiesa",,0.000018,108,1,1,2,5370,4890,10260,10,0.181818,0.292897,60,0,0
8505274,Lottigna,,0.000037,108,1,1,2,12422,12422,24844,30,0.093094,0.112152,675,0,0
8505275,"Ludiano, Piazza Fiera",,0.000033,108,2,1,3,6902,6902,13804,30,0.09153,0.111125,796.5,0,0
8578852,"Loderio, Grotto",,0.000026,108,1,1,2,6763,6763,13526,12,0.160448,0.203729,88,0,0
8578830,"Acquarossa, Ospedale",,0.000039,108,1,2,3,12415,12415,24830,18,0.146067,0.218828,2131,0,0
8505301,Lugano-Paradiso,,0.00002,28,1,3,4,43917,43677,87594,27,0.060914,0.117677,2786,0,0
8505303,Maroggia-Melano,,0.000031,28,2,2,4,30455,30450,60905,27,0.060185,0.111539,2125,0,0
8505304,Capolago-Riva S. Vitale,,0.000024,28,1,3,4,30199,32244,62443,27,0.059861,0.114341,1604,0,0
8505305,Mendrisio,,0.000046,28,4,4,8,44843,79371,124214,26,0.061295,0.11574,1294.5,0,0
8505306,Balerna,,0.000021,28,1,1,2,29685,28814,58499,26,0.060336,0.097146,0,0,0
8505302,Melide,,0.000017,28,1,1,2,30204,30204,60408,28,0.05718,0.094886,0,0,0
8505367,Capolago Lago,,0.000018,28,1,1,2,286,286,572,3,0.5,0.611111,0,0,0
8505415,S. Antonino,,0.000128,28,6,2,8,40554,4100,44654,23,0.066505,0.095157,45093,0,0
8505322,"La Tzoumaz, Maison de la Forêt",,0.000011,122,0,1,1,0,318,318,14,0.128205,0.222326,0,0,0
8579499,"La Tzoumaz, Villy",,0.000011,122,0,1,1,0,1524,1524,14,0.128205,0.222326,0,0,0
8506875,"Marthalen, Bahnhof",,0.000052,66,3,5,8,14598,22510,37108,41,0.053033,0.099335,9301,0,0
8505349,"Schleinikon, Gemeindehaus",,0.000011,79,0,1,1,0,4097,4097,4,0.416667,0.516667,0,0,0
8505361,"Oberweningen, Im Hüebli",,0.00002,79,1,2,3,4097,4096,8193,3,0.571429,0.708333,4,0,0
8575115,"Oberweningen, Hüeblistrasse",,0.000034,79,1,1,2,2048,2048,4096,1,1,1,2,0,0
8505363,"Dietlikon, Mäenriet",,0.000011,107,0,1,1,0,33013,33013,19,0.147984,0.183484,0,0,0.008375
8576262,"Zürich, Zehntenhausplatz",,0.000035,107,3,3,6,66659,151780,218439,19,0.151987,0.193058,6425.385029,0.012794,0.059988
8580443,"Glattbrugg, Riethofstrasse",,0.000015,107,1,2,3,82522,82526,165048,16,0.156104,0.189798,7014.720968,0.000004,0.056417
8505372,S. Nicolao,,0.000033,28,2,1,3,2199,2199,4398,2,0.666667,0.75,806,0,0
8505373,Bellavista,,0.000039,28,1,1,2,2199,2199,4398,1,1,1,404,0,0
8505380,"Lugano, Stazione",,0.000011,102,0,3,3,0,114337,114337,35,0.111209,0.170239,0,0,0
8505386,"Canobbio, Stazione",,0.000014,102,1,6,7,35846,72225,108071,34,0.11604,0.181757,343.104762,0,0
8505913,"Lugano, Autosilo Balestra",,0.000077,102,7,5,12,83538,115926,199464,40,0.095296,0.159517,5622.608333,0,0
8507331,"Piodella, Zona Industriale",,0.000024,102,1,2,3,5800,18382,24182,42,0.086415,0.140618,333.078788,0,0
8510198,"Comano, Rotonda",,0.000013,102,1,2,3,18225,18225,36450,40,0.089751,0.139889,9.333333,0,0
8575358,"Sala Capriasca, Paese",,0.000049,102,1,1,2,27770,27770,55540,28,0.124371,0.159829,5399,0,0
8575310,"Lugano, Genzana",,0.000032,102,3,3,6,124089,122604,246693,40,0.09101,0.151697,1619.680808,0,0
8575343,"Comano, Studio TV",,0.000066,102,3,4,7,34204,34035,68239,39,0.101779,0.174416,4144.967388,0,0
8575346,"Cureglia, Bellavista",,0.000047,102,1,2,3,29202,29202,58404,39,0.09036,0.131981,460.45,0,0
8578994,"Sureggio, Paese",,0.00005,102,1,2,3,21459,21459,42918,13,0.168382,0.191605,1290.625,0,0
8507546,"Carnago, Rotonda",,0.000013,102,1,2,3,4355,5322,9677,31,0.102725,0.130916,10,0,0
8575336,"Manno, Boschetti",,0.000048,102,1,2,3,23107,22968,46075,35,0.112138,0.174019,4840.391667,0,0
8575351,"Origlio, Paese",,0.000061,102,2,1,3,16691,16646,33337,35,0.094384,0.121192,2004,0,0
8575359,"Tesserete, Paese",,0.000056,102,3,5,8,49084,48952,98036,27,0.141514,0.198491,5964.311905,0,0
8575470,"Sonvico, Stazione ARL",,0.000085,102,1,5,6,25730,25250,50980,11,0.239474,0.29134,8730.4,0,0
8577312,"Carnago, Arbustello",,0.000043,102,2,4,6,22328,21000,43328,11,0.215294,0.261454,2515.478571,0,0
8505390,Serocca,,0.000011,14,0,1,1,0,31021,31021,11,0.166667,0.274534,0,0,0
8505391,Lugano FLP,,0.00002,14,1,1,2,31021,31021,62042,10,0.181818,0.292897,10,0,0
8505392,Magliaso Paese,,0.000028,14,1,1,2,31021,31021,62042,9,0.2,0.31433,18,0,0
8505393,Cappella-Agnuzzo,,0.000035,14,1,1,2,31021,30895,61916,8,0.222222,0.339732,24,0,0
8505394,Bioggio,,0.00004,14,1,1,2,30895,31021,61916,7,0.25,0.370408,28,0,0
8505395,Agno,,0.000045,14,1,1,2,31021,31021,62042,6,0.285714,0.408333,30,0,0
8505396,Magliaso,,0.000049,14,1,1,2,31021,30958,61979,5,0.333333,0.456667,30,0,0
8505397,Caslano,,0.000053,14,1,1,2,30958,31021,61979,4,0.4,0.520833,28,0,0
8505398,Ponte Tresa,,0.000056,14,1,1,2,31021,31021,62042,3,0.5,0.611111,24,0,0
8505399,Sorengo,,0.000058,14,1,1,2,31021,31021,62042,2,0.666667,0.75,18,0,0
8505405,Quartino,,0.000053,28,3,1,4,4055,4104,8159,26,0.057558,0.08132,1636,0,0
8505406,Magadino-Vira,,0.000056,28,1,1,2,4104,4104,8208,25,0.060542,0.086893,1341,0,0
8505407,S. Nazzaro,,0.000059,28,1,2,3,4104,4104,8208,24,0.063878,0.096915,1044,0,0
8505408,Ranzo-S. Abbondio,,0.000036,28,1,2,3,4042,4041,8083,23,0.067511,0.100898,163.5,0,0
8507263,"Yverdon, Y-Parc/Découvertes",,0.00002,35,2,2,4,18995,18994,37989,8,0.23494,0.302228,70.07381,0,0
8505430,"Perlen (Root), Holzplatz",,0.000011,90,0,1,1,0,15436,15436,43,0.071059,0.107075,0,0,0
8573055,Luzern Luzernerhof,,0.000019,90,1,6,7,287379,287498,574877,43,0.080645,0.152656,16389.767949,0,0
8505433,Fischrainweg,,0.000011,44,0,1,1,0,2102,2102,21,0.072933,0.084409,0,0,0
8505434,Altikofen Nord,,0.00002,44,1,1,2,2102,2103,4205,20,0.078332,0.090645,231,0,0
8505435,Altikofen West,,0.000028,44,1,1,2,2103,2103,4206,19,0.084621,0.098233,460,0,0
8505436,Altikofen Süd,,0.000035,44,1,1,2,2103,2103,4206,18,0.092042,0.107735,687,0,0
8505437,Babimoosweg,,0.00004,44,1,1,2,2103,2103,4206,17,0.10093,0.120149,912,0,0
8505438,Talweg,,0.000045,44,1,1,2,2103,2103,4206,16,0.111768,0.137585,1135,0,0
8508075,Breitenrain,,0.000022,44,2,8,10,33948,37498,71446,24,0.143871,0.200426,53189.733333,0,0
8576982,"Steinibach, Bahnhof",,0.000036,44,1,4,5,8676,8676,17352,16,0.113569,0.151797,6247,0,0
8505443,"Schwarzenegg, Dürren",,0.000011,43,0,1,1,0,480,480,26,0.129446,0.156274,0,0,0
8505444,"Eriz, Moosboden",,0.00002,43,1,2,3,480,480,960,25,0.148387,0.191613,483,0,0
8505932,"Heiligenschwendi, Hünibode",,0.000011,43,0,1,1,0,1859,1859,25,0.148114,0.189197,0,0,0
8507174,"Oberhofen, Dorf",,0.000023,43,1,6,7,6501,7371,13872,18,0.161047,0.208581,957,0,0
8507176,"Gunten, Dorf",,0.00002,43,2,3,5,4015,4313,8328,25,0.149861,0.194583,497,0,0
8507177,"Merligen, Beatus",,0.000017,43,1,2,3,2096,2096,4192,25,0.148591,0.19151,10,0,0
8507178,Beatenbucht,,0.000018,43,1,2,3,1797,1797,3594,25,0.148375,0.190872,6,0,0
8507179,"Sundlauenen, Dorf",,0.000019,43,1,1,2,779,779,1558,25,0.148114,0.189197,0,0,0
8507401,"Steffisburg, Flühli",,0.000027,43,2,3,5,6807,6808,13615,28,0.125272,0.164975,429,0,0
8505448,"Meilen, Friedhof",,0.000011,8,0,1,1,0,6043,6043,16,0.142857,0.205376,0,0,0
8576029,"Männedorf, Bahnhof",,0.000047,84,1,4,5,16202,17261,33463,16,0.178082,0.270614,1008.5,0,0
8505451,"Porto Ronco, Crodolo Verbano",,0.000011,101,0,1,1,0,13747,13747,34,0.077956,0.092127,0,0,0
8505453,"Losone, Posta",,0.000011,101,0,2,2,0,49900,49900,33,0.084927,0.109589,0,0,0
8505454,"Arcegno, Chiesa",,0.000016,101,1,1,2,9753,9753,19506,36,0.068299,0.081412,4,0,0
8505455,"Gruppaldo, Cappella",,0.000024,101,1,1,2,9753,9753,19506,35,0.073156,0.088837,493,0,0
8505456,Livurcio,,0.000031,101,1,1,2,9753,9753,19506,34,0.078769,0.098317,980,0,0
8505458,"Contra, Paese",,0.000011,101,0,2,2,0,17797,17797,65,0.049048,0.078869,0,0,0
8505459,"Brione s. Minusio, B. Val Resa",,0.000016,101,1,1,2,6331,6526,12857,64,0.050572,0.082464,690,0,0
8505858,"Locarno, Monti della Trinità",,0.000011,101,0,2,2,0,17493,17493,62,0.0562,0.105649,0,0,0
8505467,S. Martino,,0.000011,15,0,1,1,0,10231,10231,11,0.168831,0.239867,0,0,0
8505470,Locarno FART,,0.00002,15,1,2,3,10231,14380,24611,10,0.195312,0.299048,25,0,0
8505471,Locarno S. Antonio,,0.000019,15,1,2,3,13672,13672,27344,10,0.190476,0.290675,2,0,0
8505472,Solduno,,0.000019,15,1,1,2,8205,8205,16410,10,0.184,0.259834,0,0,0
8505473,Ponte Brolla,,0.000044,15,3,2,5,14380,14380,28760,9,0.215686,0.329888,88,0,0
8505493,Cavigliano,,0.000042,15,1,1,2,10732,10230,20962,9,0.197917,0.285485,38,0,0
8505474,"Avegno, Paese",,0.000011,101,0,1,1,0,17582,17582,44,0.0454,0.052137,0,0,0
8505475,Gordevio,,0.00002,101,1,1,2,17582,17582,35164,43,0.04747,0.054537,531,0,0
8505477,Aurigeno-Moghegno,,0.000028,101,1,1,2,17582,17582,35164,42,0.049742,0.057226,1060,0,0
8505478,"Maggia, Centro",,0.000035,101,1,1,2,17582,17582,35164,41,0.052247,0.060266,1587,0,0
8505479,Lodano,,0.00004,101,1,1,2,17582,17582,35164,40,0.055023,0.063736,2112,0,0
8505481,Coglio,,0.000045,101,1,1,2,17582,17582,35164,39,0.058116,0.067745,2635,0,0
8505482,Someo,,0.000049,101,1,1,2,17582,17582,35164,38,0.061585,0.072448,3156,0,0
8505483,"Riveo, Paese",,0.000053,101,1,1,2,17582,17582,35164,37,0.065502,0.078079,3675,0,0
8505484,"Cevio, Centro",,0.000056,101,1,1,2,17582,17582,35164,36,0.06996,0.085029,4192,0,0
8505485,"Cevio, Residenza Betulle",,0.000058,101,1,1,2,17582,17582,35164,35,0.075079,0.094067,4707,0,0
8505486,"Bignasco, Posta",,0.00006,101,1,4,5,17582,22436,40018,34,0.081018,0.107557,5220,0,0
8505487,"Ronchini, Paese",,0.000024,101,1,1,2,17582,17582,35164,34,0.08059,0.102398,0,0,0
8505763,"S. Carlo (Bavona), Funivia",,0.000024,101,1,1,2,1227,1227,2454,34,0.08059,0.102398,0,0,0
8505784,"Fusio, Paese",,0.000024,101,1,1,2,2439,2439,4878,34,0.08059,0.102398,0,0,0
8505491,Tegna,,0.00003,15,1,1,2,10732,10732,21464,11,0.153285,0.219994,10,0,0
8505492,Verscio,,0.000036,15,1,1,2,10732,10732,21464,10,0.172414,0.244643,25,0,0
8505494,Intragna,,0.000065,15,2,3,5,13878,10145,24023,8,0.233766,0.379828,144,0,0
8505495,Corcapolo,,0.000029,15,1,1,2,6746,6731,13477,9,0.188889,0.274953,0,0,0
8505496,Verdasio,,0.000054,15,2,2,4,7621,6633,14254,8,0.219178,0.343973,34,0,0
8505497,Palagnedra,,0.000034,15,1,2,3,5713,5567,11280,8,0.211268,0.333571,11,0,0
8505498,Borgnone-Cadanza,,0.000025,15,1,1,2,4978,4978,9956,8,0.2,0.285969,0,0,0
8505499,Camedo,,0.000088,15,4,2,6,8996,4104,13100,7,0.232143,0.348168,169,0,0
8505578,Zornasco,,0.000048,15,1,1,2,986,986,1972,7,0.218182,0.293849,0,0,0
8506907,"Bussigny, Jordil",,0.000024,5,1,1,2,12192,12193,24385,9,0.177852,0.215034,53,0,0
8581114,"Penthalaz, Verney",,0.000048,5,3,2,5,9932,10043,19975,9,0.182724,0.234488,1822.166667,0,0
8505530,"Servion, Moléson",,0.000022,13,1,1,2,3656,3817,7473,25,0.07988,0.089963,2888.616667,0,0
8570419,"Les Cullayes, Pra la Tête",,0.000045,13,2,1,3,6153,6265,12418,25,0.07988,0.089963,5793.283333,0,0
8506568,"Wäldi, Dorfplatz",,0.00003,65,1,1,2,4614,4614,9228,53,0.036967,0.046841,1741,0,0
8505561,"Viganello, S. Siro",,0.000012,102,1,6,7,14026,85467,99493,41,0.08851,0.149498,99.452381,0,0
8575245,"Lugano, Piazza Rezzonico",,0.000042,102,4,6,10,79757,132076,211833,41,0.092529,0.162138,2884.17197,0,0
8591580,"Albonago, Sentiero Castagni",,0.000029,102,1,1,2,12075,12075,24150,9,0.217687,0.266605,64,0,0
8510199,"Pregassona, Ronco Villa",,0.000013,102,1,1,2,4084,4094,8178,3,0.5,0.611111,0,0,0
8505563,"Pregassona, Paese",,0.000013,102,1,1,2,20433,20433,40866,16,0.105559,0.118004,29,0,0
8505565,Soragno,,0.000022,102,1,1,2,20433,19938,40371,15,0.117389,0.131562,212,0,0
8505566,"Davesco, Paese",,0.000029,102,1,1,2,19938,20433,40371,14,0.13229,0.149905,393,0,0
8505567,"Cadro, Paese",,0.000036,102,1,2,3,20433,24563,44996,13,0.151639,0.177452,572,0,0
8579000,"Massagno, Sassa",,0.000034,102,2,5,7,58523,44950,103473,11,0.245739,0.300234,1767.643223,0,0
8579005,"Canobbio, Corba",,0.000025,102,1,4,5,16680,16692,33372,11,0.233038,0.285865,195.64127,0,0
8579009,"Lugano, Cappuccine",,0.000157,102,12,11,23,114935,115681,230616,10,0.282883,0.361733,21552.866098,0,0
8505568,Dino,,0.000026,102,1,1,2,19966,19966,39932,13,0.163265,0.180909,374.4,0,0
8575468,"Sonvico, Rosone",,0.000063,102,1,1,2,5764,5764,11528,13,0.163265,0.180909,8088,0,0
8505580,Re,,0.00009,15,2,1,3,4104,4119,8223,6,0.255814,0.327273,165,0,0
8505581,S. Maria Maggiore,,0.000087,15,1,1,2,4119,4119,8238,5,0.3125,0.378333,160,0,0
8505584,Malesco,,0.000085,15,1,1,2,4119,4119,8238,4,0.409091,0.472222,153,0,0
8505585,Druogno,,0.000083,15,1,4,5,4119,4119,8238,3,0.615385,0.729167,144,0,0
8505588,Creggio,,0.000029,15,1,2,3,690,690,1380,4,0.4375,0.559524,0,0,0
8505589,Folsogno-Dissimo,,0.000041,15,2,1,3,691,691,1382,4,0.4,0.486111,0,0,0
8505590,Gagnone-Orcesco,,0.000075,15,3,2,5,1221,1221,2442,3,0.555556,0.666667,29,0,0
8505592,Marone,,0.000043,15,1,1,2,236,236,472,3,0.5,0.583333,0,0,0
8505593,Masera,,0.000097,15,3,2,5,4119,4119,8238,2,0.75,0.833333,69,0,0
8505594,Prestinone,,0.000052,15,1,1,2,1207,1207,2414,2,0.666667,0.75,0,0,0
8505597,Trontano,,0.000096,15,2,1,3,4119,926,5045,1,1,1,25,0,0
8505600,"Alpe di Neggia, Alpe",,0.000011,108,0,1,1,0,2528,2528,69,0.038773,0.05368,0,0,0
8505601,"Monti di Fosano, Bv. Piazzogna",,0.00002,108,1,1,2,2528,2528,5056,68,0.040285,0.057199,769,0,0
8505602,"Alpe di Neggia, Bv. Trecciura",,0.000028,108,1,1,2,2528,2528,5056,67,0.041921,0.061574,1536,0,0
8505604,"Minusio, Esplanade",,0.000011,101,0,1,1,0,46869,46869,35,0.072751,0.08681,0,0,0
8505606,Fosano,,0.000035,108,1,2,3,2528,5387,7915,66,0.043699,0.067611,2301,0,0
8505607,"Indemini, Isolabella",,0.000026,108,1,1,2,2528,2528,5056,66,0.043644,0.066394,0,0,0
8505608,"Magadino, Casa Comunale",,0.000047,108,2,4,6,5387,29258,34645,65,0.045576,0.0746,3825,0,0
8505612,"Indemini, Monti",,0.000029,108,1,1,2,2528,2528,5056,65,0.045314,0.069212,761,0,0
8505909,"Piazzogna, Paese",,0.000035,108,2,2,4,12714,12478,25192,29,0.056139,0.097102,319.5,0,0
8505609,"Magadino, Superiore",,0.000021,108,1,1,2,13966,13966,27932,65,0.04526,0.068645,6,0,0
8505610,"Minusio, Piazza",,0.00002,101,1,2,3,46869,46869,93738,34,0.078303,0.096537,502,0,0
8505611,"Monti di Fosano, Monti",,0.000021,108,1,1,2,2528,2528,5056,66,0.043404,0.063631,6,0,0
8505613,"Quartino, Chiesa",,0.000029,108,1,1,2,13966,13966,27932,64,0.047343,0.075751,759,0,0
8505614,Scesana,,0.000045,108,2,2,4,13449,13213,26662,64,0.047402,0.076968,6050,0,0
8505615,"Vairano, Paese",,0.00003,108,1,1,2,12478,12478,24956,64,0.047343,0.075751,0,0,0
8505616,"Vira (Gambarogno), Paese",,0.00008,108,3,5,8,27179,27415,54594,63,0.04963,0.086816,9066,0,0
8505871,"Indemini, Paese",,0.000025,108,1,2,3,2528,2528,5056,29,0.056406,0.097599,279.5,0,0
8507325,"Camorino, Busciurina",,0.000014,108,1,2,3,30462,36141,66603,61,0.053158,0.091349,240.5,0,0
8507336,"Cadenazzo, Ruscadella",,0.000025,108,1,3,4,10835,16192,27027,63,0.048905,0.082935,529.75,0,0
8507338,"S. Antonino, Stazione",,0.000037,108,3,4,7,13070,31008,44078,62,0.050883,0.088315,9358.083333,0,0
8505617,"Rovio, Paese",,0.000011,99,0,1,1,0,8838,8838,27,0.052183,0.07394,0,0,0
8505618,"Rovio, Ala Materna",,0.00002,99,1,1,2,8838,8838,17676,26,0.054526,0.076413,103,0,0
8505619,"Rovio, Selvone",,0.000028,99,1,1,2,8838,8838,17676,25,0.057111,0.07928,204,0,0
8505622,"Arogno, S. Michele",,0.000035,99,1,1,2,8838,8838,17676,24,0.059976,0.082752,303,0,0
8505623,"Gordola, Scalate",,0.000019,101,1,1,2,4815,8355,13170,55,0.031089,0.037028,46,0,0
8505624,"Gordola, Gordemo",,0.000027,101,1,1,2,8355,8355,16710,54,0.032022,0.037981,538,0,0
8505625,"Gordola, Diga Verzasca",,0.000034,101,1,1,2,8355,8355,16710,53,0.033014,0.039,1028,0,0
8505626,"Berzona (Verzasca), Paese",,0.00004,101,1,1,2,8355,8355,16710,52,0.034072,0.040094,1516,0,0
8505627,"Vogorno, Paese",,0.000045,101,1,1,2,8355,8355,16710,51,0.035202,0.041271,2002,0,0
8505628,"Vogorno, S. Bartolomeo",,0.000049,101,1,1,2,8355,8355,16710,50,0.036412,0.04254,2486,0,0
8505629,"Corippo, Bivio",,0.000053,101,1,1,2,8355,8355,16710,49,0.037711,0.043914,2968,0,0
8505630,"Lavertezzo, ai Poss",,0.000056,101,1,1,2,8355,8355,16710,48,0.039109,0.045406,3448,0,0
8505631,"Lavertezzo, Aquino",,0.000058,101,1,1,2,8355,8355,16710,47,0.040617,0.047032,3926,0,0
8505632,"Brione (Verzasca), Motta",,0.00006,101,1,1,2,8355,8355,16710,46,0.04225,0.048813,4402,0,0
8505633,"Brione (Verzasca), Ganne",,0.000062,101,1,1,2,8355,8355,16710,45,0.044023,0.050771,4876,0,0
8505634,"Brione (Verzasca), Piee",,0.000064,101,1,1,2,8355,8355,16710,44,0.045955,0.052935,5348,0,0
8505635,"Brione (Verzasca), Paese",,0.000065,101,1,1,2,8355,8355,16710,43,0.048069,0.055342,5818,0,0
8505636,"Brione (Verzasca), Alnasca",,0.000066,101,1,1,2,8355,8355,16710,42,0.050392,0.058037,6286,0,0
8505637,"Gerra(Verzasca),Prato Maggiore",,0.000067,101,1,1,2,8355,8355,16710,41,0.052956,0.061076,6752,0,0
8505638,"Gerra (Verzasca), Paese",,0.000068,101,1,1,2,8355,8355,16710,40,0.055801,0.064534,7216,0,0
8505639,"Gerra (Verzasca), Croce",,0.000069,101,1,1,2,8355,8355,16710,39,0.058976,0.068511,7678,0,0
8505640,"Frasco, Paese",,0.000069,101,1,1,2,8355,8355,16710,38,0.062541,0.07314,8138,0,0
8505641,"Frasco, Cantone",,0.00007,101,1,1,2,8355,8355,16710,37,0.066574,0.078614,8596,0,0
8505642,"Tenero, Chiesa",,0.000016,101,1,1,2,11466,11466,22932,37,0.063915,0.073755,27,0,0
8505643,"Tenero, Fraccia",,0.000024,101,1,1,2,11466,11466,22932,36,0.068136,0.079272,502,0,0
8505644,"Minusio, Mondacce",,0.000031,101,1,1,2,11466,11466,22932,35,0.072965,0.085917,975,0,0
8505645,"Contra, Moresio",,0.000038,101,1,1,2,11466,11466,22932,34,0.078542,0.094136,1446,0,0
8505646,"Contra, di Sotto",,0.000043,101,1,1,2,11466,11466,22932,33,0.085057,0.104698,1915,0,0
8505648,"Tenero, Posta",,0.000047,101,1,1,2,11466,11466,22932,32,0.092767,0.119172,2382,0,0
8508245,"Losone, Sottochiesa",,0.000041,101,1,1,2,40786,42054,82840,32,0.092767,0.119172,260,0,0
8575176,"Tenero, Piazza",,0.000145,101,3,2,5,38009,38009,76018,32,0.098539,0.139703,18708.6,0,0
8505649,"Gordola, Posta",,0.00007,101,1,1,2,8355,8355,16710,36,0.071172,0.085215,9052,0,0
8505657,"Altdorf UR, Post",,0.000011,93,0,1,1,0,948,948,23,0.088542,0.113725,0,0,0
8505658,Bürglen Brügg,,0.000011,93,0,2,2,0,24046,24046,19,0.122329,0.158594,0,0,0
8505659,Bürglen Loreto,,0.000016,93,1,3,4,23892,24276,48168,18,0.136139,0.18218,144,0,0
8505668,Attinghausen Seilbahn,,0.000015,93,1,2,3,11134,12558,23692,18,0.141002,0.190524,156.933333,0,0
8505774,"Unterschächen, Post",,0.000046,93,1,3,4,1913,1912,3825,18,0.123408,0.165481,603.32381,0,0
8505775,Urigen,,0.000024,93,1,2,3,850,851,1701,18,0.117827,0.151659,4,0,0
8505880,"Urnerboden, Klus",,0.000048,93,1,2,3,384,384,768,18,0.12709,0.166183,802.17619,0,0
8505660,"Bürglen UR, Trudelingen",,0.00002,93,2,1,3,1913,1913,3826,21,0.094548,0.120383,40,0,0
8505661,"Spiringen, Witerschwanden",,0.000028,93,1,3,4,1913,1913,3826,20,0.10378,0.14125,200,0,0
8505741,"Linthal, Stichplattenkehre",,0.00004,93,1,1,2,384,384,768,21,0.097411,0.120557,474,0,0
8505752,Balm (Klausen),,0.000052,93,2,2,4,627,627,1254,20,0.10724,0.138355,710.342857,0,0
8505662,"Bosco Luganese, Bassa",,0.000011,81,0,1,1,0,8218,8218,42,0.087857,0.115862,0,0,0
8508678,"Schwarzenberg LU, Ennenmatt",,0.000051,90,1,2,3,4388,4388,8776,49,0.06192,0.096723,3444,0,0
8505664,Silenen Dägerlohn,,0.000028,93,1,1,2,7340,22368,29708,18,0.11858,0.148442,314,0,0
8577177,"Root D4, Oberfeld",,0.000066,90,2,3,5,45631,45627,91258,37,0.089689,0.137418,46262.495238,0,0
8577197,Meggen Gottlieben,,0.000028,90,1,3,4,22711,22709,45420,37,0.084306,0.156106,3719,0,0
8505667,Amsteg Post,,0.000035,93,1,2,3,22368,23804,46172,17,0.133676,0.177931,468,0,0
8505890,Bürglen Dorf,,0.000065,93,5,1,6,24260,24276,48536,17,0.131076,0.168701,1207.057143,0,0
8573089,Altdorf Allmend,,0.000035,93,1,1,2,17125,17131,34256,20,0.12274,0.174472,390.480952,0,0
8505670,"Weggis, Schiffstation",,0.000011,91,0,2,2,0,4495,4495,11,0.222222,0.317979,0,0,0
8587532,"Steinen, Bahnhof",,0.00005,91,4,4,8,14339,14371,28710,11,0.235294,0.342478,2342.035714,0,0
8587582,"Küssnacht, Plaza",,0.00006,91,5,4,9,23860,24835,48695,11,0.239796,0.347105,3810.35,0,0
8588117,"Steinen, Hausmatt",,0.000048,91,1,2,3,13593,13562,27155,11,0.21978,0.305973,192.733333,0,0
8588119,"Schwyz, Engiberg",,0.000056,91,1,4,5,13643,13501,27144,11,0.238994,0.363274,786.666667,0,0
8588121,"Schwyz, Eglismatt",,0.00003,91,1,3,4,3783,3703,7486,11,0.230769,0.341789,36,0,0
8588807,"Weggis, Seilbahn",,0.000073,91,6,4,10,11643,11982,23625,11,0.228758,0.351554,4987.883333,0,0
8588906,"Arth, Klostermatt",,0.000149,91,11,3,14,38291,12018,50309,11,0.226027,0.337507,3031.238095,0,0
8589203,"Rotkreuz, Birkenstrasse",,0.000044,91,2,2,4,4820,3777,8597,11,0.21374,0.316229,2692.183333,0,0
8588626,"Rotkreuz, Bahnhof Nord",,0.000041,91,3,2,5,4672,4865,9537,12,0.192513,0.276621,7686.45,0,0
8577219,"Vitznau, Unterwilen",,0.000061,91,1,2,3,20182,20182,40364,30,0.100151,0.158179,33331,0,0
8577220,"Vitznau, Park Hotel",,0.000037,91,1,2,3,18769,18769,37538,29,0.10275,0.160806,5326.1,0,0
8505679,"Vissoie, Les Barmes",,0.000014,39,1,1,2,2498,2173,4671,9,0.157895,0.236746,258,0,0
8505693,"Zinal, Pralong",,0.000029,39,1,1,2,302,302,604,5,0.317073,0.383333,13,0,0
8505695,"St-Jean VS, village",,0.000036,39,1,2,3,2542,2542,5084,5,0.325,0.421795,14.833333,0,0
8505681,"Sierre, Chapelle St-Antoine",,0.000023,39,1,1,2,2173,2173,4346,8,0.175,0.252806,229,0,0
8505686,"Chippis, Eaux-Vives",,0.000029,39,2,4,6,10293,10492,20785,19,0.118658,0.173755,1233.5,0,0
8505694,"Réchy, village",,0.000017,39,1,3,4,7723,7723,15446,21,0.096192,0.131481,141,0,0
8509553,"Grône, Loos",,0.000036,39,1,1,2,7184,7184,14368,20,0.10355,0.13017,280,0,0
8570942,"Brie, Chalais",,0.000022,39,2,1,3,1064,1049,2113,20,0.10355,0.13017,140,0,0
8570944,"Sierre, TechnoArk",,0.000066,39,3,1,4,10278,10293,20571,19,0.114686,0.15008,695,0,0
8505687,Fang,,0.00003,39,1,1,2,2173,2337,4510,7,0.19697,0.272711,198,0,0
8505688,"Vissoie, Mayoux-village",,0.000029,39,2,1,3,2542,2542,5084,6,0.259259,0.328571,8.833333,0,0
8505690,Mottec,,0.000022,39,1,1,2,302,302,604,6,0.254545,0.316667,7,0,0
8505691,"Niouc, village",,0.000037,39,1,1,2,2337,2337,4674,6,0.226415,0.298611,165,0,0
8505692,Les Pontis,,0.000042,39,1,1,2,2337,2173,4510,5,0.268293,0.334848,130,0,0
8509551,"St-Léonard, Sous Gare",,0.000016,39,1,1,2,415,415,830,22,0.08685,0.106369,0,0,0
8505697,"Grimentz, Torrent",,0.000062,39,3,3,6,747,747,1494,4,0.428571,0.541667,118.166667,0,0
8505696,"Sierre, Sentier de Chippis",,0.000047,39,1,1,2,2173,2173,4346,4,0.333333,0.391667,93,0,0
8510008,"Zinal, Les Plats de la Lé",,0.000028,39,1,1,2,302,302,604,4,0.384615,0.45,0,0,0
8570948,"Grimentz, Roua",,0.000043,39,2,1,3,2542,2468,5010,4,0.384615,0.45,10,0,0
8505699,"Linthal, Bergli",,0.000019,93,1,1,2,143,384,527,24,0.076594,0.092684,12,0,0
8505701,"Simplon Dorf, Hospiz-Niederalp",,0.000034,40,1,1,2,1615,1615,3230,18,0.117188,0.151908,438,0,0
8505704,"Berisal, Kehr",,0.00004,40,1,1,2,1615,1615,3230,17,0.130531,0.169933,307,0,0
8571135,"Visp, Arena",,0.000045,40,2,4,6,5084,5042,10126,11,0.215311,0.324101,2008.178788,0,0
8505710,"Törbel, Brunnen",,0.000038,40,1,1,2,3085,3142,6227,20,0.09127,0.165772,93,0,0
8505713,Gabi (Simplon),,0.000065,40,2,2,4,1665,1620,3285,15,0.170149,0.243616,10203,0,0
8571180,"Simplon Dorf, Eggen",,0.000069,40,1,1,2,1615,1615,3230,11,0.195349,0.251617,588,0,0
8505716,"Brig, Geschina",,0.000038,40,1,1,2,1570,1615,3185,25,0.061674,0.097872,2716,0,0
8505727,"Ried-Brig, Chavez",,0.000043,40,1,1,2,1615,1615,3230,24,0.064554,0.100661,2577,0,0
8505729,"Ried-Brig, Rufigraben",,0.000048,40,1,1,2,1615,1615,3230,23,0.067754,0.103739,2436,0,0
8505730,Schallberg,,0.000052,40,1,1,2,1615,1615,3230,22,0.071332,0.107164,2293,0,0
8505731,Schallbett,,0.000055,40,1,1,2,1615,1615,3230,21,0.075362,0.111012,2148,0,0
8505733,"Brig, Stützen",,0.000057,40,1,1,2,1615,1615,3230,20,0.079937,0.115381,2001,0,0
8505737,"Saas-Almagell, Zermeiggern",,0.000028,41,2,4,6,1627,1597,3224,4,0.5,0.628788,31.333333,0,0
8557032,"Saas-Grund, Parkplatz Bergbahn",,0.000024,41,2,1,3,1739,1739,3478,7,0.212766,0.306905,0,0,0
8571195,"Saas-Grund, untere Brücke",,0.000053,41,1,1,2,5327,5327,10654,4,0.35,0.428571,21,0,0
8571197,"Saas-Almagell, Lehn",,0.000063,41,1,3,4,5332,5330,10662,2,0.714286,0.8,30,0,0
8505738,"Eisten, Ganter",,0.00006,40,1,1,2,1615,1615,3230,19,0.085179,0.120403,1852,0,0
8505739,"Linthal, Kantonsgrenze",,0.000027,93,1,1,2,384,384,768,23,0.082432,0.099801,168,0,0
8505740,"Linthal, Frittern",,0.000034,93,1,1,2,384,384,768,22,0.089276,0.108735,322,0,0
8505742,"Ernen, Wasen-Zauberwald",,0.000017,16,1,1,2,1789,1789,3578,8,0.208955,0.284099,4,0,0
8505743,"Ausserbinn, Dorfplatz",,0.000025,16,1,1,2,1789,1789,3578,7,0.245283,0.326374,15,0,0
8505747,"Ernen, Niederernen",,0.00003,16,2,2,4,2827,2827,5654,5,0.34375,0.45,29.5,0,0
8505745,"Mühlebach (Goms), Dorf",,0.000017,16,1,2,3,1560,1558,3118,3,0.555556,0.666667,10,0,0
8505748,"Steinhaus, Dorfplatz",,0.000026,16,1,1,2,1366,1366,2732,3,0.5,0.611111,3,0,0
8505746,"Mühlebach (Goms), Ernergalen",,0.000018,16,1,1,2,1380,1366,2746,4,0.4,0.520833,3,0,0
8505749,Steinmatten,,0.000037,16,2,2,4,1789,1789,3578,5,0.357143,0.47,27,0,0
8578897,"Fiesch, Abzw. Feriendorf",,0.00004,16,2,2,4,2827,2827,5654,4,0.428571,0.527778,37.5,0,0
8505751,"Astano, Paese",,0.000011,81,0,2,2,0,8056,8056,41,0.094529,0.130315,0,0,0
8505755,"Cademario, Kurhaus",,0.00002,81,1,3,4,8218,20677,28895,41,0.096128,0.135746,504,0,0
8505765,"Novaggio, Posta",,0.000021,81,2,5,7,12732,32004,44736,40,0.103852,0.153745,1434.866667,0,0
8505754,Belvedere Furka,,0.000026,108,2,2,4,384,384,768,18,0.126984,0.193682,120,0,0
8505760,Galenstock (Furka),,0.00003,108,1,1,2,257,257,514,18,0.123752,0.175737,62,0,0
8505756,"Cademario, Posta",,0.000017,81,1,1,2,8218,8218,16436,44,0.073015,0.088778,6,0,0
8505758,"Figino, Posta",,0.000014,102,1,1,2,9298,9435,18733,42,0.081457,0.117485,15,0,0
8505759,"Furkapass, Hotel Furkablick",,0.000022,108,1,1,2,257,257,514,19,0.111702,0.153354,3,0,0
8505762,"Meien, Aderbogen",,0.000011,114,0,1,1,0,254,254,25,0.08384,0.102237,0,0,0
8505764,"Neggio, Paese",,0.000017,81,1,2,3,7534,9693,17227,44,0.074238,0.094063,20,0,0
8505788,"Cimo, Paese",,0.000018,81,1,3,4,2856,5745,8601,43,0.080013,0.104962,263,0,0
8505781,"Pura, Paese",,0.000015,81,1,2,3,16051,16601,32652,40,0.096173,0.134796,3.9,0,0
8505787,"Breno, Paese",,0.000021,81,2,4,6,8236,8560,16796,39,0.104998,0.157428,703.538889,0,0
8505789,"Curio, Paese",,0.000021,81,2,3,5,16552,16097,32649,40,0.101572,0.147941,170.594444,0,0
8505768,"Rossa, Villaggio",,0.000011,17,0,2,2,0,2138,2138,12,0.163265,0.230813,0,0,0
8505875,"Castaneda, Tevegno",,0.000016,17,1,3,4,2009,5195,7204,11,0.186508,0.273337,41,0,0
8505770,"Serpiano, Albergo",,0.000011,99,0,1,1,0,568,568,25,0.134169,0.175504,0,0,0
8505924,"Rancate, Cantone",,0.000035,99,1,1,2,11311,11311,22622,25,0.134169,0.175504,642,0,0
8505994,"Ligornetto, Posta",,0.000016,99,1,2,3,16060,22369,38429,25,0.136741,0.185992,196.75,0,0
8505771,Sonogno,,0.000071,101,1,1,2,8355,8355,16710,35,0.076465,0.093382,9506,0,0
8505772,"Spiringen, Post",,0.000041,93,2,1,3,1913,1913,3826,19,0.110482,0.138723,457.32381,0,0
8573118,Bürglen St. Sebastian,,0.000031,93,1,2,3,24276,24276,48552,19,0.125891,0.18602,1252,0,0
8505776,"Urnerboden, Dorf",,0.000043,93,2,1,3,384,384,768,19,0.113417,0.140824,662.17619,0,0
8505777,"Bedigliora, Paese",,0.000015,81,1,1,2,7466,7715,15181,40,0.097524,0.138865,69.883333,0,0
8505786,"Bombinasco, Paese",,0.000027,81,1,4,5,8056,8056,16112,40,0.100408,0.150652,460.133333,0,0
8505792,"Miglieglia, Paese",,0.000025,81,3,6,9,13387,13754,27141,39,0.111449,0.173906,2124.460317,0,0
8505888,"Cademario, Lisone",,0.000058,81,3,4,7,21810,21929,43739,40,0.102146,0.148109,4960.383333,0,0
8505778,"Bristen, Dorf",,0.000026,93,1,1,2,1436,1436,2872,4,0.4,0.520833,16,0,0
8505780,"Isenthal, Post",,0.00002,93,1,1,2,948,948,1896,22,0.096429,0.126583,135,0,0
8505783,"Bosco Gurin, Paese",,0.000011,82,0,1,1,0,2796,2796,16,0.10989,0.186595,0,0,0
8505785,"Banco, Paese",,0.000019,81,2,1,3,8056,8056,16112,41,0.091456,0.125886,70.133333,0,0
8575670,"Sessa, Tortura",,0.000048,81,1,2,3,8831,8831,17662,9,0.219178,0.338864,1376,0,0
8575671,"Sessa, Piazza",,0.000037,81,2,2,4,7772,8244,16016,8,0.234375,0.354048,604,0,0
8575678,"Monteggio, Castello",,0.000063,81,1,2,3,9381,9381,18762,6,0.333333,0.49375,126,0,0
8505910,"Bedano, Paese",,0.000012,102,1,2,3,6865,23531,30396,39,0.089411,0.143111,356.908333,0,0
8505968,"Taverne, Paese",,0.000022,102,2,6,8,29194,29190,58384,39,0.090141,0.15188,859.333333,0,0
8507544,"Banco, Cruséta",,0.000051,81,5,6,11,9129,9103,18232,39,0.107786,0.171462,4917.966667,0,0
8570128,"Camignolo, Scuola Media",,0.000021,102,2,3,5,1627,1627,3254,39,0.089241,0.143864,465,0,0
8575311,"Massagno, Praccio",,0.000033,102,2,4,6,101135,101012,202147,39,0.091913,0.150633,3354.719697,0,0
8575312,"Massagno, Cappella due Mani",,0.000018,102,1,5,6,89850,89850,179700,39,0.091832,0.151822,216,0,0
8575317,"Cadempino, Municipio",,0.000042,102,1,3,4,64747,64747,129494,38,0.090571,0.147207,1636.383333,0,0
8575318,"Lamone, Posta Vecchia",,0.000023,102,1,1,2,984,984,1968,39,0.086579,0.133283,0,0,0
8575337,"Gravesano, Paese",,0.000029,81,1,1,2,8344,8344,16688,29,0.082454,0.097311,3693,0,0
8505790,"Iseo, Paese",,0.000023,81,2,1,3,8221,8221,16442,43,0.079691,0.101201,238,0,0
8505796,"Vernate, Paese",,0.000036,81,2,2,4,9693,9693,19386,42,0.086413,0.114925,1428,0,0
8575375,"Miglieglia, Tortoglio",,0.00003,81,1,3,4,13754,13754,27508,21,0.10808,0.143423,3660,0,0
8575389,"Aranno, Cappella di Aranno",,0.000043,81,3,3,6,13759,13878,27637,21,0.108402,0.144141,1037.166667,0,0
8505791,"Madonna del Piano, Paese",,0.000017,81,1,1,2,7305,21529,28834,28,0.055868,0.074001,18,0,0
8505886,"Aranno, Paese",,0.000026,81,1,2,3,8221,8221,16442,41,0.093493,0.128584,1887,0,0
8505887,"Bosco Luganese, Paese",,0.000038,81,1,1,2,8218,8218,16436,41,0.092856,0.124295,1431,0,0
8575363,"Arosio, Bassa",,0.000049,81,1,1,2,8533,8533,17066,26,0.108096,0.135412,4251,0,0
8575364,"Arosio, Bivio per Arosio",,0.000056,81,2,3,5,8601,11727,20328,25,0.120707,0.161497,4549.333333,0,0
8575370,"Vezio, Acquacalda",,0.000052,81,1,1,2,8533,8533,17066,25,0.115385,0.144279,1200,0,0
8575371,"Fescoggia, Paese",,0.000075,81,3,3,6,11589,8207,19796,24,0.129891,0.173113,5313.166667,0,0
8505793,"Molinazzo di Monteggio, Posta",,0.000025,81,1,2,3,21529,21529,43058,27,0.05886,0.081186,200,0,0
8505794,"Ponte Cremenaga, Paese",,0.000022,81,1,1,2,12148,12148,24296,26,0.061876,0.082507,186,0,0
8505795,"Termine, Paese",,0.000022,81,1,1,2,9381,9381,18762,26,0.061876,0.082507,186,0,0
8575405,"Novaggio, Riveri",,0.00006,81,2,3,5,23601,23563,47164,18,0.111823,0.149196,2852.5,0,0
8505799,"Isone, Paese",,0.000011,102,0,1,1,0,6671,6671,41,0.077326,0.111138,0,0,0
8505850,"Ascona, Centro",,0.000019,101,1,2,3,42054,41920,83974,33,0.08468,0.104554,954,0,0
8506519,"Gordola, Roviscaglie",,0.000019,101,1,1,2,20655,20775,41430,33,0.084517,0.102673,0,0,0
8505852,"Brissago, Posta",,0.00002,101,1,1,2,13747,13747,27494,33,0.084369,0.101836,475,0,0
8505853,"Ascona, Moscia",,0.000028,101,1,1,2,13747,13747,27494,32,0.09195,0.114641,948,0,0
8506520,"Gordola, Centro Professionale",,0.000035,101,2,2,4,42040,41864,83904,32,0.092126,0.116505,1900,0,0
8506522,"Ascona, Borgo",,0.000026,101,1,1,2,21089,20844,41933,32,0.09195,0.114641,0,0,0
8505855,"Ronco s. Ascona, Posta",,0.000038,101,1,1,2,9753,9753,19506,33,0.08533,0.111192,1465,0,0
8505856,"Cavergno, Paese",,0.000084,101,4,3,7,22436,22450,44886,33,0.087485,0.118081,7252,0,0
8573562,Cortemezzano di Peccia,,0.000011,101,0,1,1,0,1668,1668,7,0.263158,0.324643,0,0,0
8505857,Giumaglio,,0.000035,101,1,1,2,17582,17582,35164,32,0.091852,0.121231,7305,0,0
8506438,"Locarno, Rotonda",,0.000037,108,3,4,7,24537,24383,48920,61,0.058952,0.121763,3674.191667,0,0
8506528,"Locarno, Delta Maggia",,0.000037,101,1,3,4,17316,18069,35385,32,0.092212,0.125166,986,0,0
8507215,"Losone, Canaa",,0.000016,101,1,1,2,40147,40147,80294,32,0.091852,0.121231,487,0,0
8507641,"Arcegno, Altisio",,0.000043,101,1,4,5,9753,9753,19506,32,0.093099,0.131283,1948,0,0
8573614,"Mosogno, Sotto",,0.00004,101,1,2,3,5370,5370,10740,32,0.092903,0.124263,1948,0,0
8505870,"Mergoscia, Posta",,0.000023,108,1,1,2,6331,6526,12857,62,0.055744,0.102467,2093,0,0
8505948,"Monte Carasso, Cunvént",,0.000011,108,0,4,4,0,42469,42469,61,0.058116,0.113122,0,0,0
8505859,"Orselina, Posta",,0.000029,101,2,2,4,23842,23647,47489,63,0.053191,0.092687,1406,0,0
8505861,Maccagno,,0.000102,28,3,1,4,3979,4131,8110,22,0.069948,0.091554,44928,0,0
8505862,Pino-Tronzano,,0.000098,28,1,1,2,4131,4131,8262,21,0.074513,0.097282,44619,0,0
8575251,"Vico Morcote, Colombaio",,0.000042,102,1,1,2,13125,11160,24285,22,0.096392,0.114915,873,0,0
8505864,Nante,,0.000011,108,0,1,1,0,1948,1948,16,0.125,0.158762,0,0,0
8505869,All'Acqua,,0.000051,108,2,2,4,3582,3582,7164,16,0.125781,0.164728,837,0,0
8510183,"Bedretto, Bivio per Ronco",,0.000033,108,1,1,2,3068,3068,6136,16,0.125,0.158762,0,0,0
8505865,"Fontana, Paese",,0.000024,108,2,1,3,3582,3582,7164,18,0.102764,0.127612,281,0,0
8505866,Ossasco (Bedretto),,0.000032,108,1,2,3,3582,3582,7164,17,0.113744,0.148073,423,0,0
8505868,"Bedretto, Paese",,0.000032,108,1,1,2,3457,3457,6914,17,0.112431,0.139595,142,0,0
8505867,Villa (Bedretto),,0.000024,108,1,1,2,3457,3457,6914,18,0.101707,0.123569,4,0,0
8507521,"Orgnana, Molina",,0.000053,108,1,1,2,4216,2373,6589,29,0.054449,0.083686,536,0,0
8575525,"Magadino, Farmacia",,0.000055,108,1,1,2,13966,13966,27932,29,0.054449,0.083686,708,0,0
8505872,"Lavertezzo, Paese",,0.000071,101,1,1,2,8355,8355,16710,34,0.082622,0.103863,9958,0,0
8505874,Colmegna,,0.000094,28,1,1,2,4131,224,4355,20,0.079759,0.104575,44308,0,0
8575560,"Gerra (Gambarogno), Bagno",,0.000084,108,1,1,2,13966,13966,27932,20,0.079759,0.104575,3541,0,0
8505981,"Augio, Paese",,0.000049,17,1,2,3,2138,2138,4276,11,0.174888,0.249492,195,0,0
8505984,"Sta. Maria in Calanca, Paese",,0.000024,17,1,2,3,2963,2963,5926,11,0.173333,0.247355,39,0,0
8505876,"Buseno, Paese",,0.00002,17,2,1,3,2201,2138,4339,16,0.101617,0.140262,10,0,0
8505879,"Arvigo, Paese",,0.000028,17,1,1,2,2138,2138,4276,15,0.11054,0.149825,51,0,0
8505892,Altdorf Telldenkmal,,0.000081,93,2,5,7,46644,50725,97369,16,0.14985,0.213573,1942.057143,0,0
8505881,"Cademario, Belsito",,0.000025,81,1,1,2,8218,8218,16436,43,0.078602,0.097583,483,0,0
8505885,"Bioggio, Bivio per Zotta",,0.000032,81,1,1,2,8218,8218,16436,42,0.085129,0.108893,958,0,0
8575372,"Breno, alla Bolla",,0.000036,81,2,2,4,6644,8560,15204,23,0.144769,0.194579,5672.443651,0,0
8505889,"Bosco Luganese, Luchina",,0.000023,81,1,1,2,8218,8218,16436,42,0.080339,0.112906,1772.15,0,0
8505918,"Isleten, Seegarten",,0.000028,93,1,2,3,948,948,1896,21,0.105929,0.146143,268,0,0
8508864,"Isenthal, Seilbahn St. Jakob",,0.000023,93,1,1,2,867,867,1734,21,0.105222,0.139723,0,0,0
8505893,Schattdorf Dorf,,0.000025,93,1,4,5,26377,26393,52770,19,0.139423,0.215,192.616667,0,0
8505975,Klausen Passhöhe,,0.000045,93,2,2,4,478,478,956,18,0.133733,0.181474,842.009524,0,0
8505997,"Urnerboden, Argseeli",,0.000036,93,1,2,3,384,384,768,18,0.135385,0.183863,396,0,0
8573087,Altdorf Hagenschulhaus,,0.000056,93,3,1,4,23359,23313,46672,20,0.116711,0.163385,528,0,0
8508983,"Meien, Sustenbrüggli",,0.000032,114,1,2,3,254,254,508,20,0.127141,0.175833,1344,0,0
8571607,"Gadmen, Feldmoos",,0.000045,114,1,2,3,266,266,532,20,0.137821,0.195551,2785,0,0
8573088,Altdorf Bahnhof Ost,,0.000112,93,5,4,9,35040,51099,86139,19,0.131131,0.206228,1935.766667,0,0
8573106,Göschenen Bahnhof,,0.000063,93,4,4,8,7949,7949,15898,19,0.146286,0.229496,5427.516667,0,0
8573092,Seedorf Schloss A Pro,,0.000047,93,2,4,6,18571,18283,36854,19,0.138829,0.22322,751.414286,0,0
8573114,Flüelen Eggberge Talstation,,0.000053,93,3,2,5,25453,25445,50898,19,0.127353,0.1906,66,0,0
8505895,"Udligenswil, Frohsinn",,0.000017,91,1,1,2,6113,5570,11683,41,0.066557,0.084338,3505.495238,0,0
8505896,"Golzern, Talstation Seilbahn",,0.000033,93,1,1,2,1436,1436,2872,3,0.5,0.611111,15,0,0
8505897,"Melano, Cappelletta per Rovio",,0.00004,99,1,1,2,8838,8838,17676,23,0.063171,0.087389,400,0,0
8505898,"Rivera-Bironico, Stazione",,0.00002,102,1,3,4,6671,22767,29438,40,0.083596,0.13046,398,0,0
8505900,"Gordola, Motto",,0.000011,101,0,1,1,0,11569,11569,40,0.055801,0.064534,0,0,0
8505902,"Riazzino, Montedato Municipio",,0.00002,101,1,1,2,11569,11569,23138,39,0.058976,0.068511,479,0,0
8505903,"Agarone, Piandesso",,0.000028,101,1,1,2,11569,11569,23138,38,0.062541,0.07314,956,0,0
8505905,"Agarone, i Lög",,0.000035,101,1,1,2,11569,11569,23138,37,0.066574,0.078614,1431,0,0
8505906,"Agarone, Colletto",,0.00004,101,1,1,2,11569,11569,23138,36,0.071172,0.085215,1904,0,0
8505907,"Medoscio, Sotto",,0.000045,101,1,1,2,11569,11569,23138,35,0.076465,0.093382,2375,0,0
8505908,"Medoscio, Paese",,0.000049,101,1,1,2,11569,11569,23138,34,0.082622,0.103863,2844,0,0
8505914,"Loco, Paese",,0.00002,101,1,1,2,5370,5370,10740,35,0.073036,0.087358,490,0,0
8505915,"Bristen, Kohlplatz",,0.000039,93,1,1,2,1436,1436,2872,2,0.666667,0.75,12,0,0
8505916,"Bristen, Wideli",,0.000044,93,1,1,2,1436,1436,2872,1,1,1,7,0,0
8505921,"Riva S. Vitale, Prati Maggi",,0.000011,99,0,1,1,0,11311,11311,28,0.096745,0.115146,0,0,0
8505922,"Rancate, Prati di Fondo",,0.00002,99,1,1,2,11311,11311,22622,27,0.106614,0.128955,216,0,0
8505923,"Mendrisio, Stand di Tiro",,0.000028,99,1,1,2,11311,11311,22622,26,0.118785,0.147762,430,0,0
8575153,"Bellinzona, Piazza Orico",,0.000033,108,1,5,6,94408,94408,188816,59,0.058282,0.125592,7613.416667,0,0
8575155,"Bellinzona, Via Borromini",,0.000018,108,1,2,3,8921,8921,17842,34,0.064883,0.076,103,0,0
8575156,"Bellinzona, Via Pierino Tatti",,0.000026,108,3,1,4,17748,7986,25734,34,0.06476,0.07411,0,0,0
8505963,"Soazza, Stazión",,0.000011,109,0,1,1,0,46,46,30,0.09354,0.118885,0,0,0
8509867,"S. Bernardino, Villaggio",,0.000073,109,6,5,11,6149,6112,12261,28,0.11153,0.155433,1897.066667,0,0
8575154,"Bellinzona, SAMB",,0.000016,108,1,2,3,39232,39232,78464,29,0.086729,0.113511,257,0,0
8505964,"Mesocco, Stazione",,0.00003,109,2,3,5,287,4011,4298,29,0.102962,0.140744,711,0,0
8505991,"Pian S. Giacomo, Paese",,0.00002,109,1,4,5,1838,1995,3833,28,0.112891,0.157933,193.033333,0,0
8509661,"Zillis, Viamala-Schlucht",,0.000024,109,1,1,2,1154,1154,2308,29,0.102102,0.133442,442,0,0
8509662,"Pignia, Abzw. Clugin",,0.000044,109,3,6,9,2427,6978,9405,28,0.113455,0.163769,1451.3,0,0
8509666,"Nufenen, Dorf",,0.000037,109,1,2,3,4111,4412,8523,29,0.101557,0.134358,477,0,0
8509783,"Hinterrhein, Dorf",,0.000026,109,2,4,6,2587,2587,5174,28,0.106732,0.141977,407.466667,0,0
8509866,"S. Bernardino, Ospizio",,0.000026,109,2,1,3,530,530,1060,29,0.100557,0.128722,56.866667,0,0
8505966,"Medeglia, Paese",,0.000017,102,1,2,3,6671,6671,13342,40,0.082452,0.123827,39,0,0
8575745,"Rivera, Bivio Capidogno",,0.00004,102,1,1,2,12850,12850,25700,24,0.066057,0.083404,1774,0,0
8505967,"Arogno, Paese",,0.000045,99,1,2,3,8838,8838,17676,22,0.066757,0.095806,495,0,0
8575698,"Capolago, Piazza",,0.00003,99,1,1,2,8112,8097,16209,22,0.066127,0.086579,0,0,0
8575313,"Savosa, Crocifisso",,0.000014,102,1,1,2,55586,55586,111172,42,0.068013,0.090733,0,0,0
8575315,"Vezia, Villa Negroni",,0.000041,102,1,2,3,64356,64356,128712,40,0.078306,0.114591,888,0,0
8575326,"Taverne, Solriposo",,0.00005,102,1,1,2,23531,23531,47062,39,0.078296,0.106972,1541,0,0
8575319,"Lamone-Cadempino, Stazione",,0.000082,102,10,7,17,72718,89204,161922,38,0.094542,0.165423,12507.88438,0,0
8575321,"Lamone, Ostarietta",,0.000029,102,1,3,4,31836,31842,63678,38,0.085675,0.127529,378,0,0
8575327,"Taverne, Casette",,0.000056,102,2,2,4,23708,23531,47239,38,0.084719,0.123,2053,0,0
8505969,"Stabio, Posta",,0.000011,99,0,2,2,0,16530,16530,26,0.124855,0.162658,0,0,0
8575615,"Stabio, Bagni",,0.000062,99,1,2,3,22836,22836,45672,27,0.135209,0.200134,1011,0,0
8505992,"Quinto, Paese",,0.000018,108,2,2,4,3836,5374,9210,29,0.103736,0.134371,468.1,0,0
8575703,"Ambrì, Sotto",,0.000037,108,1,2,3,18030,18035,36065,18,0.140165,0.200147,3985.133333,0,0
8575715,"Faido, Stazione",,0.000033,108,2,7,9,24311,24379,48690,17,0.15505,0.251455,3874.666667,0,0
8575721,Predelp,,0.000024,108,1,1,2,561,561,1122,18,0.12091,0.161205,85,0,0
8505974,"Chironico, Paese",,0.000011,108,0,1,1,0,4407,4407,19,0.107769,0.142524,0,0,0
8505978,"Selma, al Pont",,0.000035,17,1,1,2,2138,2138,4276,14,0.121387,0.162133,90,0,0
8505979,"Cauco, Bodio",,0.00004,17,1,1,2,2138,2138,4276,13,0.134868,0.178873,127,0,0
8505980,Sta. Domenica,,0.000045,17,1,1,2,2138,2138,4276,12,0.152091,0.203821,162,0,0
8575233,"Grono, Clinica San Rocco",,0.000046,17,3,3,6,3881,3917,7798,10,0.201058,0.295478,344,0,0
8505982,"Castaneda, Paese",,0.000015,17,1,1,2,2963,2963,5926,12,0.150943,0.202393,2,0,0
8505985,"Verdabbio, Piazza",,0.000011,17,0,1,1,0,2136,2136,2,0.6,0.666667,0,0,0
8580103,"Grono, Bivio Calanca",,0.00011,17,4,3,7,4307,4190,8497,9,0.210145,0.303093,2032,0,0
8509968,"Zillis, Dorf",,0.000066,109,5,6,11,7005,6921,13926,27,0.122492,0.177549,5800.15,0,0
8574902,"Thusis, Dorf",,0.000082,109,4,3,7,3887,3884,7771,26,0.122195,0.163878,13443.25,0,0
8575112,"Chur, Postautostation",,0.000105,109,4,3,7,6807,3364,10171,26,0.128501,0.180323,6306.65,0,0
8575232,"Roveredo GR, Ponte di Ferro",,0.000023,109,1,1,2,121,121,242,28,0.107172,0.136875,0,0,0
8575239,"Mesocco, Castello",,0.000023,109,1,1,2,46,46,92,28,0.107172,0.136875,8.2,0,0
8575689,"Airolo, Stazione",,0.000097,108,6,4,10,22114,22181,44295,15,0.141837,0.197082,8144.616667,0,0
8575574,"Mendrisio, Via Motta",,0.00002,99,1,4,5,71853,71853,143706,27,0.140994,0.215562,222,0,0
8505996,"Urnerboden, Sonne",,0.00003,93,1,1,2,384,384,768,19,0.120036,0.152936,286,0,0
8573127,"Unterschächen, Untere Balm",,0.00002,93,1,2,3,386,386,772,21,0.116727,0.167382,708,0,0
8506046,Henggart,,0.000059,9,2,1,3,19306,19306,38612,3,0.5,0.611111,6,0,0
8506019,Islikon,,0.000039,18,1,1,2,19867,19867,39734,31,0.070362,0.084224,3184.333333,0,0
8506035,Schottikon,,0.000055,18,1,1,2,19834,19834,39668,32,0.064435,0.074031,10458,0,0
8506143,Münsterlingen Spital,,0.000088,18,3,2,5,18953,18953,37906,29,0.079526,0.098215,7432.333333,0,0
8506148,St. Katharinental,,0.000084,18,2,3,5,18280,17762,36042,28,0.086169,0.11112,25531.833333,0,0
8506178,Münchwilen TG,,0.000066,18,1,2,3,22850,22850,45700,32,0.064476,0.074651,12461,0,0
8506179,Lüdem,,0.000039,18,1,1,2,18614,18615,37229,32,0.064435,0.074031,0,0,0
8506190,Bussnang,,0.000059,18,1,1,2,17312,17312,34624,32,0.064435,0.074031,10458,0,0
8506205,Bazenheid,,0.000044,18,1,1,2,19863,19863,39726,32,0.064435,0.074031,5080,0,0
8506210,Gossau SG,,0.000094,18,2,4,6,51890,69060,120950,28,0.086414,0.112273,36357.071429,0,0
8506270,St. Gallen Marktplatz,,0.000011,18,0,3,3,0,27334,27334,28,0.086957,0.112576,0,0,0
8506276,Strahlholz,,0.000014,18,1,3,4,19316,17775,37091,28,0.086985,0.112811,16,0,0
8506286,Appenzell,,0.000071,18,3,3,6,35002,34028,69030,28,0.086071,0.111028,14828,0,0
8506290,Herisau,,0.000124,18,5,3,8,60277,53807,114084,28,0.08595,0.110476,45729.404762,0,0
8506292,Degersheim,,0.000085,18,2,2,4,19449,19449,38898,28,0.085868,0.109831,3402,0,0
8506294,Brunnadern-Neckertal,,0.000051,18,1,2,3,18196,18196,36392,28,0.085796,0.109673,2174,0,0
8506299,Nesslau-Neu St. Johann,,0.000061,18,1,1,2,8555,8304,16859,28,0.085651,0.108643,2920,0,0
8506301,St. Gallen Bruggen,,0.000154,18,1,1,2,32844,32844,65688,28,0.085651,0.108643,34310,0,0
8506001,Winterthur Grüze,,0.000035,9,1,2,3,47738,47744,95482,39,0.044793,0.050146,7698.343831,0,0
8506002,Winterthur Seen,,0.000026,9,1,1,2,27941,27690,55631,7,0.266667,0.386607,3738.343831,0,0
8506004,Kollbrunn,,0.000025,9,1,1,2,24240,24240,48480,5,0.3,0.413889,2495,0,0
8506005,Rikon,,0.000032,9,1,1,2,24240,24240,48480,4,0.357143,0.466667,2001,0,0
8506006,Rämismühle-Zell,,0.000038,9,1,1,2,24240,24240,48480,3,0.444444,0.541667,1505,0,0
8506007,Turbenthal,,0.000043,9,1,1,2,24240,24240,48480,2,0.6,0.666667,1007,0,0
8506010,Sirnach,,0.000026,18,1,1,2,19803,19833,39636,38,0.046626,0.050803,4476,0,0
8506011,Eschlikon TG,,0.000033,18,1,1,2,19833,19833,39666,37,0.048874,0.053473,5478,0,0
8506012,Guntershausen,,0.000039,18,1,1,2,19833,19833,39666,36,0.051351,0.056482,6478,0,0
8506013,Aadorf,,0.000044,18,1,1,2,19833,19833,39666,35,0.054094,0.059906,7476,0,0
8506014,Elgg,,0.000048,18,1,1,2,19833,19833,39666,34,0.057149,0.063851,8472,0,0
8506015,Räterschen,,0.000052,18,1,1,2,19833,19834,39667,33,0.060573,0.068473,9466,0,0
8506016,Oberwinterthur,,0.000035,9,1,2,3,48489,48239,96728,33,0.062115,0.072435,6228.5,0,0
8506017,Wiesendangen,,0.000026,18,1,1,2,19867,19867,39734,33,0.061754,0.070683,1076.333333,0,0
8506018,Rickenbach-Attikon,,0.000033,18,1,1,2,19867,19867,39734,32,0.065777,0.076699,2131.333333,0,0
8506020,Seuzach,,0.000026,9,1,2,3,28372,27067,55439,32,0.065093,0.075336,5723.166667,0,0
8506025,Etzwilen,,0.000087,9,2,2,4,35561,36070,71631,30,0.074715,0.090228,14862,0,0
8506021,Dinhard,,0.000022,9,1,1,2,16507,16507,33014,34,0.057652,0.064439,2314.5,0,0
8506022,Thalheim-Altikon,,0.000029,9,1,1,2,16507,16507,33014,33,0.061139,0.069121,3355.5,0,0
8506023,Ossingen,,0.000036,9,1,1,2,16507,17820,34327,32,0.065078,0.074687,4394.5,0,0
8506036,Reutlingen,,0.000059,9,2,1,3,28380,28380,56760,31,0.068664,0.079815,3993.666667,0,0
8506138,Eschenz,,0.000056,18,1,1,2,18737,18737,37474,30,0.073631,0.08742,9006,0,0
8506039,Schloss Laufen am Rheinfall,,0.00005,9,2,2,4,19291,19306,38597,4,0.454545,0.616667,992,0,0
8506045,Hettlingen,,0.000032,9,1,1,2,19111,19111,38222,4,0.4,0.520833,0,0,0
8506041,Embrach-Rorbas,,0.000035,9,1,1,2,19362,19362,38724,3,0.5,0.611111,1488,0,0
8506042,Pfungen,,0.000041,9,1,1,2,19362,19342,38704,2,0.666667,0.75,994,0,0
8506043,Winterthur Wülflingen,,0.000045,9,1,1,2,19342,19362,38704,1,1,1,498,0,0
8506047,Andelfingen,,0.000085,9,2,1,3,27861,19807,47668,2,0.666667,0.75,998,0,0
8506048,Marthalen,,0.000083,9,1,1,2,19807,19523,39330,1,1,1,500,0,0
8506052,"Hoffeld, Post",,0.000011,97,0,1,1,0,3379,3379,44,0.046179,0.0657,0,0,0
8506053,"Hoffeld, Strickwald",,0.00002,97,1,1,2,3379,3379,6758,43,0.048372,0.071658,1132,0,0
8506054,"Hoffeld, Ziegelhütte",,0.000028,97,1,1,2,3379,3379,6758,42,0.050786,0.07927,2262,0,0
8506699,"Waldkirch, Rickenhueb",,0.000022,71,1,2,3,8849,8849,17698,30,0.084265,0.103151,535,0,0
8506057,"Rickenbach bei Wil, Wilfeld",,0.000011,20,0,3,3,0,24136,24136,46,0.047651,0.071793,0,0,0
8506472,"Flawil, Scheidweg",,0.000021,20,1,2,3,11273,11273,22546,48,0.043839,0.062036,4434,0,0
8506477,"Flawil, Maestrani",,0.00002,20,1,1,2,9896,9896,19792,48,0.043811,0.061413,0,0,0
8506576,"Oberuzwil, Post",,0.00004,20,3,4,7,25878,25910,51788,47,0.045788,0.068155,7535.541828,0,0
8506578,"Niederuzwil, Luxenburg",,0.000023,20,2,1,3,1113,1108,2221,46,0.047121,0.067291,4073.823377,0,0
8506065,Liestal Grammet,,0.000011,2,0,1,1,0,23903,23903,17,0.120452,0.142628,0,0,0
8578244,Reigoldswil Hoggen,,0.000038,2,3,4,7,11159,11159,22318,14,0.14404,0.182272,659.738362,0,0
8578246,Lauwil Dorf,,0.000026,2,2,2,4,10735,10502,21237,14,0.143014,0.174896,145.827677,0,0
8506088,"Romont FR, La Maula bas",,0.000018,13,1,1,2,52,164,216,23,0.09811,0.116575,461,0,0
8506097,"Sion, Roseaux",,0.000011,39,0,1,1,0,5832,5832,13,0.125749,0.198845,0,0,0
8506100,Frauenfeld,,0.000068,18,2,3,5,40508,59124,99632,30,0.075639,0.094377,39375.75,0,0
8506104,Märstetten,,0.000047,18,1,1,2,19867,19867,39734,30,0.075136,0.091667,4608,0,0
8506101,Felben-Wellhausen,,0.00003,18,1,1,2,19867,19867,39734,33,0.06142,0.069831,1503,0,0
8506102,Hüttlingen-Mettendorf,,0.000037,18,1,1,2,19867,19867,39734,32,0.065397,0.075576,2540,0,0
8506103,Müllheim-Wigoltingen,,0.000042,18,1,1,2,19867,19867,39734,31,0.069927,0.082625,3575,0,0
8506105,Weinfelden,,0.00007,18,2,5,7,40509,102136,142645,29,0.081187,0.104455,39550.75,0,0
8506108,Oberaach,,0.000024,18,1,1,2,17310,17310,34620,29,0.080294,0.09803,1583,0,0
8506127,Bottighofen,,0.000053,18,2,2,4,18908,18953,37861,30,0.07453,0.09055,7560,0,0
8506118,Triboltingen,,0.000048,9,1,2,3,18250,18767,37017,29,0.080521,0.09991,15840,0,0
8506128,Kreuzlingen Hafen,,0.000053,18,3,2,5,35134,35396,70530,29,0.080232,0.099973,6202.988095,0,0
8506106,Bürglen TG,,0.000023,18,1,4,5,36490,36490,72980,29,0.080716,0.101472,7125.904762,0,0
8506209,Flawil,,0.000092,18,1,1,2,37310,37310,74620,29,0.07959,0.0978,29921,0,0
8506212,Hauptwil,,0.000037,18,1,1,2,14667,14648,29315,34,0.05679,0.063107,1846,0,0
8506206,Wil SG,,0.0003,18,9,3,12,116212,73952,190164,31,0.068827,0.081173,53076.666667,0,0
8506216,Kradolf,,0.000057,18,1,2,3,19197,18802,37999,30,0.07326,0.08683,7318,0,0
8506107,Erlen,,0.000016,18,1,1,2,17295,17310,34605,30,0.074371,0.087972,558,0,0
8506109,Amriswil,,0.000043,18,2,1,3,36887,36872,73759,28,0.087246,0.111659,21443.857143,0,0
8506119,Kurzrickenbach Seepark,,0.000031,18,1,1,2,18028,18953,36981,28,0.087246,0.111659,16544.5,0,0
8506278,Seebleiche,,0.000011,18,0,2,2,0,7827,7827,28,0.067021,0.09118,0,0,0
8506122,Uttwil,,0.000019,18,1,1,2,18968,18968,37936,33,0.061086,0.069597,2620,0,0
8506123,Kesswil,,0.000027,18,1,2,3,18968,18953,37921,32,0.065017,0.075634,3612,0,0
8506124,Güttingen,,0.000022,18,1,2,3,14405,14405,28810,31,0.069486,0.082505,3550,0,0
8506126,Münsterlingen-Scherzingen,,0.000038,18,1,1,2,18877,18877,37754,31,0.069404,0.081623,1513,0,0
8506125,Altnau,,0.000032,18,2,1,3,18922,18877,37799,32,0.06494,0.074744,527,0,0
8506131,Kreuzlingen,,0.000066,18,3,3,6,65196,54526,119722,30,0.074194,0.090308,8655.5,0,0
8506139,Stein am Rhein,,0.000085,18,2,2,4,36557,18516,55073,29,0.079431,0.09776,16429.666667,0,0
8506200,Wattwil,,0.000084,18,6,3,9,19281,47943,67224,29,0.079552,0.098782,36117.416667,0,0
8506201,Lichtensteig,,0.000035,18,1,2,3,38059,38059,76118,29,0.079579,0.098023,2096,0,0
8506289,Wasserauen,,0.000037,18,1,1,2,10137,10137,20274,29,0.079197,0.096742,1468,0,0
8506132,Tägerwilen-Gottlieben,,0.000029,18,1,1,2,18737,18767,37504,36,0.051237,0.056215,3216,0,0
8506133,Ermatingen,,0.000036,18,1,1,2,18767,18797,37564,35,0.053969,0.059579,4186,0,0
8506134,Mannenbach-Salenstein,,0.000041,18,1,1,2,18797,18797,37594,34,0.057009,0.063433,5154,0,0
8506135,Berlingen,,0.000046,18,1,1,2,18797,18797,37594,33,0.060416,0.067907,6120,0,0
8506136,Steckborn,,0.00005,18,1,1,2,18797,18737,37534,32,0.064258,0.073182,7084,0,0
8506137,Mammern,,0.000053,18,1,1,2,18737,18737,37474,31,0.068624,0.079534,8046,0,0
8506398,Neukirch-Egnach,,0.000053,18,1,1,2,18416,18200,36616,1,1,1,95,0,0
8506168,Tägerschen,,0.000031,18,2,1,3,17312,17312,34624,39,0.044577,0.048414,3668,0,0
8506169,Wiesengrund,,0.00003,18,1,1,2,18615,18614,37229,36,0.051488,0.057281,4509,0,0
8506170,Münchwilen Pflegeheim,,0.000037,18,1,2,3,18614,22850,41464,35,0.054247,0.06126,5510,0,0
8506175,Jakobstal,,0.000044,18,1,1,2,18614,18614,37228,35,0.054122,0.060033,4494,0,0
8506171,Frauenfeld Marktplatz,,0.000026,18,1,1,2,18614,18615,37229,38,0.046647,0.050864,1509,0,0
8506173,Weberei Matzingen,,0.000033,18,1,1,2,18615,18615,37230,37,0.048897,0.053548,2506,0,0
8506174,Matzingen,,0.000039,18,1,1,2,18615,18614,37229,36,0.051376,0.056578,3501,0,0
8506176,Wängi,,0.000064,18,2,1,3,22850,22850,45700,34,0.057181,0.064031,10485,0,0
8506177,Rosental,,0.000065,18,1,1,2,22850,22850,45700,33,0.060609,0.068761,11474,0,0
8506181,Bronschhofen,,0.000037,18,1,1,2,17312,17312,34624,38,0.046626,0.050803,4644,0,0
8506182,Bettwiesen,,0.000042,18,1,1,2,17312,17312,34624,37,0.048874,0.053473,5618,0,0
8506183,Tobel-Affeltrangen,,0.000047,18,1,1,2,17312,17312,34624,36,0.051351,0.056482,6590,0,0
8506184,Märwil,,0.000051,18,1,1,2,17312,17312,34624,35,0.054094,0.059906,7560,0,0
8506185,Oppikon,,0.000054,18,1,1,2,17312,17312,34624,34,0.057149,0.063851,8528,0,0
8506188,Bronschhofen AMP,,0.000057,18,1,1,2,17312,17312,34624,33,0.060573,0.068473,9494,0,0
8506193,Kehlhof,,0.000029,18,1,1,2,34895,34975,69870,5,0.333333,0.456667,2660,0,0
8506194,Berg,,0.000036,18,1,1,2,34975,34973,69948,4,0.4,0.520833,2132,0,0
8506195,Siegershausen,,0.000041,18,1,1,2,34973,34974,69947,3,0.5,0.611111,1602,0,0
8506196,Lengwil,,0.000046,18,1,1,2,34974,34690,69664,2,0.666667,0.75,1070,0,0
8506197,Kreuzlingen Bernrain,,0.00005,18,1,1,2,34690,34975,69665,1,1,1,536,0,0
8506202,Dietfurt,,0.000026,18,1,1,2,19863,19863,39726,35,0.054094,0.059906,1744,0,0
8506203,Bütschwil,,0.000033,18,1,1,2,19863,19863,39726,34,0.057149,0.063851,2858,0,0
8506204,Lütisburg,,0.000039,18,1,1,2,19863,19863,39726,33,0.060573,0.068473,3970,0,0
8506208,Uzwil,,0.000096,18,1,1,2,37310,37310,74620,30,0.073768,0.087586,29029,0,0
8506217,Sulgen,,0.000133,18,4,1,5,37372,14580,51952,30,0.073213,0.086205,23815.5,0,0
8506211,Arnegg,,0.000031,18,1,1,2,14667,14667,29334,35,0.053773,0.059305,980,0,0
8506213,Bischofszell Stadt,,0.000047,18,2,1,3,19170,19197,38367,33,0.060168,0.067514,4738,0,0
8506214,Sitterdorf,,0.000051,18,1,1,2,19197,19197,38394,32,0.063977,0.072705,5600,0,0
8506215,Bischofszell Nord,,0.000054,18,1,1,2,19197,19197,38394,31,0.068303,0.07896,6460,0,0
8506230,"Sion, Route de la Drague",,0.00002,39,1,1,2,5832,5832,11664,12,0.136986,0.21439,20,0,0
8506232,"Sion, Voirie",,0.000028,39,1,1,2,5832,5832,11664,11,0.150794,0.238057,38,0,0
8506234,"Sion, Gravière",,0.000035,39,1,2,3,5832,5831,11663,10,0.168224,0.288095,54,0,0
8506238,"Sion, Piscine de la Blancherie",,0.000033,39,1,1,2,2930,2930,5860,10,0.153846,0.230357,16,0,0
8506236,"Sion, Perdrix",,0.000026,39,1,1,2,2930,2930,5860,11,0.140496,0.217044,4,0,0
8506243,"Sion, gare sud",,0.000053,39,2,1,3,5831,5832,11663,9,0.170455,0.24664,90,0,0
8570836,Les Ronquoz,,0.000034,39,1,1,2,1232,1232,2464,9,0.170455,0.24664,579,0,0
8506252,"Gossau SG, Degenau",,0.000011,20,0,1,1,0,12137,12137,48,0.049552,0.074521,0,0,0
8506253,"Niederwil SG, Wiesental",,0.00002,20,1,2,3,12137,12137,24274,47,0.052103,0.083283,1597,0,0
8506577,"Oberbüren, Buchental",,0.000011,20,0,1,1,0,153,153,47,0.051261,0.078832,0,0,0
8506580,"Oberbüren, Post",,0.000029,20,2,5,7,10810,14234,25044,46,0.053997,0.089665,3763.285714,0,0
8506687,"Niederbüren, Dorf",,0.000026,20,2,2,4,6327,6437,12764,47,0.051488,0.082512,561.375,0,0
8573953,"Gossau SG, Gerbhof",,0.000045,71,2,3,5,65788,65930,131718,26,0.123105,0.164241,2850.842857,0,0
8506255,"Arbon, Wildpark",,0.000011,71,0,2,2,0,9024,9024,41,0.060042,0.095346,0,0,0
8574245,"Roggwil TG, Frohheim",,0.00004,71,1,1,2,8349,8915,17264,19,0.122414,0.136331,2386,0,0
8506260,"Weissbad, Bahnhof",,0.000011,96,0,1,1,0,5444,5444,4,0.4,0.520833,0,0,0
8506267,Seebensäge,,0.000011,73,0,1,1,0,4376,4376,41,0.037922,0.052673,0,0,0
8506285,Gonten,,0.000063,18,1,1,2,17102,17102,34204,29,0.079299,0.097083,13947,0,0
8506271,Gontenbad,,0.000031,18,1,2,3,17104,17102,34206,35,0.053978,0.060446,6987,0,0
8506277,Schwende,,0.000031,18,1,1,2,10137,10137,20274,35,0.053911,0.059512,1477,0,0
8506275,Steinegg,,0.000024,18,1,1,2,10300,10137,20437,36,0.051186,0.056163,602,0,0
8506375,Teufen AR,,0.000077,18,2,3,5,26621,24707,51328,10,0.236111,0.39288,9685,0,0
8506376,Steigbach,,0.000033,18,1,1,2,17782,17810,35592,10,0.2,0.278894,0,0,0
8506305,Goldach,,0.000051,18,2,1,3,28435,28435,56870,28,0.066555,0.087561,950,0,0
8506306,Rorschach Hafen,,0.000023,18,2,2,4,23432,23432,46864,28,0.066919,0.090847,1704.619048,0,0
8506309,Egnach,,0.000035,18,1,1,2,19588,19588,39176,28,0.066555,0.087561,950,0,0
8506280,Herisau Wilen,,0.000051,18,2,1,3,16939,17102,34041,34,0.056944,0.063348,9612,0,0
8506281,Waldstatt,,0.000054,18,1,1,2,17102,17102,34204,33,0.060342,0.067796,10483,0,0
8506282,Zürchersmühle,,0.000057,18,1,1,2,17102,17102,34204,32,0.064173,0.073033,11352,0,0
8506283,Urnäsch,,0.000059,18,1,1,2,17102,17102,34204,31,0.068528,0.079323,12219,0,0
8506284,Jakobsbad,,0.000061,18,1,1,2,17102,17102,34204,30,0.073519,0.087088,13084,0,0
8506288,Weissbad,,0.000031,18,1,1,2,9938,10137,20075,30,0.073432,0.08685,613,0,0
8506291,Schachen (Herisau),,0.000046,18,1,1,2,18196,18196,36392,29,0.079128,0.096436,0,0,0
8506293,Mogelsberg,,0.000047,18,1,1,2,18196,18196,36392,29,0.079067,0.096317,1329,0,0
8506297,Ebnat-Kappel,,0.000056,18,2,1,3,8555,8555,17110,30,0.073213,0.086205,1240,0,0
8506298,Krummenau,,0.000059,18,1,1,2,8555,8555,17110,29,0.078943,0.095774,2081,0,0
8506300,St. Gallen Winkeln,,0.000168,18,3,1,4,32844,32844,65688,29,0.078943,0.095774,33458,0,0
8506311,Rorschach,,0.000146,18,5,5,10,72528,65351,137879,27,0.07115,0.101645,11074.809524,0,0
8506313,Rheineck,,0.000041,18,1,2,3,28183,40697,68880,27,0.070009,0.09243,1749,0,0
8506322,Rorschach Stadt,,0.000081,18,3,1,4,28435,18093,46528,10,0.173333,0.260104,47.5,0,0
8506303,St. Gallen St. Fiden,,0.000058,18,1,3,4,52152,52154,104306,29,0.063334,0.085083,5153,0,0
8506304,Mörschwil,,0.000027,18,1,1,2,19847,19847,39694,29,0.062525,0.078965,0,0,0
8506307,Horn,,0.000021,18,1,1,2,19588,19588,39176,30,0.058962,0.072612,1052,0,0
8506308,Arbon,,0.000029,18,1,1,2,19588,19588,39176,29,0.062525,0.078965,1002,0,0
8506314,St. Margrethen SG,,0.0001,18,3,3,6,40064,37685,77749,26,0.074806,0.102044,8800.32381,0,0
8506312,Staad SG,,0.000036,18,1,1,2,28183,28183,56366,28,0.06556,0.082621,1926,0,0
8506316,Au SG,,0.000039,18,1,1,2,20096,20096,40192,26,0.074608,0.098108,0,0,0
8506317,Heerbrugg,,0.000073,18,2,2,4,29348,29288,58636,25,0.080448,0.113185,8108.633333,0,0
8506318,Rebstein-Marbach,,0.000042,18,1,1,2,20096,20096,40192,25,0.080287,0.111253,0,0,0
8506392,St. Gallen Haggen,,0.000127,18,2,1,3,27468,9788,37256,9,0.193548,0.280192,1942.5,0,0
8506350,Walzenhausen,,0.000028,18,1,1,2,12514,12514,25028,1,1,1,644,0,0
8506352,Wartensee,,0.000036,18,1,1,2,7827,7827,15654,4,0.4,0.520833,2568,0,0
8506353,Wienacht-Tobel,,0.000041,18,1,1,2,7827,7827,15654,3,0.5,0.611111,1929,0,0
8506354,Schwendi bei Heiden,,0.000046,18,1,1,2,7827,7827,15654,2,0.666667,0.75,1288,0,0
8506355,Heiden,,0.00005,18,1,1,2,7827,7827,15654,1,1,1,645,0,0
8506358,St. Gallen Spisertor,,0.000058,18,1,1,2,27624,27334,54958,20,0.094801,0.150797,19591,0,0
8506359,St. Gallen Schülerhaus,,0.00006,18,1,1,2,27334,27334,54668,19,0.101351,0.158269,18988,0,0
8506361,St. Gallen Notkersegg,,0.000062,18,1,1,2,27334,27624,54958,18,0.109023,0.167349,18383,0,0
8506362,Schwarzer Bären,,0.000064,18,1,1,2,27624,27624,55248,17,0.118143,0.178852,17776,0,0
8506364,Vögelinsegg,,0.000065,18,1,1,2,27624,27624,55248,16,0.129187,0.194377,17167,0,0
8506365,Schützengarten,,0.000066,18,1,1,2,27624,27624,55248,15,0.142857,0.217795,16556,0,0
8506366,Speicher,,0.000067,18,1,2,3,27624,30131,57755,14,0.160256,0.263824,15943,0,0
8506369,Trogen,,0.000049,18,1,3,4,28627,26119,54746,12,0.203704,0.356207,1320,0,0
8506367,Bendlehn,,0.000039,18,1,1,2,28625,28508,57133,14,0.154839,0.228289,2556,0,0
8506368,Gfeld,,0.000044,18,1,1,2,28508,28627,57135,13,0.175573,0.267666,1939,0,0
8506372,Lustmühle,,0.000056,18,1,1,2,25622,25622,51244,12,0.18018,0.264327,11512,0,0
8506381,Sammelplatz,,0.000036,18,1,2,3,17808,17808,35616,2,0.666667,0.75,9,0,0
8506470,Teufen AR Stofel,,0.000071,18,2,1,3,23577,25622,49199,2,0.666667,0.75,17,0,0
8506371,St. Gallen Riethüsli,,0.000053,18,2,1,3,25623,25622,51245,13,0.159091,0.231254,12135,0,0
8506373,Niederteufen,,0.000072,18,2,2,4,26621,26621,53242,11,0.208791,0.331748,10941,0,0
8506374,Sternen bei Teufen,,0.000042,18,1,1,2,25622,25622,51244,11,0.2,0.294623,0,0,0
8506382,Zweibrücken,,0.000045,18,2,1,3,17773,17561,35334,3,0.5,0.611111,12,0,0
8506377,Bühler,,0.000065,18,3,1,4,18933,18684,37617,9,0.234375,0.329709,7797,0,0
8506378,Gais,,0.000066,18,1,3,4,18684,25219,43903,8,0.285714,0.450085,7162,0,0
8506379,Altstätten Stadt,,0.00003,18,1,1,2,6539,6539,13078,7,0.25,0.370408,4557,0,0
8506380,Hirschberg,,0.00003,18,1,1,2,17806,17808,35614,3,0.454545,0.533333,656,0,0
8506383,Hebrig,,0.000036,18,1,1,2,6539,6539,13078,6,0.285714,0.408333,3912,0,0
8506384,Schachen (Gais),,0.000041,18,1,1,2,6539,6539,13078,5,0.333333,0.456667,3265,0,0
8506385,Rietli,,0.000046,18,1,1,2,6539,6539,13078,4,0.4,0.520833,2616,0,0
8506386,Stoss AR,,0.00005,18,1,1,2,6539,6539,13078,3,0.5,0.611111,1965,0,0
8506387,Kreuzstrasse,,0.000053,18,1,1,2,6539,6539,13078,2,0.666667,0.75,1312,0,0
8506388,Warmesberg,,0.000056,18,1,1,2,6539,6539,13078,1,1,1,657,0,0
8506393,Wittenbach,,0.000027,18,1,1,2,23719,18416,42135,6,0.285714,0.408333,3260,0,0
8506394,Roggwil-Berg,,0.000034,18,1,1,2,18416,18416,36832,5,0.333333,0.456667,2631,0,0
8506395,Häggenschwil-Winden,,0.00004,18,1,1,2,18416,18416,36832,4,0.4,0.520833,2000,0,0
8506396,Muolen,,0.000045,18,1,1,2,18416,18416,36832,3,0.5,0.611111,1367,0,0
8506397,Steinebrunn,,0.000049,18,1,1,2,18416,18416,36832,2,0.666667,0.75,732,0,0
8506401,"Allaman, gare sud",,0.000011,5,0,1,1,0,6949,6949,41,0.042326,0.052151,0,0,0
8506403,"Allaman, Château",,0.00002,5,1,1,2,6949,6949,13898,40,0.044163,0.055894,1329,0,0
8506405,"Allaman, Grand-Rue",,0.000028,5,1,1,2,6949,6950,13899,39,0.046169,0.060702,2656,0,0
8506407,"Etoy, Route Suisse",,0.000035,5,1,2,3,6950,6950,13900,38,0.048367,0.067544,3981,0,0
8570084,"Morges, gare",,0.000202,5,11,11,22,166089,165533,331622,36,0.052903,0.081864,72500.039555,0,0
8577593,"Etoy, Chenalette",,0.000064,5,1,1,2,5505,5505,11010,11,0.192308,0.234212,877,0,0
8506424,"Matten i.S., Stocken",,0.000011,19,0,1,1,0,417,417,10,0.192982,0.311724,0,0,0
8506427,"Matten i.S., Dorf",,0.00002,19,1,2,3,417,775,1192,9,0.217391,0.382897,10,0,0
8506429,"Matten i.S., Färmelbach",,0.000019,19,1,1,2,358,418,776,9,0.2,0.31433,0,0,0
8506431,"St. Stephan, altes Moosschulh.",,0.000036,19,2,1,3,835,835,1670,8,0.222222,0.339732,24,0,0
8506433,"St. Stephan, Bahnhof",,0.000041,19,1,1,2,835,1190,2025,7,0.25,0.370408,28,0,0
8506435,"St. Stephan, Grodey",,0.000046,19,1,1,2,1190,1190,2380,6,0.285714,0.408333,30,0,0
8506437,"St. Stephan, Nageldach",,0.00005,19,1,1,2,1190,1190,2380,5,0.333333,0.456667,30,0,0
8507217,"Ascona, Fiume Maggia",,0.000072,101,3,2,5,55366,54533,109899,31,0.101047,0.133106,4257,0,0
8510204,"Locarno, Saleggi",,0.000021,101,1,1,2,753,6960,7713,31,0.098545,0.12698,441.2,0,0
8575177,"Tenero, Stazione",,0.000148,101,3,5,8,73444,74125,147569,31,0.102036,0.142177,14710,0,0
8575473,"Locarno, Cinque Vie",,0.000098,101,6,4,10,76914,78236,155150,31,0.100935,0.145309,13364.52619,0,0
8575475,"Ponte Brolla, Stazione",,0.000032,101,2,2,4,18010,18010,36020,31,0.099075,0.130208,713.583333,0,0
8575478,"Cavigliano, Via Stazione (bus)",,0.000038,101,1,1,2,428,428,856,31,0.098545,0.12698,894,0,0
8575518,"Frasco, Mora",,0.000064,101,1,2,3,8355,8355,16710,31,0.098894,0.129696,4023,0,0
8576451,"Losone, Mercato Cattori",,0.000085,101,4,5,9,95839,96783,192622,31,0.10274,0.148626,11678.753571,0,0
8576971,"Golino, Ponte",,0.000025,101,1,3,4,5511,5511,11022,31,0.101177,0.138097,380.808333,0,0
8576461,"Losone, Arbigo",,0.000054,101,2,2,4,46003,46003,92006,33,0.090744,0.128882,1573.603571,0,0
8576465,"Losone, Zandone",,0.000034,101,1,2,3,19427,19427,38854,32,0.095993,0.1347,250.808333,0,0
8578881,"Locarno, Stazione",,0.000208,101,10,4,14,66289,76893,143182,30,0.109073,0.152442,40519.904762,0,0
8506439,"St. Stephan, Ried",,0.000054,19,1,1,2,1190,1190,2380,4,0.4,0.520833,28,0,0
8506440,"Jenaz, Mühlewiese",,0.000011,112,0,3,3,0,4688,4688,18,0.101645,0.126482,0,0,0
8509601,"Furna, Hinterberg",,0.000014,112,1,1,2,603,1324,1927,19,0.092027,0.107088,0,0,0
8509633,"Pragg, Jarella",,0.000026,112,2,1,3,1561,1804,3365,18,0.100988,0.120152,276,0,0
8506441,"St. Stephan, Kirche",,0.000056,19,1,1,2,1190,1190,2380,3,0.5,0.611111,24,0,0
8506443,"Au SG, Monstein",,0.000011,72,0,3,3,0,16747,16747,33,0.08115,0.12695,0,0,0
8506777,"Thal, alte Post",,0.000021,71,2,2,4,7311,7786,15097,34,0.0765,0.120006,4918.516667,0,0
8574092,"Rheineck, Altensteig",,0.000062,71,1,1,2,4782,4564,9346,34,0.076372,0.118639,13879.507143,0,0
8574110,"St. Margrethen SG, Mineralbad",,0.000041,72,2,1,3,2280,2280,4560,33,0.057218,0.079292,10908.9,0,0
8506444,"Eichberg, Post",,0.000011,73,0,1,1,0,7432,7432,47,0.060909,0.078397,0,0,0
8506446,"Hinterforst, Post",,0.00002,73,1,1,2,7432,7432,14864,46,0.064804,0.086789,1176,0,0
8506448,"Eichberg, Süesswinkel",,0.000028,73,1,2,3,7432,7432,14864,45,0.069236,0.098427,2350,0,0
8506450,"Altstätten SG, Bahnhof",,0.000023,73,1,4,5,7347,52244,59591,44,0.073467,0.108048,2948,0,0
8574041,"Buchs SG, Bahnhof",,0.000078,73,5,9,14,50077,68032,118109,19,0.118573,0.172388,101065.017416,0,0
8574137,"Heerbrugg, Bahnhof",,0.000129,73,4,6,10,81805,87988,169793,30,0.067703,0.113406,42314.9,0,0
8574145,"Altstätten SG, Spital/Heime",,0.000071,73,2,1,3,5232,6122,11354,30,0.06476,0.095622,12324.9,0,0
8509623,"Ruggell, Rathaus",,0.000021,73,3,7,10,6119,5927,12046,44,0.074972,0.119377,4064.509465,0,0
8509635,"Gams, Gasenzen",,0.000014,73,1,1,2,7527,8030,15557,44,0.071768,0.100143,1005.233333,0,0
8506452,"Lüchingen, Dorf",,0.000016,73,1,1,2,9857,17821,27678,35,0.050951,0.064826,145,0,0
8506453,"Marbach SG, Dorf",,0.000024,73,1,1,2,17821,17821,35642,34,0.053594,0.069735,724,0,0
8506454,"Rebstein, Dorf",,0.000032,73,1,1,2,17821,17821,35642,33,0.056532,0.075822,1301,0,0
8506455,"Balgach, Bad",,0.000038,73,1,1,2,17821,17821,35642,32,0.059817,0.083719,1876,0,0
8506456,"Balgach, Rathaus",,0.000043,73,1,1,2,17821,17821,35642,31,0.063513,0.094792,2449,0,0
8506463,"Diepoldsau, Dorf",,0.000028,73,1,1,2,29038,29038,58076,31,0.063513,0.094792,1160,0,0
8574112,"St. Margrethen SG,Industriestr",,0.000029,72,1,3,4,18019,18019,36038,31,0.064322,0.100757,32729.9,0,0
8574136,"Heerbrugg, Schulen",,0.000058,73,1,1,2,18199,18199,36398,31,0.063513,0.094792,3750,0,0
8506458,"Berneck, Rathaus",,0.000011,73,0,1,1,0,18199,18199,36,0.065301,0.087048,0,0,0
8506645,"Abtwil SG, Dufourpark",,0.000016,71,1,1,2,4921,4921,9842,39,0.065525,0.107497,728.666667,0,0
8574257,"St. Gallen, Bleicheli",,0.000046,71,4,11,15,189986,188520,378506,16,0.218663,0.290584,31000.061092,0,0
8574471,"St. Gallen, Marktplatz Bohl",,0.000172,71,9,20,29,350011,344816,694827,15,0.231648,0.322126,61299.509469,0,0
8589553,"St. Gallen, Am Weg",,0.000049,71,2,2,4,68806,68767,137573,14,0.163105,0.201848,2498.68254,0,0
8589554,"St. Gallen, Bach St. Georgen",,0.000018,71,1,2,3,44810,44814,89624,14,0.151832,0.179453,270.233333,0,0
8506461,"Diepoldsau, Storchenbühl",,0.000011,73,0,1,1,0,27033,27033,33,0.056532,0.075822,0,0,0
8506462,"Widnau, Post",,0.00002,73,1,1,2,27033,29038,56071,32,0.059817,0.083719,581,0,0
8506789,"Andwil SG, Post",,0.000023,71,3,1,4,16472,16476,32948,27,0.1117,0.141089,63.116667,0,0
8506876,"Niederwil SG, Dorf",,0.000049,20,3,2,5,12407,12137,24544,27,0.112559,0.144485,11355.350908,0,0
8573933,"Oberbüren, Oberstufe Thurzelg",,0.000043,20,2,2,4,13408,12509,25917,27,0.112607,0.145044,71789.500776,0,0
8573934,"Niederbüren, Freizeitpark",,0.000029,20,1,3,4,5428,6327,11755,27,0.112679,0.146608,64.166667,0,0
8506469,"St. Pelagiberg, Trön",,0.000011,121,0,2,2,0,4265,4265,18,0.108911,0.146711,0,0,0
8506474,"Lütisburg, Dorf",,0.000011,70,0,2,2,0,12908,12908,43,0.049848,0.071156,0,0,0
8506618,"Lichtensteig, Gurtberg",,0.000028,97,1,1,2,3582,3582,7164,43,0.049697,0.069307,3038,0,0
8506479,"Dicken b Dgh, Dorf",,0.000035,97,1,1,2,3379,3379,6758,41,0.053456,0.089576,3390,0,0
8506712,"Waldstatt, Scheidweg",,0.00004,97,1,3,4,9880,9880,19760,41,0.058759,0.1001,8559.3,0,0
8506480,"Degersheim, Hintertschwil",,0.000036,20,2,1,3,5938,7688,13626,13,0.135246,0.178884,99,0,0
8506481,"Degersheim, Ifang",,0.000041,20,1,1,2,7688,7688,15376,12,0.151659,0.196219,128,0,0
8506482,"Wolfertswil, Magdenau",,0.000046,20,1,1,2,7688,7688,15376,11,0.173184,0.220738,155,0,0
8506483,"Wolfertswil, alte Post",,0.00005,20,1,1,2,7688,7688,15376,10,0.202703,0.259101,180,0,0
8506484,"Tuggen, Holeneich",,0.000043,67,1,1,2,8818,8818,17636,23,0.083682,0.101322,288,0,0
8506485,"Rufi, Post",,0.000018,67,1,1,2,5040,4786,9826,19,0.106495,0.122494,52.333333,0,0
8506489,"Tuggen, Gallusplatz",,0.000047,67,1,1,2,8818,8818,17636,22,0.090973,0.113323,535,0,0
8573847,"Gommiswald, Alpenblick",,0.000035,67,2,1,3,5509,5305,10814,16,0.156977,0.188493,792.357143,0,0
8573862,"Kaltbrunn, Sonnhalde",,0.000044,67,1,2,3,9430,9430,18860,16,0.152027,0.189837,1291.047619,0,0
8573863,"Kaltbrunn, Müllisperg",,0.000058,67,2,2,4,14690,14438,29128,16,0.153516,0.190759,1462,0,0
8574439,"Uetliburg SG, Ottenhofen",,0.00003,67,2,1,3,11525,4061,15586,16,0.156977,0.188493,145.333333,0,0
8506496,"Dorf b. Schänis, Landi",,0.000026,67,1,1,2,4786,5038,9824,18,0.118533,0.137609,229.333333,0,0
8506497,"Schänis, Warthausen",,0.000033,67,1,1,2,5038,5292,10330,17,0.13373,0.158519,404.333333,0,0
8573590,"Hintergoldingen, Kapelle",,0.000049,67,1,1,2,5903,5642,11545,47,0.037945,0.050642,1166,0,0
8506499,"Waldkirch, Ronwil",,0.000013,71,1,1,2,4091,8849,12940,31,0.07785,0.092219,1,0,0
8506502,"St. Stephan, Bawald",,0.000059,19,1,1,2,1190,1190,2380,2,0.666667,0.75,18,0,0
8506504,"St. Stephan, Bleiki",,0.000061,19,1,1,2,1190,1190,2380,1,1,1,10,0,0
8506524,"Locarno, Bosco Isolino",,0.000023,101,1,1,2,17316,16554,33870,34,0.078135,0.096091,16,0,0
8506526,"Locarno, Lungolago Motta",,0.000031,101,1,1,2,16554,17316,33870,33,0.084585,0.107811,502,0,0
8506530,"Locarno, Città Vecchia",,0.000021,101,1,1,2,8783,8783,17566,23,0.068079,0.083222,3,0,0
8578883,"Locarno, Piazza Castello",,0.000197,101,7,9,16,176593,175291,351884,32,0.098664,0.154704,20862.184524,0,0
8577726,"Epagny, Prâ Dêrê",,0.000033,13,2,1,3,3363,8463,11826,15,0.112229,0.136501,0,0,0
8506543,"Aminona, Colombire",,0.000013,39,1,1,2,1104,1104,2208,7,0.301587,0.368922,30.266667,0,0
8579473,"Montana, Pavillon",,0.000088,39,6,10,16,34403,34403,68806,19,0.101382,0.195808,8552.5,0,0
8579491,"Crans-s.-S., Etang Long",,0.000076,39,1,4,5,22028,19136,41164,6,0.341772,0.445062,479.466667,0,0
8506613,"Mattwil, Schule",,0.000045,65,1,1,2,4823,4391,9214,46,0.047418,0.067836,7870,0,0
8506742,"Friltschen, Dorf",,0.000027,65,1,1,2,3373,3373,6746,46,0.047418,0.067836,2792,0,0
8506986,"Helsighausen, Kreuzung",,0.000037,65,1,1,2,4801,4801,9602,46,0.047418,0.067836,35982,0,0
8506564,"Hefenhausen, Illharterstrasse",,0.00004,65,2,3,5,9415,12115,21530,50,0.041533,0.056576,6697,0,0
8506565,"Märstetten, Post",,0.000022,65,1,1,2,4580,4801,9381,50,0.041186,0.054121,0,0,0
8506566,"Sonterswil, Volg",,0.000022,65,1,1,2,4614,4614,9228,54,0.035669,0.044387,73,0,0
8506567,"Wagerswil, Dorf",,0.000041,65,2,2,4,7722,7597,15319,49,0.04293,0.058501,9948,0,0
8506594,"Lamperswil TG, Illharterstr.",,0.000035,65,1,1,2,2921,2921,5842,49,0.042881,0.057667,1658,0,0
8506871,"Pfyn, Gemeinde",,0.000029,65,1,2,3,11071,11071,22142,49,0.042964,0.058796,17718,0,0
8506569,"Weinfelden, Giessen",,0.000011,65,0,1,1,0,4823,4823,51,0.038438,0.047818,0,0,0
8506571,"Mauren TG, Dorfstrasse",,0.00002,65,1,1,2,4823,4823,9646,50,0.039949,0.05054,1578,0,0
8506573,"Weinfelden, Pflegeheim",,0.000028,65,1,1,2,4823,4607,9430,49,0.041585,0.0537,3154,0,0
8506874,"Niederuzwil, Augarten",,0.000041,20,2,2,4,153,153,306,44,0.051033,0.083305,4615.998232,0,0
8557093,"Uzwil, Gemeindehaus",,0.000027,20,1,2,3,11574,11574,23148,24,0.070186,0.099726,234,0,0
8573922,"Niederhelfenschwil, Neudorf",,0.000044,20,1,1,2,91,91,182,24,0.069997,0.09588,876,0,0
8573927,"Schwarzenbach SG, Thurbrücke",,0.000022,20,1,1,2,24136,24136,48272,24,0.069997,0.09588,6984,0,0
8506583,"Oberbüren, Eich/Au",,0.000016,20,1,2,3,6326,6327,12653,47,0.051166,0.077837,4,0,0
8506669,"Lenggenwil, Taa",,0.00003,20,1,3,4,6555,6555,13110,45,0.055897,0.093245,3014.958333,0,0
8506673,"Wil SG, Spital",,0.00003,20,1,1,2,91,91,182,47,0.051516,0.082491,5356.5,0,0
8506726,"Niederbüren, Nellen",,0.000032,20,2,3,5,6327,6327,12654,46,0.053257,0.087758,2013.267857,0,0
8506727,"Oberbüren, Rüti",,0.00003,20,2,2,4,10657,10657,21314,47,0.052427,0.08812,268.530154,0,0
8506729,"Jonschwil, Winkel",,0.000032,20,2,2,4,14666,14666,29332,45,0.051183,0.079004,7064.104926,0,0
8506730,"Zuzwil SG, Industrie",,0.000071,20,5,4,9,13020,14650,27670,46,0.054278,0.094182,9979.397634,0,0
8506581,"Henau, Wirmeten",,0.000033,20,2,2,4,9558,9537,19095,45,0.049419,0.074913,6973.281549,0,0
8506589,"Oberuzwil, Evangelische Kirche",,0.000019,20,1,1,2,14573,14573,29146,46,0.047093,0.067003,4073.823377,0,0
8506675,"Jonschwil, Kreisel",,0.000041,20,2,1,3,14666,11802,26468,45,0.049387,0.074296,5566.823377,0,0
8506676,"Rickenbach bei Wil, Zentrum",,0.00002,20,1,2,3,58,37823,37881,45,0.049682,0.076942,249,0,0
8506588,"Bischofszell Stadt, Bahnhof",,0.000016,121,1,3,4,3461,24086,27547,17,0.117572,0.162084,177,0,0
8582162,"Hefenhofen, Sonne",,0.000028,121,1,1,2,4893,5385,10278,17,0.113294,0.142431,346,0,0
8582163,"Amriswil, Kirchstrasse",,0.00006,121,2,3,5,11551,26067,37618,17,0.116699,0.157959,37084,0,0
8583792,"Amriswil, Schrofen",,0.000073,121,2,2,4,7680,7680,15360,17,0.113874,0.147359,1292,0,0
8583839,"Oberaach, Bahnhof",,0.000042,121,1,1,2,4488,4488,8976,17,0.113294,0.142431,0,0,0
8587136,"Frasnacht, Post",,0.000028,121,1,1,2,16803,16397,33200,17,0.113294,0.142431,9701,0,0
8587210,"Schocherswil, alte Post",,0.000055,121,2,1,3,16220,16220,32440,4,0.388889,0.464286,3633,0,0
8506590,"Oberneunforn, Hochberg",,0.000011,65,0,1,1,0,4525,4525,44,0.043101,0.057524,0,0,0
8506591,"Steckborn, Haldenberg",,0.000011,65,0,2,2,0,8444,8444,54,0.03569,0.044957,0,0,0
8506592,"Lanzenneunforn, Schweikhof",,0.000016,65,1,1,2,6658,6658,13316,54,0.035669,0.044387,0,0,0
8506593,"Illhart, Sternen",,0.000028,65,1,1,2,2796,2921,5717,50,0.041142,0.053684,7,0,0
8506595,"Müllheim Dorf, Grüneck",,0.000041,65,2,1,3,11071,11071,22142,52,0.038363,0.049782,3426,0,0
8506627,"Pfyn, Bürgi",,0.000035,65,1,1,2,8444,8601,17045,52,0.038363,0.049782,5016,0,0
8506597,"Reckenwil, Steinberg",,0.000011,65,0,1,1,0,2530,2530,52,0.038412,0.05016,0,0,0
8506628,"Frauenfeld, Langdorf",,0.000076,65,2,2,4,19672,19665,39337,51,0.039869,0.053603,11774,0,0
8506599,"Grub AR, Krähtobel",,0.000011,71,0,3,3,0,11071,11071,37,0.070062,0.114947,0,0,0
8506634,Buechen b. Staad,,0.000011,71,0,2,2,0,7325,7325,35,0.072615,0.10702,0,0,0
8506600,"Niederteufen, Battenhaus",,0.000011,97,0,1,1,0,5493,5493,46,0.046249,0.06328,0,0,0
8506601,"Schwellbrunn, Brisig",,0.000011,97,0,1,1,0,4623,4623,46,0.04716,0.067439,0,0,0
8506602,"Schwellbrunn, Einsiegele",,0.00002,97,1,1,2,4623,4623,9246,45,0.049456,0.073828,1304,0,0
8506603,"Stein AR, Hagtobel",,0.00002,97,1,2,3,5493,5758,11251,45,0.048454,0.068694,1296,0,0
8506604,"Lustmühle, Hauteten",,0.000019,97,1,1,2,5493,5493,10986,45,0.048418,0.067975,0,0,0
8506605,"Stein AR, Rämsen-Störgel",,0.000036,97,2,1,3,5758,5758,11516,44,0.050843,0.074112,3882,0,0
8506606,"Stein AR, Rose",,0.000041,97,1,1,2,5758,5758,11516,43,0.053525,0.081848,5172,0,0
8506607,"Schwellbrunn, Teufen",,0.000028,97,1,2,3,4623,5658,10281,44,0.051989,0.082324,2606,0,0
8506610,Happerswil,,0.000035,65,1,1,2,4607,4607,9214,48,0.043362,0.057441,4728,0,0
8506611,Langrickenbach,,0.00002,65,1,1,2,4704,4921,9625,25,0.06698,0.087076,214,0,0
8506612,"Leimbach TG, Kreuzung",,0.00004,65,1,1,2,4607,4823,9430,47,0.045299,0.062002,6300,0,0
8506614,"Zuben, Käserei",,0.000028,65,1,1,2,4921,4921,9842,24,0.071453,0.096381,426,0,0
8573410,"Bottighofen, Post",,0.000055,65,1,2,3,10629,10629,21258,24,0.072051,0.102461,37368,0,0
8573412,"Scherzingen, Scheidweg",,0.00004,65,1,1,2,9353,9353,18706,24,0.071453,0.096381,213,0,0
8506616,"Krinau, Fabrik Feldmoos",,0.000011,97,0,1,1,0,3582,3582,45,0.04526,0.059021,0,0,0
8506617,"Lichtensteig, Hintergurtberg",,0.00002,97,1,1,2,3582,3582,7164,44,0.047374,0.06362,1520,0,0
8506620,"Lichtensteig, Steigrüti",,0.000039,97,2,1,3,3669,24656,28325,42,0.052262,0.076665,6042,0,0
8506621,"Lichtensteig, St. Loreto",,0.000044,97,1,3,4,24656,24656,49312,41,0.055108,0.087069,7555,0,0
8506622,"Dietfurt, Langensteig",,0.000023,97,1,1,2,3582,3582,7164,45,0.049711,0.07584,0,0,0
8573999,"Bütschwil, Engi",,0.000025,70,1,2,3,12908,12907,25815,42,0.044787,0.067988,117681.566667,0,0
8574006,"Krinau, Rössli",,0.000045,97,1,1,2,3582,3582,7164,42,0.044573,0.065506,4432,0,0
8506623,"Dietfurt, Neudietfurt",,0.000043,97,2,4,6,3669,8056,11725,44,0.052277,0.087312,6092,0,0
8506672,"Wil SG, Adler",,0.000066,20,2,3,5,5713,62248,67961,44,0.056621,0.094593,13445.333333,0,0
8506677,"Wil SG, Lindenhof",,0.000069,20,3,5,8,35528,38418,73946,44,0.051918,0.085342,17121.104926,0,0
8506680,"Hosenruck, Dorf",,0.00003,20,1,3,4,5622,6108,11730,44,0.051731,0.082552,1276.666667,0,0
8506740,"Bronschhofen, Feuerwehrdepot",,0.000035,20,1,2,3,12707,12707,25414,44,0.050637,0.080705,4461,0,0
8506785,"Zuzwil SG, Schule",,0.000041,20,2,2,4,7929,7916,15845,44,0.050912,0.082125,6641.3,0,0
8506852,"Dussnang, Rehaklinik",,0.000041,20,1,2,3,12639,12639,25278,44,0.050606,0.080072,5948,0,0
8506997,"Schwarzenbach SG, Wilerstrasse",,0.000058,20,4,2,6,24136,24110,48246,44,0.050628,0.080115,5105.8,0,0
8507196,"Schwarzenbach, Oberstettenstr.",,0.000036,20,1,1,2,9444,9444,18888,44,0.050595,0.079496,0,0,0
8507441,"Wil SG, Stelz",,0.000023,20,1,1,2,7144,7144,14288,44,0.050595,0.079496,0,0,0
8507444,"Rickenbach bei Wil, Pünt",,0.000042,20,1,2,3,23541,23541,47082,44,0.050628,0.080115,5944,0,0
8508037,"Gähwil, Sportstrasse",,0.000029,20,1,1,2,17684,16618,34302,44,0.050595,0.079496,0,0,0
8573373,"Weinfelden, Maienrain",,0.00007,65,2,2,4,8174,7953,16127,44,0.050944,0.081016,54983,0,0
8573527,"Bichelsee, Dorf",,0.000073,20,2,2,4,14775,15318,30093,44,0.050687,0.080566,69499.5,0,0
8506624,"Oberhelfenschwil, Wigetshof",,0.00002,97,1,1,2,4387,4531,8918,34,0.063539,0.077449,1424.197424,0,0
8506625,"Oberhelfenschwil, Tobelacker",,0.000028,97,1,1,2,4531,4531,9062,33,0.067653,0.084063,1759.197424,0,0
8506626,"Steckborn, Sportplatz Emmig",,0.000029,65,2,1,3,8444,8444,16888,53,0.036967,0.046841,3346,0,0
8506629,Guntalingen,,0.000011,65,0,1,1,0,4234,4234,41,0.050234,0.075429,0,0,0
8506901,"Frauenfeld, Schaffhauserplatz",,0.000099,65,2,5,7,19432,19432,38864,39,0.054335,0.090631,6461,0,0
8506948,"Warth, Gemeindehaus",,0.000051,65,2,2,4,8232,8232,16464,39,0.053927,0.084267,493,0,0
8506632,"Eschenz, Höfen",,0.000011,65,0,1,1,0,8070,8070,44,0.04324,0.058188,0,0,0
8506633,"Ganterschwil, alte Post",,0.000016,70,1,1,2,12821,12813,25634,44,0.041617,0.058954,30,0,0
8506786,"Libingen, Dorf",,0.000011,70,0,1,1,0,5361,5361,44,0.041617,0.058954,0,0,0
8573602,"Wil SG, Bahnhof",,0.000303,20,15,15,30,166641,257554,424195,43,0.053256,0.095157,198453.629183,0,0
8506636,"Adliswil, Sunnau",,0.000026,130,2,3,5,20047,20273,40320,13,0.152874,0.174162,437,0,0
8590463,"Adliswil, Badstrasse",,0.000018,130,1,1,2,9991,9969,19960,15,0.119146,0.134867,0,0,0
8590476,"Adliswil, Ahornweg",,0.000024,130,1,2,3,17037,17040,34077,16,0.143378,0.159517,1495.333333,0,0
8576184,"Zollikon, Bahnhof",,0.000029,86,1,1,2,1000,1000,2000,19,0.078502,0.084742,417,0,0.00213
8508033,"Givisiez, Taconnets",,0.000018,126,1,1,2,11336,16382,27718,24,0.109151,0.141985,0,0,0
8506642,"Düdingen, Leimacker",,0.000017,126,1,1,2,7491,7491,14982,2,0.666667,0.75,32,0,0
8506644,"Düdingen, Gantrischweg",,0.000017,126,1,1,2,25544,25544,51088,21,0.093525,0.161587,48,0,0
8506646,"Düdingen, Zelg",,0.000025,126,1,1,2,25544,25544,51088,20,0.099206,0.169068,57,0,0
8506648,"Düdingen, Blumenrain",,0.000032,126,1,1,2,25544,25544,51088,19,0.105727,0.178049,64,0,0
8506650,"Berg SG, Seeblick",,0.000016,71,1,1,2,8915,8915,17830,28,0.097889,0.117668,6,0,0
8506716,"Trogen, Sandegg",,0.000014,71,1,2,3,80,5480,5560,40,0.059471,0.089727,66.835714,0,0
8506756,"Grub AR, Dorf",,0.000034,71,2,2,4,11070,11071,22141,39,0.063062,0.100689,2382.8,0,0
8506733,"Bernhardzell, Engi",,0.000026,71,3,2,5,8490,9046,17536,30,0.084134,0.102408,32.5,0,0
8506734,"Bernhardzell, Lee",,0.000022,71,1,1,2,8740,8740,17480,30,0.08399,0.100724,0,0,0
8574226,"St. Gallen, Spisegg",,0.000036,71,1,4,5,27359,27358,54717,17,0.17364,0.217023,1776,0,0
8506694,"Roggwil TG, Post",,0.000024,71,1,1,2,8915,8915,17830,27,0.108304,0.134735,523,0,0
8574095,"St. Gallen, Bahnhof",,0.000216,71,22,20,42,280325,494124,774449,24,0.156089,0.253269,112694.281743,0,0
8574223,"St. Gallen, St.Leonhard",,0.00002,71,1,14,15,211485,211506,422991,20,0.165603,0.260439,7408.711321,0,0
8506654,"St. Gallen, Neudorf",,0.000022,71,3,2,5,17273,18159,35432,36,0.071825,0.113885,6977.95,0,0
8506655,"Braunau, Dorf",,0.000011,20,0,1,1,0,12707,12707,47,0.04404,0.059442,0,0,0
8506658,"Schönholzerswilen, Hagenwil",,0.000033,20,2,1,3,3331,3373,6704,48,0.046293,0.062615,2107,0,0
8506659,"Braunau, Hittingen",,0.00002,20,1,1,2,12707,12707,25414,46,0.046038,0.064508,1489,0,0
8506661,"Lenggenwil, Dorf",,0.000022,20,2,1,3,3055,6555,9610,46,0.052969,0.081879,1426.958333,0,0
8506664,"Wuppenau, Obermörenau-Hasenloh",,0.000039,20,1,1,2,3373,5622,8995,47,0.04851,0.067874,3695,0,0
8506665,"Rossrüti, Rislen",,0.000044,20,1,2,3,5622,5622,11244,46,0.050951,0.074608,5281,0,0
8506668,"Stehrenberg, Dorf",,0.000029,20,1,1,2,3373,3373,6746,46,0.050921,0.074026,0,0,0
8506666,"Ennetmoos, Rohren",,0.000011,62,0,2,2,0,6641,6641,50,0.062306,0.096572,0,0,0
8508670,"Kerns, Sand",,0.000016,62,1,3,4,5923,10655,16578,49,0.066295,0.109962,635,0,0
8506670,"Wuppenau, Untermörenau",,0.000054,20,2,1,3,5622,5622,11244,45,0.053619,0.082436,8447,0,0
8506728,"Niederuzwil, Wespiwiese",,0.000023,20,1,2,3,1113,1113,2226,45,0.05024,0.076328,0,0,0
8506735,"Uzwil, Schöntal",,0.000045,20,3,3,6,246,246,492,45,0.052163,0.082645,13932.538259,0,0
8506678,"Wiezikon b. S., Weingarten",,0.000011,20,0,2,2,0,12639,12639,47,0.044045,0.059878,0,0,0
8506690,"Sirnach, Bad",,0.000016,20,1,1,2,10633,10633,21266,47,0.044016,0.059247,0,0,0
8587757,"Wil SG, Breitenloo",,0.000071,20,2,1,3,5622,5622,11244,8,0.211111,0.284837,390.5,0,0
8506693,"Rorschacherberg, Sonnenhof/MZH",,0.000011,72,0,3,3,0,29856,29856,35,0.073216,0.116141,0,0,0
8506685,"Kirchberg SG, Post",,0.000019,20,1,3,4,23541,30528,54069,47,0.044225,0.062083,141,0,0
8506686,"Gähwil, Dorf",,0.000016,20,1,1,2,17151,16618,33769,47,0.044033,0.059274,0,0,0
8506721,"Gossau SG, Gerenstrasse",,0.000035,20,3,3,6,12247,12137,24384,47,0.052381,0.087999,2530.548403,0,0
8506689,"Buch bei Frauenfeld, Dorf",,0.00002,65,1,1,2,4525,4537,9062,43,0.044953,0.061152,501,0,0
8506691,"Oberohringen, Friedenstrasse",,0.000015,68,1,2,3,8804,8806,17610,46,0.056146,0.089194,532.866667,0,0
8506692,"Schlatt ZH, Unterschlatt",,0.000011,68,0,2,2,0,9392,9392,46,0.056198,0.089623,0,0,0
8506896,"Neftenbach, Alte Post",,0.00002,68,2,3,5,4378,7822,12200,45,0.05742,0.090787,1796,0,0
8506899,"Winterthur, Hauptbahnhof",,0.000028,68,3,9,12,23335,74815,98150,45,0.059349,0.104071,4486.35,0,0
8573678,"Neftenbach, Tössallmend",,0.000027,68,1,2,3,3439,3440,6879,17,0.129002,0.179826,297.833333,0,0
8573668,"Schlatt ZH, Schulhaus",,0.000022,68,1,3,4,9206,9241,18447,9,0.212766,0.344484,84,0,0
8574271,"Rorschach, Landhaus",,0.000074,72,1,1,2,36229,36229,72458,19,0.116141,0.134712,5130.166667,0,0
8574282,"Rorschach, Langmoosstrasse",,0.00003,72,1,1,2,13464,13464,26928,21,0.088929,0.098934,352,0,0
8574284,"Rorschacherberg, Zelgstrasse",,0.000039,72,1,1,2,15324,15324,30648,21,0.088929,0.098934,584,0,0
8506695,"Brunnadern, Auboden",,0.000028,97,2,1,3,4355,7497,11852,43,0.052024,0.076235,1104.8,0,0
8506696,"Herisau, Ifang",,0.000023,71,1,2,3,1035,13716,14751,27,0.103861,0.142995,636.4867,0,0
8506774,"Schwellbrunn, Dorf",,0.000037,71,2,2,4,9646,9626,19272,24,0.112892,0.145317,1019.2,0,0
8574188,"Schönengrund, Wohnheim",,0.000061,71,3,2,5,5657,5658,11315,23,0.117271,0.147942,16242.466667,0,0
8506697,"Herisau, Johannesbad",,0.000021,71,1,2,3,9646,9612,19258,26,0.094925,0.117932,158.5,0,0
8506698,"Schwellbrunn, Risi",,0.00002,71,1,1,2,5262,5563,10825,26,0.094676,0.115375,0,0,0
8506703,"St. Gallen, Sonnrainweg",,0.00004,71,2,2,4,41760,41760,83520,26,0.121226,0.159479,1189,0,0
8506708,"Freidorf TG, Kreuzegg",,0.000028,71,1,1,2,8915,8915,17830,26,0.121022,0.157865,0,0,0
8573964,"Bernhardzell, Schöntal",,0.000061,71,1,2,3,9046,9046,18092,26,0.121445,0.16055,7174.270331,0,0
8506704,"Brunnadern, Anker",,0.000035,97,1,1,2,7497,7497,14994,42,0.054836,0.084795,2392.8,0,0
8506706,"Felben, Löwen",,0.000065,65,2,3,5,19667,19672,39339,50,0.041355,0.056367,16165,0,0
8506718,"Hörhausen, Hochstrasse",,0.000029,65,1,2,3,8444,8444,16888,41,0.040567,0.060233,16,0,0
8506709,"Waldstatt, Auerhof",,0.000067,97,3,2,5,10381,10381,20762,42,0.056508,0.092183,13035.284503,0,0
8506710,"Herisau, Glattmüli",,0.000036,71,2,2,4,9913,9646,19559,25,0.104274,0.133155,838.5,0,0
8506773,"Schönengrund, Dorf",,0.000052,97,3,4,7,6442,6565,13007,24,0.108236,0.140977,1375,0,0
8506713,"Hundwil, Sonderau",,0.000051,97,2,1,3,5758,5758,11516,27,0.107296,0.132134,6105.775376,0,0
8506753,"Eggersriet, Post",,0.00002,71,1,1,2,10991,10990,21981,40,0.059371,0.088041,124,0,0
8506857,"Dettighofen, Lanzenneunfornstr",,0.000042,65,2,2,4,6815,6815,13630,40,0.042143,0.063356,211.5,0,0
8506719,"Eschenz, Bornhausen",,0.00002,65,1,1,2,8070,8070,16140,43,0.045104,0.062068,503,0,0
8506720,Kalchrain,,0.000028,65,1,1,2,8070,8070,16140,42,0.047141,0.066931,1004,0,0
8506725,"Uzwil, Gupfenstrasse",,0.000019,20,1,1,2,11150,11574,22724,25,0.065845,0.087802,7,0,0
8506783,"Züberwangen, Zentrum",,0.000036,20,2,2,4,7915,7916,15831,45,0.053866,0.086722,10010.904926,0,0
8506764,"Niederhelfenschwil, Dorf",,0.000024,20,1,2,3,91,182,273,46,0.051162,0.078021,7732.938259,0,0
8573951,"Niederwil SG, Bergwis",,0.000017,71,1,2,3,10657,10657,21314,16,0.119141,0.148181,163,0,0
8581425,"Oberbüren, Kloster Glattburg",,0.000051,71,1,1,2,3269,3269,6538,18,0.097031,0.115434,3759.135134,0,0
8573978,"Flawil, Bahnhof",,0.000076,20,4,5,9,30192,30467,60659,8,0.291667,0.429804,4225,0,0
8506732,"Frauenfeld, Marktplatz",,0.000029,65,2,2,4,14942,14942,29884,39,0.044112,0.069648,654,0,0
8506737,"Bronschhofen, Maugwil",,0.000028,20,1,1,2,12707,12707,25414,45,0.048227,0.071126,2976,0,0
8578598,"Wil SG, Lenzenbüel",,0.000021,20,1,1,2,13975,13975,27950,7,0.266667,0.386607,1296,0,0
8506741,"Weingarten b. Märwil, Dorf",,0.000019,65,1,1,2,3373,3373,6746,47,0.045299,0.062002,1236,0,0
8506745,"Le Cachot, Pt-Cachot de bise",,0.000014,49,1,1,2,2574,2567,5141,30,0.058446,0.095016,386,0,0
8506748,"Rickenbach ZH, Dorf",,0.000011,64,0,1,1,0,7644,7644,5,0.315789,0.422222,0,0,0
8506749,"Rickenbach Sulz, Sunnezirkel",,0.00002,64,1,1,2,7644,7648,15292,4,0.384615,0.483333,5,0,0
8506750,"Alt St. Johann, Dorf",,0.000011,73,0,1,1,0,11883,11883,45,0.062507,0.078041,0,0,0
8506752,"Berneck, Neugass",,0.00002,73,1,2,3,18199,18199,36398,35,0.069801,0.097987,1121,0,0
8574131,"Berneck, Taa",,0.000035,71,1,1,2,3746,3746,7492,35,0.050951,0.064826,558,0,0
8506754,"Ennetbühl, Dorf",,0.00002,73,1,1,2,4376,4376,8752,40,0.039354,0.056957,631,0,0
8506951,"Rüdlingen, Gemeindehaus",,0.000016,68,1,2,3,4117,4681,8798,45,0.04768,0.090063,63,0,0
8506989,"Dorf, Gemeindehaus",,0.000023,68,2,4,6,9073,9076,18149,44,0.049793,0.101617,1173.880952,0,0
8506765,"Oberegg AI, Post",,0.000019,71,1,3,4,3746,7191,10937,37,0.067332,0.104935,1088,0,0
8506767,"Rehetobel, Dorf",,0.000021,71,1,2,3,8607,8689,17296,39,0.062872,0.09908,843.679061,0,0
8506771,"Schachen (Reute), alte Post",,0.000016,71,1,1,2,5136,5257,10393,39,0.062819,0.098275,0,0,0
8506778,"Wald AR, Dorf",,0.000029,71,2,1,3,5980,5980,11960,39,0.062819,0.098275,843.679061,0,0
8506782,"Wolfhalden, Dorf",,0.000033,71,3,1,4,6913,8243,15156,39,0.062819,0.098275,2336,0,0
8574017,"Hemberg, Rohr",,0.000052,97,1,2,3,3605,394,3999,32,0.088624,0.136748,39974.333333,0,0
8574182,"St. Peterzell, Mühle",,0.000049,97,1,2,3,7497,4985,12482,28,0.099318,0.139311,18012.697424,0,0
8574187,"Schönengrund, Postgarage",,0.000054,97,1,2,3,5221,5220,10441,24,0.113707,0.147848,15438.5,0,0
8574195,"Herisau, Lederbach",,0.000078,71,1,3,4,39950,39950,79900,19,0.156008,0.195747,30039.934953,0,0
8506759,"Hundwil, Dorf",,0.000054,97,1,1,2,5758,5758,11516,26,0.119963,0.154936,6611.775376,0,0
8506761,Kaien,,0.000034,71,3,3,6,13216,14171,27387,40,0.059469,0.090747,735.304762,0,0
8574082,"Heiden, Rosental",,0.000036,71,2,2,4,6484,6281,12765,39,0.056793,0.076359,3040.5,0,0
8506763,"Rheinau, Psych. Uniklinik",,0.000011,66,0,1,1,0,6411,6411,43,0.048125,0.075076,0,0,0
8573919,"Zuckenriet, Sproochbrugg",,0.000041,20,2,3,5,3269,3269,6538,28,0.10153,0.128539,72087.167442,0,0
8574123,"Heiden, Bissau",,0.000078,71,4,2,6,6328,6327,12655,37,0.053237,0.068277,10416.1,0,0
8574125,"Oberegg AI, Riethof",,0.000048,71,1,3,4,5835,5835,11670,37,0.055315,0.073385,3454.5,0,0
8574126,"Oberegg AI, Unterdorf",,0.000025,71,1,2,3,4394,4394,8788,37,0.053049,0.067065,65,0,0
8574127,"Reute AR, Hinterdorf",,0.000021,71,1,1,2,4312,4312,8624,37,0.052995,0.066076,0,0,0
8506766,"Oberhelfenschwil, Dorf",,0.000035,97,1,3,4,4531,5166,9697,32,0.07235,0.093966,2092.197424,0,0
8574179,"Brunnadern-Neckertal, Bahnhof",,0.000068,97,4,2,6,11889,11889,23778,31,0.077694,0.100494,18268.86409,0,0
8574858,"Oberhelfenschwil, Metzwil",,0.00005,97,2,2,4,4680,4680,9360,1,1,1,72.666667,0,0
8578577,"Lichtensteig, Obertor",,0.000079,97,4,2,6,24657,24656,49313,18,0.088312,0.174411,2569.833333,0,0
8506769,Rietbad,,0.000028,73,1,2,3,4376,4376,8752,39,0.040901,0.063351,1260,0,0
8506794,"Schwägalp, Passhöhe",,0.000055,73,2,2,4,5043,5043,10086,39,0.040593,0.061608,3141,0,0
8574008,"Wattwil, Bahnhof",,0.000103,97,8,5,13,37205,42391,79596,40,0.048815,0.08367,223519.316667,0,0
8574010,"Wattwil, Post",,0.000028,97,1,4,5,25127,25127,50254,39,0.044673,0.06481,41018.633333,0,0
8506772,"Scherzingen, Post",,0.000028,65,1,1,2,4678,9352,14030,33,0.048762,0.068716,516,0,0
8573375,"Frauenfeld, Bahnhof",,0.00035,65,11,8,19,64968,60826,125794,33,0.054855,0.118529,45335,0,0
8506776,"Stein SG, Dorf",,0.00002,73,1,1,2,11883,11883,23766,44,0.066616,0.085936,1136,0,0
8506781,"Wildhaus, Lisighaus",,0.000023,73,1,1,2,11883,11883,23766,42,0.071084,0.094203,810.8,0,0
8506784,"Zuckenriet, Dorf",,0.000035,20,2,2,4,6756,6769,13525,45,0.054852,0.091103,11441.438259,0,0
8573918,"Lenggenwil, Wiesental",,0.000036,20,1,2,3,6542,6555,13097,29,0.092465,0.113613,63184.229183,0,0
8506787,"Schwägalp, Säntis-Schwebebahn",,0.000023,73,1,2,3,2871,5043,7914,40,0.039295,0.058656,36,0,0
8506793,"Urnäsch, Kräzerli",,0.000041,73,1,1,2,2172,2172,4344,40,0.03907,0.055698,1875,0,0
8506790,"Urnäsch, Sonne Thal",,0.000021,73,1,1,2,2172,2172,4344,43,0.035127,0.046084,12,0,0
8506791,Rossfall,,0.000028,73,1,1,2,2172,2172,4344,42,0.036348,0.048606,635,0,0
8506792,Steinfluh,,0.000035,73,1,1,2,2172,2172,4344,41,0.037659,0.051694,1256,0,0
8506795,"Urnäsch, Kleinwald",,0.000034,73,1,1,2,2172,2172,4344,5,0.333333,0.436111,54,0,0
8506796,"Heiden, Post",,0.000107,71,6,8,14,39651,39595,79246,38,0.06697,0.116295,13457.158123,0,0
8574077,"Heiden, Bahnhof",,0.000022,71,1,2,3,5719,6479,12198,39,0.058579,0.080261,355,0,0
8574104,"Walzenhausen, Wilen",,0.000023,72,1,1,2,3139,3139,6278,38,0.050273,0.062863,8265,0,0
8506860,"Oberegg AI, St. Anton Kapelle",,0.000022,71,1,1,2,1071,1071,2142,38,0.050597,0.062497,0,0,0
8574105,"Walzenhausen, Leuchen",,0.000042,72,2,2,4,4002,4002,8004,37,0.05288,0.068952,12632.7,0,0
8574122,"Berneck, Maienhalde",,0.000022,71,1,1,2,3746,3746,7492,38,0.050597,0.062497,0,0,0
8506798,"Waldkirch, Dorf",,0.000053,71,4,3,7,12673,12673,25346,29,0.091519,0.114481,2288.5,0,0
8506799,"Bernhardzell, Toregg",,0.000026,71,1,2,3,9046,9046,18092,28,0.099264,0.123383,1257.970696,0,0
8573957,"Arnegg, Weideggstrasse",,0.00004,71,1,2,3,16412,16412,32824,29,0.091462,0.113035,3184.833333,0,0
8573958,"Arnegg, Bahnhof",,0.000054,71,3,3,6,25228,24884,50112,28,0.099602,0.125613,4697.483243,0,0
8573959,"Waldkirch, Friedegg",,0.000026,71,1,1,2,4413,3739,8152,28,0.098032,0.118111,0,0,0
8506850,"Fischingen, Sonne",,0.000029,20,2,1,3,12639,12639,25278,46,0.046012,0.064244,2978,0,0
8506851,"Oberwangen TG, Sonnenhof",,0.000035,20,1,1,2,12639,12639,25278,45,0.048199,0.070741,4464,0,0
8506855,"Dingenhart, Brand",,0.000023,65,1,1,2,6112,6112,12224,38,0.044511,0.065333,632,0,0
8506856,"Frauenfeld, Bühl",,0.000031,65,1,1,2,6112,6112,12224,37,0.046435,0.070791,941,0,0
8506881,"Hörhausen, Dorf",,0.000046,65,1,2,3,8444,8444,16888,39,0.043729,0.065829,488.5,0,0
8506858,"Dietingen, Abzweigung",,0.000028,65,1,1,2,4537,4537,9074,42,0.046975,0.065532,1000,0,0
8506859,"Hagenbuch ZH, Egghof",,0.00004,65,2,1,3,14041,14059,28100,37,0.047577,0.075743,984,0,0
8506863,"Steckborn, Eichhölzli",,0.000041,65,2,1,3,8444,8444,16888,40,0.04202,0.060492,180.5,0,0
8506865,"Hagenbuch ZH, Dorf",,0.000045,65,1,2,3,14059,14061,28120,36,0.049798,0.086182,1300,0,0
8573669,"Schlatt ZH, Oberschlatt",,0.000022,68,2,3,5,5722,5721,11443,9,0.22619,0.359921,78,0,0
8580291,"Elsau, Tolhusen",,0.000039,68,1,2,3,9237,9221,18458,5,0.375,0.503704,88,0,0
8506866,"Häuslenen, Zentrum",,0.00003,65,1,2,3,8830,8672,17502,35,0.051017,0.091316,1551,0,0
8506870,"Frauenfeld, Kantonsspital",,0.000037,65,1,1,2,6112,6112,12224,36,0.048541,0.078396,1248,0,0
8573362,"Aadorf, Zentrum",,0.000033,65,1,1,2,8438,8830,17268,35,0.049885,0.081791,616,0,0
8506867,"Horgenbach, Hauptstrasse",,0.000035,65,1,1,2,4537,4537,9074,41,0.049192,0.071031,1497,0,0
8506869,Kartause Ittingen,,0.000011,65,0,1,1,0,4143,4143,36,0.050459,0.082298,0,0,0
8573203,"Stammheim, Bahnhof",,0.000071,65,2,4,6,11290,11279,22569,36,0.050884,0.09361,15312,0,0
8573266,"Hüttwilen, Hörnliwald",,0.000033,65,1,2,3,8070,8070,16140,36,0.050544,0.085901,6573,0,0
8506885,"Lipperswil, Conny Land",,0.000071,65,3,3,6,12336,12336,24672,48,0.044775,0.062984,33735,0,0
8506872,"Frauenfeld, Hauptpost",,0.000055,65,2,3,5,14550,21714,36264,35,0.050853,0.091073,1588,0,0
8573359,"Frauenfeld, Thundorferstrasse",,0.000027,65,1,3,4,14234,14240,28474,35,0.050591,0.0895,56,0,0
8573364,"Frauenfeld, Rosenbergstrasse",,0.000018,65,1,1,2,4709,4709,9418,35,0.049736,0.080406,0,0,0
8573198,"Kleinandelfingen, Bad",,0.00003,66,1,1,2,4234,4245,8479,41,0.042704,0.06461,5384,0,0
8573199,"Ossingen, Bahnhof",,0.000045,66,2,3,5,12252,12253,24505,40,0.044484,0.072366,14444,0,0
8506878,"Rheinau, Schulplatz",,0.00002,66,1,2,3,6006,6009,12015,2,0.75,0.833333,84,0,0
8506879,"Marthalen, Dorf",,0.000019,66,1,1,2,5741,5738,11479,2,0.666667,0.75,0,0,0
8506880,"Formangueires, Moulin",,0.000015,126,1,1,2,3957,3957,7914,16,0.111837,0.126428,6,0,0
8506882,"Lanzenneunforn, Dorf",,0.000048,65,2,1,3,6815,6815,13630,39,0.043601,0.062954,503.5,0,0
8506887,"Niederneunforn, Dorf",,0.00004,65,1,1,2,4537,4537,9074,40,0.051633,0.078451,1992,0,0
8506900,"Frauenfeld, Auenfeld",,0.000063,65,4,1,5,14895,14895,29790,40,0.051633,0.078451,3486,0,0
8506891,"Embrach, Illingerweg",,0.000015,107,1,1,2,21713,21721,43434,22,0.100589,0.115187,0,0,0
8506894,"Freienstein, Alte Brücke",,0.000042,107,3,5,8,26414,26754,53168,22,0.102114,0.120805,1551.666667,0,0.000027
8506895,"Lufingen, Dorf",,0.000029,107,2,2,4,26669,30002,56671,21,0.10941,0.12855,1737,0.000004,0.000001
8573215,"Teufen ZH, Oberteufen",,0.000018,107,1,1,2,3938,3937,7875,29,0.057374,0.06363,0,0.000004,0.000004
8557041,"Rorbas, Bruggi",,0.000033,107,1,1,2,7541,7555,15096,26,0.068911,0.077848,1130,0,0.00016
8573218,"Freienstein, Breite",,0.000044,107,1,1,2,8035,8035,16070,26,0.068911,0.077848,1695,0,0.00016
8573221,"Embrach, Hard",,0.000049,107,2,2,4,18874,18870,37744,35,0.07265,0.085953,4392,0.000152,0.000178
8573222,"Embrach, Embraport",,0.000032,107,1,2,3,18844,18839,37683,35,0.072566,0.085958,40,0.000004,0.000339
8573224,"Embrach, Alterszentrum",,0.000026,107,1,2,3,21729,21725,43454,35,0.072235,0.083981,575.833333,0,0.000187
8507307,"Hettlingen, Gemeindehaus",,0.000029,68,4,3,7,7722,7716,15438,44,0.049137,0.09503,2668.357143,0,0
8557081,"Buch am Irchel, Bebikon",,0.000019,68,2,1,3,928,928,1856,18,0.112645,0.143601,11.683333,0,0
8573657,"Winterthur, Deutweg",,0.000014,68,1,2,3,14342,14345,28687,18,0.120766,0.162438,72,0,0
8573658,"Winterthur, Waldegg",,0.000017,68,1,3,4,14093,14097,28190,18,0.127046,0.179512,136.333333,0,0
8573659,"Winterthur, Schulhaus Seen",,0.000016,68,1,2,3,12446,16614,29060,18,0.116129,0.154261,70,0,0
8573656,"Winterthur, Obertor",,0.000014,68,1,6,7,25878,25868,51746,21,0.083958,0.110469,163,0,0
8576177,"Winterthur, Auwiesen",,0.000035,68,1,1,2,4108,4111,8219,21,0.079159,0.089064,3862,0,0
8573673,"Winterthur, Blumenau",,0.000034,68,1,3,4,14720,14712,29432,17,0.133741,0.192653,375.778571,0,0
8573675,"Winterthur, Langwiesen",,0.00003,68,1,3,4,12994,12992,25986,16,0.157371,0.233141,74,0,0
8573693,"Winterthur, Friedhof",,0.000026,68,1,2,3,11873,11876,23749,16,0.135751,0.185144,131,0,0
8576746,"Winterthur, Waser",,0.000019,68,1,1,2,12448,12446,24894,16,0.145794,0.190968,0,0,0
8576181,"Winterthur, Sulzer",,0.000032,68,1,2,3,12857,12868,25725,13,0.148889,0.202512,2783.333333,0,0
8580458,"Winterthur, Gewerbeschule",,0.000078,68,4,4,8,26238,26235,52473,14,0.168704,0.25467,959.066667,0,0
8506902,"Eschenz, Barriere",,0.000028,65,1,1,2,8070,8070,16140,40,0.051266,0.075375,0,0,0
8506963,"Hüttwilen, Stutheien",,0.000036,65,1,1,2,5216,5216,10432,39,0.04477,0.06787,672,0,0
8506916,"Bettens, village",,0.00002,5,1,1,2,3783,3783,7566,29,0.071319,0.0842,1253,0,0
8570068,"Sullens, Auberge",,0.000035,5,1,1,2,4935,4963,9898,29,0.071319,0.0842,3091.166667,0,0
8506905,"Bussigny, Tatironne",,0.000015,5,1,1,2,12750,12192,24942,10,0.153409,0.184164,3,0,0
8506909,"Riazzino, Bolla",,0.000021,108,2,2,4,18237,18503,36740,60,0.055905,0.098668,3392.808333,0,0
8575122,"Bellinzona, P. Indipendenza",,0.000027,108,1,2,3,17728,46145,63873,60,0.053727,0.094147,9850.833333,0,0
8575126,"Giubiasco, Piazza",,0.000048,108,2,2,4,52424,61532,113956,60,0.053809,0.094496,3246,0,0
8575165,"Gudo, Malcantone",,0.000044,108,1,1,2,18001,18001,36002,36,0.064473,0.072576,3738,0,0
8506920,"Belfaux, route de Lossy",,0.000024,126,1,1,2,3957,3957,7914,15,0.125,0.140872,140,0,0
8506922,"Robasacco, Via Cantonale",,0.000011,108,0,2,2,0,1549,1549,15,0.116995,0.150244,0,0,0
8573329,"Cadenazzo, Scuole Elementari",,0.000016,108,1,2,3,131,431,562,15,0.116049,0.146523,1,0,0
8506924,"Lossy, école",,0.000031,126,1,1,2,3957,3957,7914,14,0.141807,0.160241,272,0,0
8506928,"Murten, Löwenberg Einkaufsztr",,0.000011,126,0,1,1,0,2976,2976,12,0.13828,0.160811,0,0,0
8506932,Grands Clos,,0.000026,49,1,1,2,5742,5743,11485,21,0.082591,0.104299,539,0,0
8571838,"Les Ponts-de-Martel, gare",,0.000075,134,3,4,7,8816,8816,17632,14,0.134927,0.180123,13003.089286,0,0
8571855,"Fleurier, collège régional",,0.000075,49,4,2,6,12071,12663,24734,20,0.089676,0.120916,16615.5,0,0
8571867,"La Brévine, ch. du Baillod",,0.000071,49,1,1,2,4585,4585,9170,20,0.088253,0.115002,2368,0,0
8506937,"Schluein, Isla",,0.000011,110,0,2,2,0,2908,2908,9,0.235577,0.292841,0,0,0
8509729,"Schluein, vitg",,0.000033,110,3,4,7,5482,5498,10980,8,0.279621,0.351877,174,0,0
8509786,"Laax GR, posta",,0.000043,110,2,5,7,5280,4220,9500,9,0.252252,0.338081,144,0,0
8574874,"Laax GR, Demvitg",,0.000047,110,3,3,6,4829,4829,9658,8,0.266304,0.332872,312.75,0,0
8574879,"Falera, Parcadi",,0.000032,110,2,3,5,3510,3510,7020,8,0.266667,0.334598,40.083333,0,0
8574990,"Ilanz, Plazza Cumin",,0.000068,110,6,4,10,6452,7523,13975,7,0.291925,0.361905,574.75,0,0
8506939,"Guttannen, Aegerstein",,0.000011,114,0,1,1,0,1890,1890,26,0.0805,0.102134,0,0,0
8506953,"Oberneunforn, Gemeindehaus",,0.000028,65,1,1,2,4537,4537,9074,39,0.044106,0.064704,98,0,0
8506954,"Oberstammheim, Post",,0.000059,65,3,2,5,9450,9467,18917,40,0.052784,0.084362,2988,0,0
8506955,"Frauenfeld, Osterhalden",,0.000034,65,1,1,2,4537,4536,9073,38,0.046001,0.070148,413,0,0
8506967,"Weiningen TG, Dorfplatz",,0.000079,65,1,3,4,14895,14672,29567,37,0.048873,0.085849,6596,0,0
8573300,"Warth, Kreuz",,0.000049,65,3,2,5,8341,8341,16682,35,0.052979,0.095085,21783,0,0
8506957,"Frauenfeld, Römerstrasse",,0.000071,65,2,1,3,8601,8601,17202,38,0.045448,0.067833,1620,0,0
8506969,"Pfyn, Ost",,0.000043,65,2,2,4,11071,11071,22142,38,0.046158,0.075349,1246,0,0
8507944,"Wigoltingen, Fabrikstrasse",,0.000037,65,1,1,2,6457,6457,12914,38,0.045448,0.067833,928.5,0,0
8575937,"Tagelswangen, Oberwis",,0.000023,84,2,4,6,26074,26081,52155,21,0.079719,0.100754,324.666667,0,0.000001
8576163,"Bassersdorf, Rietli",,0.000033,84,2,2,4,7525,7524,15049,21,0.078335,0.093615,2650.833333,0.000088,0
8506966,"Weiningen TG, Weckingen",,0.00008,65,3,1,4,14895,14895,29790,38,0.046729,0.074662,6281,0,0
8506968,"Eschenbach SG, Post",,0.000052,67,3,5,8,10611,18499,29110,42,0.0468,0.086635,10587.569048,0,0
8509434,"Neuhaus SG, Hinterwis",,0.00002,67,1,1,2,10651,10341,20992,45,0.041418,0.065812,0,0,0
8573595,"Eschenbach SG, Sternen",,0.000103,67,4,3,7,27983,27969,55952,42,0.04661,0.081261,24659.490476,0,0
8573598,"Neuhaus SG, Ochsen",,0.000036,67,1,3,4,32037,32347,64384,42,0.046534,0.08124,3346.714286,0,0
8573859,"Eschenbach SG, Mettlen",,0.00005,67,1,1,2,6300,6300,12600,42,0.046213,0.077931,7524,0,0
8573586,"Wald ZH, Bahnhof",,0.000068,67,3,3,6,4712,6772,11484,22,0.143156,0.217936,3157,0,0
8573596,"Eschenbach SG, Breiten",,0.000066,67,3,3,6,32412,32403,64815,44,0.043171,0.075597,1784.714286,0,0
8573599,"Wald ZH, Gemeindehaus",,0.00003,67,1,4,5,2844,2302,5146,12,0.217839,0.277222,364.5,0,0
8574473,"Uznach, Bahnhof",,0.000237,67,8,10,18,38224,33568,71792,14,0.219373,0.310068,17206.385714,0,0
8576072,"Tann, Blatt",,0.000062,67,2,2,4,3495,3551,7046,12,0.211039,0.258791,1845.5,0,0
8576090,"Rapperswil SG, Bahnhof",,0.000082,67,5,4,9,53863,64163,118026,13,0.202605,0.268053,30475.640476,0,0
8576102,"Bubikon, Bahnhof",,0.000154,8,5,5,10,38208,36763,74971,12,0.222807,0.287786,5060.511905,0,0
8576103,"Rüti ZH, Bahnhof",,0.0002,67,13,13,26,28644,32688,61332,11,0.266355,0.370332,41769.921429,0,0
8506975,"Basadingen, Unterdorf",,0.000033,65,1,1,2,4993,7038,12031,37,0.048559,0.079745,147,0,0
8573202,Waltalingen,,0.000037,65,1,1,2,4252,4252,8504,37,0.048559,0.079745,14570,0,0
8506977,"Homburg, Dorf",,0.000067,65,2,2,4,2104,2763,4867,39,0.043242,0.066481,2167,0,0
8506978,"Unterhörstetten, Dorf",,0.00004,65,1,1,2,2530,2530,5060,38,0.044776,0.06675,2422,0,0
8573336,"Pfyn, Frohsinn",,0.000057,65,1,2,3,8601,8601,17202,34,0.053985,0.101605,5665.5,0,0
8506979,"Wigoltingen, Dorf",,0.000029,65,1,1,2,6457,6457,12914,40,0.04239,0.064065,45,0,0
8506984,"Raperswilen, Dorf",,0.000031,65,1,1,2,2921,2921,5842,40,0.04239,0.064065,180,0,0
8506985,"Fruthwilen, Schreinerei",,0.000031,65,1,1,2,4801,4801,9602,47,0.045299,0.062002,34430,0,0
8557098,"Oberneunforn, Stocke",,0.000036,68,1,1,2,4251,4252,8503,44,0.046374,0.07774,2772,0,0
8573388,"Rüdlingen, Spitzrüti",,0.000023,68,2,4,6,4682,9339,14021,14,0.156535,0.234516,219.652381,0,0
8573700,"Dägerlen, Lindenhof",,0.000029,68,1,1,2,6017,5993,12010,15,0.123649,0.163427,154,0,0
8507003,Gümligen,,0.000026,11,1,3,4,38634,38618,77252,27,0.076873,0.106393,780,0,0
8507005,Rubigen,,0.000018,11,1,1,2,19581,19581,39162,27,0.076115,0.100231,0,0,0
8507062,Muri,,0.000023,44,2,6,8,34648,34650,69298,25,0.123682,0.168063,730.921429,0,0
8507063,Worb Dorf,,0.000041,44,2,3,5,60718,59417,120135,25,0.121963,0.158341,552112,0,0
8507067,Deisswil,,0.000042,11,1,1,2,33318,33318,66636,8,0.184466,0.239787,57,0,0
8507075,Toffen,,0.000057,11,1,1,2,19352,19352,38704,28,0.071386,0.090617,3000,0,0
8507078,Wabern bei Bern,,0.000051,11,1,1,2,34544,34544,69088,31,0.059062,0.070845,688,0,0
8507079,Bern Weissenbühl,,0.000082,11,2,1,3,34569,34554,69123,30,0.062664,0.076719,1276,0,0
8507002,Ostermundigen,,0.000052,11,2,3,5,39274,39294,78568,27,0.076554,0.105708,2951.086602,0,0
8507096,Papiermühle,,0.000082,11,1,1,2,49536,49536,99072,5,0.326531,0.382292,240,0,0
8508052,Bern Tiefenau,,0.000043,11,1,2,3,29350,29350,58700,5,0.34,0.418627,749,0,0
8508053,Steinibach,,0.000029,11,1,1,2,29100,29572,58672,5,0.326531,0.382292,0,0,0
8508054,Worblaufen,,0.000151,11,4,4,8,114585,99116,213701,4,0.454545,0.561111,3945,0,0
8508058,Urtenen,,0.000051,11,1,1,2,34740,34740,69480,4,0.4,0.458333,20,0,0
8508086,Utzenstorf,,0.000069,11,1,2,3,18698,18683,37381,10,0.202643,0.279822,2452,0,0
8508089,Biberist Ost,,0.000049,11,1,1,2,18099,7011,25110,10,0.19457,0.256709,86,0,0
8508200,Worb SBB,,0.000033,11,2,2,4,19201,19098,38299,10,0.198198,0.273602,816,0,0
8508201,Tägertschi,,0.000025,11,1,1,2,9977,9977,19954,10,0.19457,0.256709,0,0,0
8507093,Kehrsatz Nord,,0.000059,11,1,2,3,34529,34293,68822,27,0.075854,0.10046,2920,0,0
8508207,Langnau i.E.,,0.000107,11,5,3,8,37772,47507,85279,8,0.229358,0.343857,13756.884524,0,0
8508265,Hasle-Rüegsau,,0.000139,11,4,3,7,38901,20012,58913,4,0.470588,0.614583,4748,0,0
8508266,Lützelflüh-Goldbach,,0.00005,11,1,2,3,19713,19526,39239,3,0.5,0.595238,3152,0,0
8508269,Neumühle,,0.000032,11,1,1,2,9299,9088,18387,2,0.666667,0.75,4,0,0
8507007,Wichtrach,,0.000037,11,1,1,2,19065,19065,38130,28,0.070584,0.088562,1472,0,0
8507008,Kiesen,,0.000042,11,1,1,2,19065,19065,38130,27,0.075815,0.09889,1320,0,0
8507050,Egghölzli,,0.000011,44,0,3,3,0,57983,57983,26,0.110937,0.141702,0,0,0
8507053,Siloah,,0.000023,44,1,2,3,26400,26404,52804,26,0.108481,0.133228,781,0,0
8507055,Langenloh,,0.000028,44,1,1,2,25131,25132,50263,26,0.108247,0.13164,777,0,0
8507061,Brunnadernstrasse,,0.000031,44,1,3,4,76087,76140,152227,25,0.122317,0.160829,226.333333,0,0
8507052,Melchenbühl,,0.000014,44,1,1,2,26397,26400,52797,27,0.097978,0.115463,3,0,0
8507054,Rüfenacht BE,,0.000021,44,1,1,2,25133,25131,50264,27,0.097788,0.114689,3,0,0
8507060,Helvetiaplatz,,0.000048,44,3,2,5,49739,79134,128873,25,0.121231,0.156667,3422.111905,0,0
8588988,Aegertenstrasse,,0.000017,44,1,1,2,6124,6124,12248,12,0.127517,0.157328,3480,0,0
8507912,Rain,,0.000011,44,0,1,1,0,2987,2987,26,0.11426,0.142394,0,0,0
8507919,Deisswil,,0.000011,44,0,2,2,0,194,194,25,0.125293,0.158573,0,0,0
8508076,Kappelisacker,,0.00003,44,4,7,11,12650,18331,30981,25,0.128799,0.174966,13719.829762,0,0
8508094,Hirschen,,0.000018,44,2,1,3,4654,4654,9308,16,0.159854,0.19347,0,0,0
8576646,Bern Bahnhof,,0.000167,44,17,24,41,153322,175433,328755,23,0.159322,0.237666,570166.48228,0,0
8576996,Wankdorfplatz,,0.000031,44,2,5,7,32954,33018,65972,9,0.212403,0.273256,13429.133333,0,0
8577013,Melchenbühl,,0.000057,44,1,1,2,3583,3583,7166,18,0.086876,0.11034,740,0,0
8507064,Vechigen,,0.000023,11,1,1,2,33318,33318,66636,11,0.13253,0.192696,2223,0,0
8507065,Boll-Utzigen,,0.00003,11,1,1,2,33318,33318,66636,10,0.145833,0.204856,1503,0,0
8507066,Stettlen,,0.000036,11,1,1,2,33318,33318,66636,9,0.162602,0.22002,781,0,0
8507068,Bolligen,,0.000085,11,3,1,4,49670,49528,99198,7,0.214286,0.267196,1698,0,0
8507069,Ittigen bei Bern,,0.000083,11,1,1,2,49528,49536,99064,6,0.257576,0.308824,970,0,0
8507070,Uetendorf,,0.000038,11,1,1,2,19168,19352,38520,33,0.052977,0.061643,3660,0,0
8507071,Seftigen,,0.000043,11,1,1,2,19352,19352,38704,32,0.055848,0.065516,3532,0,0
8507072,Burgistein,,0.000048,11,1,1,2,19352,19352,38704,31,0.059054,0.070055,3402,0,0
8507073,Thurnen,,0.000051,11,1,1,2,19352,19352,38704,30,0.062656,0.075479,3270,0,0
8507074,Kaufdorf,,0.000055,11,1,1,2,19352,19352,38704,29,0.066733,0.082131,3136,0,0
8507076,Belp,,0.000087,11,2,2,4,52315,52671,104986,27,0.076746,0.102335,5790,0,0
8507077,Kehrsatz,,0.000048,11,1,1,2,34544,34544,69088,32,0.055857,0.066074,830,0,0
8507082,Bern  Europaplatz,,0.000107,11,2,2,4,52503,52478,104981,29,0.066741,0.084571,9914,0,0
8507083,Köniz,,0.000057,11,1,1,2,17949,17944,35893,8,0.222222,0.339732,5944,0,0
8507084,Moos,,0.000059,11,1,1,2,17944,17949,35893,7,0.25,0.370408,5208,0,0
8507085,Gasel,,0.000061,11,1,1,2,17949,17949,35898,6,0.285714,0.408333,4470,0,0
8507086,Niederscherli,,0.000063,11,1,1,2,17949,17949,35898,5,0.333333,0.456667,3730,0,0
8507087,Mittelhäusern,,0.000064,11,1,1,2,17949,17958,35907,4,0.4,0.520833,2988,0,0
8507088,Lanzenhäusern,,0.000066,11,1,1,2,17958,17949,35907,3,0.5,0.611111,2244,0,0
8507089,Schwarzenburg,,0.000067,11,1,1,2,17949,17958,35907,2,0.666667,0.75,1498,0,0
8507091,Liebefeld,,0.000067,11,1,1,2,17958,17949,35907,1,1,1,750,0,0
8507092,Belp Steinbach,,0.000057,11,1,1,2,34529,34529,69058,28,0.070618,0.089218,3079,0,0
8507475,Kandersteg,,0.000068,4,1,2,3,8503,8503,17006,19,0.108861,0.191581,1452,0,0
8507476,Blausee-Mitholz,,0.00004,11,1,1,2,220,220,440,19,0.106599,0.172333,0,0,0
8507298,Wimmis,,0.000122,11,1,2,3,13397,13395,26792,18,0.114286,0.199228,1475.5,0,0
8507299,Lattigen bei Spiez,,0.000063,11,1,1,2,9494,9494,18988,18,0.111748,0.178696,0,0,0
8507478,Frutigen,,0.000094,11,3,2,5,8997,12512,21509,18,0.116477,0.206564,2820,0,0
8507481,Mülenen,,0.000054,11,1,1,2,12229,12227,24456,18,0.111748,0.178696,39,0,0
8508001,Schönbühl SBB,,0.000073,11,3,1,4,10261,10254,20515,26,0.07916,0.104238,1225.171873,0,0
8507110,Zytglogge,,0.000055,44,4,11,15,79108,132654,211762,24,0.136804,0.195137,554591.985714,0,0
8507250,Scheyenholz,,0.000015,44,1,1,2,25120,25133,50253,26,0.10902,0.12883,0,0,0
8508074,"Münchenbuchsee, Kirche",,0.000024,44,2,3,5,8928,8928,17856,25,0.127226,0.16631,929.433333,0,0
8508077,"Zollikofen, Hirzenfeld",,0.000043,44,5,7,12,12598,20321,32919,24,0.140723,0.191725,7573.290476,0,0
8530259,Hofgut,,0.000035,44,1,5,6,26401,26403,52804,24,0.138933,0.1868,1224,0,0
8571342,"Bern, Inselplatz",,0.000055,44,3,5,8,50044,50042,100086,24,0.136133,0.183736,57291.271429,0,0
8571359,"Bern, Länggasse",,0.000042,44,1,4,5,17451,17452,34903,24,0.137195,0.184028,10930.995238,0,0
8571392,"Zollikofen, Bahnhof",,0.000086,44,4,5,9,23403,23245,46648,24,0.140193,0.188141,15331.209524,0,0
8571393,Eigerplatz,,0.000017,44,2,5,7,26567,47361,73928,24,0.139459,0.188149,24707.816667,0,0
8571395,"Wabern, Tram-Endstation",,0.000028,44,3,4,7,27739,27889,55628,24,0.13978,0.186445,44605.074271,0,0
8571415,"Köniz, Schloss",,0.000054,44,1,4,5,19298,19152,38450,24,0.138785,0.183546,14675.657143,0,0
8571435,Holenacker,,0.000027,44,1,2,3,23790,23734,47524,24,0.137993,0.180709,1828.166667,0,0
8571436,Bachmätteli,,0.000015,44,1,2,3,22457,23802,46259,24,0.137993,0.180709,4452,0,0
8571521,"Ins, Bahnhof",,0.000107,117,4,5,9,11305,10825,22130,24,0.137515,0.181985,91148.393983,0,0
8571733,"Boll-Utzigen, Bahnhof",,0.000028,47,3,4,7,7631,9344,16975,24,0.139937,0.186719,9423.825,0,0
8576447,"Brügg BE, Möschler",,0.000086,87,4,5,9,53189,53180,106369,20,0.164884,0.210456,64083.207143,0,0
8576460,"Bolligen, Sternen",,0.000078,44,3,4,7,11940,18332,30272,24,0.139344,0.187582,9248.833333,0,0
8580939,Europaplatz Bahnhof,,0.000056,44,2,4,6,47597,47648,95245,10,0.214286,0.289777,1569,0,0
8587479,Schosshalde,,0.000064,44,4,2,6,18538,18449,36987,10,0.209068,0.270578,2518.8,0,0
8582262,"Bern Brünnen Westside, Bahnhof",,0.000089,44,2,3,5,31713,23801,55514,10,0.207792,0.274683,1466,0,0
8587485,Rosengarten,,0.00006,44,2,4,6,23674,23676,47350,11,0.216216,0.2901,3381.978571,0,0
8576990,Guisanplatz Expo,,0.000041,44,5,5,10,35217,36292,71509,15,0.189401,0.25121,13667.619589,0,0
8579896,Hirschengraben,,0.000049,44,6,8,14,127628,127638,255266,8,0.249505,0.332379,8924.502381,0,0
8579897,Kocherpark,,0.000028,44,3,9,12,93222,93222,186444,10,0.231061,0.318693,10420.872597,0,0
8587481,Burgernziel,,0.000034,44,1,2,3,23221,23171,46392,10,0.205882,0.267527,45.5,0,0
8588174,Weltpostverein,,0.000059,44,4,3,7,31533,31506,63039,10,0.207895,0.277105,4780.634271,0,0
8588562,Gurtenbahn,,0.000038,44,4,4,8,24995,24931,49926,10,0.216438,0.301577,3579.490736,0,0
8588699,Wankdorf Center,,0.000041,44,3,3,6,32967,33007,65974,10,0.210243,0.281191,3811.785873,0,0
8507150,Thun (See),,0.000011,21,0,2,2,0,1525,1525,5,0.341463,0.430952,0,0,0
8507153,Gunten (See),,0.000031,21,1,1,2,1322,1322,2644,5,0.314286,0.381818,22,0,0
8507151,Hilterfingen (See),,0.000016,21,1,1,2,1322,1302,2624,7,0.216667,0.287912,2,0,0
8507152,Oberhofen am Thunersee,,0.000024,21,1,1,2,1302,1322,2624,6,0.255319,0.323611,13,0,0
8507154,Spiez Schiffstation,,0.000042,21,2,2,4,1525,1505,3030,4,0.416667,0.508333,40,0,0
8507155,Merligen (See),,0.000029,21,1,1,2,1340,1360,2700,4,0.391304,0.453704,0,0,0
8507156,Beatenbucht (See),,0.000053,21,2,3,5,1525,1525,3050,3,0.571429,0.666667,48,0,0
8507157,Beatushöhlen-Sundlauenen,,0.000026,21,1,2,3,1196,1176,2372,3,0.538462,0.619048,0,0,0
8507158,Neuhaus (Unterseen) (See),,0.000037,21,2,3,5,1175,1195,2370,2,0.666667,0.75,20,0,0
8507159,Gwatt Deltapark (See),,0.000021,21,1,1,2,203,203,406,3,0.454545,0.533333,0,0,0
8507166,Faulensee (See),,0.000072,21,2,2,4,1424,1298,2722,1,1,1,10,0,0
8507161,Hünibach (See),,0.000066,21,4,2,6,1424,1424,2848,2,0.666667,0.75,26,0,0
8507164,Einigen (See),,0.000039,21,1,1,2,203,203,406,2,0.6,0.666667,0,0,0
8507167,Leissigen (See),,0.000052,21,2,1,3,203,203,406,1,1,1,5,0,0
8507172,"Hünibach, Chartreuse",,0.000011,43,0,3,3,0,6561,6561,18,0.123779,0.146525,0,0,0
8576869,"Hünibach, Seematte",,0.00006,43,1,1,2,4341,4341,8682,24,0.077329,0.160752,3262,0,0
8576870,"Hünibach, Stationsstrasse",,0.000068,43,3,3,6,4791,4791,9582,23,0.081905,0.202868,3246,0,0
8507173,"Hilterfingen, Post",,0.000014,43,1,1,2,6501,6501,13002,19,0.138952,0.166221,466,0,0
8507175,"Oberhofen a. T., Längenschach.",,0.000014,43,1,2,3,2905,2905,5810,26,0.132631,0.162499,0,0,0
8590399,"Thun, Untere Wart",,0.000033,43,2,2,4,420,420,840,3,0.5,0.633333,130,0,0
8507181,"Thun, Lauitor",,0.000014,43,1,4,5,6021,6020,12041,24,0.102775,0.128869,720,0,0
8507180,"Thun, Bahnhof",,0.000068,43,7,19,26,8270,50971,59241,24,0.173506,0.253345,5129.5,0,0
8507399,"Heimenschwand, Post",,0.000014,43,1,6,7,1468,2728,4196,29,0.116177,0.157738,486.833333,0,0
8507400,"Fahrni, Dörfli",,0.000016,43,2,1,3,1080,1080,2160,29,0.111571,0.137804,2,0,0
8507406,"Heiligenschwendi, Haltenegg",,0.000014,43,1,2,3,870,930,1800,31,0.089635,0.10688,12,0,0
8507873,"Wattenwil, Ey",,0.000023,43,1,2,3,1857,1857,3714,21,0.114537,0.145736,246,0,0
8507245,"Reutigen, Hintere Gasse",,0.000014,43,1,2,3,209,209,418,18,0.134444,0.169397,0,0,0
8507403,"Unterlangenegg, Kreuzweg",,0.000032,43,3,5,8,2219,2219,4438,28,0.126101,0.170233,828.916667,0,0
8507411,"Steffisburg, Schiessstand",,0.000025,43,2,2,4,1080,1079,2159,28,0.120973,0.156469,348,0,0
8507871,"Heiligenschwendi, Alte Post",,0.000061,43,3,2,5,2639,2639,5278,28,0.120632,0.155285,2382,0,0
8508987,"Süderen, Oberei",,0.000031,43,2,2,4,810,810,1620,28,0.12137,0.15774,400.833333,0,0
8507529,"Därligen, Tracht",,0.000011,43,0,3,3,0,6246,6246,25,0.135559,0.183285,0,0,0
8507877,"Spiez, Altersheim",,0.000028,43,2,2,4,4464,4464,8928,27,0.126751,0.171144,1140.047339,0,0
8507878,"Spiezwiler, Rössli",,0.000034,43,3,3,6,6217,6446,12663,27,0.127948,0.174001,2896.588655,0,0
8507879,"Aeschi b. Spiez, Wachthubel",,0.000049,43,4,2,6,3800,3800,7600,27,0.12693,0.171509,630.364006,0,0
8571310,"Interlaken West, Bahnhof",,0.000152,43,10,7,17,43079,43199,86278,24,0.138839,0.199595,11764.642857,0,0
8571330,"Reichenbach i. K., Bahnhof",,0.000033,43,2,2,4,3450,3449,6899,27,0.127839,0.172447,2457.421989,0,0
8571708,"Thun, Berntor",,0.000077,43,6,4,10,8454,8575,17029,27,0.135896,0.187133,6190.583333,0,0
8576318,"Frutigen, Bahnhof",,0.000093,43,3,4,7,16398,16041,32439,27,0.129276,0.178618,10648.588655,0,0
8507892,"Höfen, Dorf",,0.00002,43,2,4,6,1227,1227,2454,17,0.141066,0.18442,339,0,0
8571722,"Teuffenthal, Burghalten",,0.000065,43,1,2,3,690,690,1380,20,0.134132,0.172169,2464,0,0
8576333,"Spiez, Bahnhof",,0.000128,43,9,11,20,21880,27357,49237,26,0.143134,0.21558,30939.397059,0,0
8576338,"Spiez, Oberlandstrasse",,0.000025,43,2,6,8,8683,8178,16861,20,0.14503,0.196856,1463.166667,0,0
8576555,"Thun, Rebgässli",,0.000082,43,1,1,2,2579,2579,5158,20,0.12549,0.159037,2898,0,0
8507889,"Thierachern, Wahlen",,0.000031,43,1,4,5,2247,2277,4524,19,0.14665,0.21032,779,0,0
8507899,"Thierachern, mittlerer Schwand",,0.000036,43,1,3,4,1947,1947,3894,19,0.145212,0.204341,447,0,0
8571654,"Wattenwil, Postgasse",,0.000091,43,2,4,6,4104,4075,8179,19,0.145151,0.208197,17916,0,0
8576557,"Thun, Sternenplatz",,0.000018,43,2,1,3,2849,2849,5698,19,0.142857,0.195116,156.166667,0,0
8576558,"Thun, Marktgasse",,0.000145,43,7,1,8,13729,13750,27479,19,0.142857,0.195116,23834.95,0,0
8576559,"Thun, Postbrücke",,0.000189,43,6,16,22,36134,36078,72212,18,0.165919,0.26982,44221.783333,0,0
8576834,"Allmendingen, RAZ",,0.000063,43,1,1,2,1227,1227,2454,15,0.109739,0.14121,667,0,0
8576842,"Niederstocken, Säge",,0.000048,43,1,3,4,1077,1077,2154,12,0.188144,0.264798,4247.333333,0,0
8576376,"Interlaken Ost, Bahnhof",,0.000099,43,6,8,14,25374,25450,50824,25,0.131339,0.274464,7098.247619,0,0
8507186,"Sundlauenen, Beatushöhlen",,0.000014,43,1,1,2,779,779,1558,26,0.109137,0.133805,693,0,0
8507187,"Unterseen, Neuhaus",,0.000023,43,1,1,2,779,779,1558,25,0.122191,0.157983,1066,0,0
8507490,"Bönigen, Dorf",,0.000036,43,2,3,5,4481,7006,11487,25,0.122711,0.163519,1206,0,0
8507867,"Unterseen, Spital Interlaken",,0.000011,43,0,3,3,0,7216,7216,25,0.123491,0.163412,0,0,0
8507868,"Ringgenberg, Säge",,0.000041,43,1,3,4,8202,8202,16404,24,0.12579,0.171258,1242,0,0
8507893,"Interlaken, Zentralplatz",,0.000041,43,4,2,6,18578,18563,37141,25,0.123369,0.161613,507,0,0
8507894,"Matten b. I., Hotel Sonne",,0.000028,43,1,2,3,7778,14556,22334,25,0.12348,0.161979,120,0,0
8507897,"Wilderswil, Lehngasse",,0.000024,43,1,2,3,8955,8955,17910,25,0.122695,0.161499,710.466667,0,0
8507948,"Habkern, Zäundli",,0.000029,43,1,1,2,3220,3221,6441,25,0.122191,0.157983,1916,0,0
8570512,"Beatenberg, Ramsern",,0.000036,43,1,1,2,4661,4661,9322,25,0.122191,0.157983,2274,0,0
8507188,"Sierre, Villa",,0.000011,39,0,1,1,0,8086,8086,21,0.090045,0.131562,0,0,0
8508243,"Sierre, Manège",,0.000032,39,1,2,3,8281,8281,16562,21,0.090578,0.137879,334,0,0
8507213,"Piano Stampa, Maglio",,0.000011,102,0,1,1,0,4055,4055,15,0.132244,0.147067,0,0,0
8507219,"Brienzwiler, Eichhof",,0.000011,114,0,1,1,0,5780,5780,22,0.116573,0.167529,0,0,0
8507223,"Piano Stampa, Farera",,0.00002,102,1,1,2,4055,4055,8110,14,0.151541,0.170328,177,0,0
8507224,"Piano Stampa, Capolinea",,0.000028,102,1,1,2,4055,4055,8110,13,0.177598,0.205136,352,0,0
8578996,"Trevano, Centro Studi",,0.000076,102,1,3,4,55545,55960,111505,13,0.192771,0.237877,2180.609055,0,0
8507226,"Lugano, Via Ciani/Cornaredo",,0.000014,102,1,1,2,42367,42367,84734,12,0.181287,0.213886,16.254762,0,0
8579013,"Viganello, la Santa",,0.000033,102,2,1,3,48905,48905,97810,12,0.181287,0.213886,828.15,0,0
8579017,"Cadro, Pronuovo",,0.000057,102,2,2,4,23191,23191,46382,11,0.194357,0.235776,1052.15,0,0
8507227,"Chavannes-R., Cèdres",,0.000019,5,1,1,2,33596,33598,67194,24,0.085604,0.096174,388.5,0,0
8579230,"Préverenges, village",,0.000027,5,1,6,7,34254,50083,84337,24,0.103448,0.155876,10047.685859,0,0
8507232,"Bioggio, Scuole",,0.000031,81,2,1,3,4361,4361,8722,23,0.066765,0.079344,51,0,0
8507234,"Bioggio, Pianazzo",,0.000037,81,1,1,2,4361,4361,8722,22,0.071146,0.084066,225,0,0
8507236,"Cimo, Canavée",,0.000043,81,1,1,2,4361,4361,8722,21,0.07617,0.08967,397,0,0
8507238,"Orgnana, Cavriana",,0.000036,108,2,1,3,4216,4216,8432,33,0.045893,0.06741,60,0,0
8507240,"Orgnana, Paese",,0.000041,108,1,1,2,4216,4216,8432,32,0.047752,0.070269,182,0,0
8507241,"Châtel-St-Denis, centre",,0.000095,12,2,1,3,15403,15417,30820,6,0.318182,0.389286,210,0,0
8507244,"Bioggio, Via Mondonico",,0.000047,81,1,1,2,4361,4361,8722,20,0.08199,0.096485,567,0,0
8507246,"Lenk, Fure",,0.000011,23,0,1,1,0,2601,2601,14,0.147541,0.19645,0,0,0
8507251,Seidenberg,,0.000028,44,2,1,3,26404,26401,52805,25,0.12216,0.150976,1355,0,0
8507255,"Orgnana, Monda",,0.000046,108,1,1,2,4216,4216,8432,31,0.04978,0.073706,302,0,0
8507257,"Orgnana, Rozzolo",,0.00005,108,1,1,2,4216,4216,8432,30,0.052003,0.077997,420,0,0
8507267,"Yverdon-les-Bains, Prés-du-Lac",,0.000032,35,1,3,4,18150,18150,36300,6,0.289062,0.365315,65.202381,0,0
8594017,"Yverdon, Centre Professionnel",,0.000037,35,2,3,5,23452,23169,46621,8,0.246753,0.323528,4801.997619,0,0
8594018,"Yverdon, Centre Thermal",,0.00006,35,2,1,3,12018,11964,23982,8,0.226994,0.278024,1217.666667,0,0
8507265,"Yverdon-les-Bains, patinoire",,0.000025,35,2,1,3,18150,18150,36300,7,0.228916,0.272243,44.202381,0,0
8594021,"Yverdon, J.-J. Rousseau",,0.000093,35,5,4,9,42073,42125,84198,7,0.285714,0.383135,3038.45,0,0
8594022,"Yverdon, Léon-Jaquier nord",,0.00004,35,2,4,6,9508,9464,18972,6,0.296296,0.396875,1393.961905,0,0
8594031,"Yverdon, Théâtre Benno Besson",,0.000108,35,4,4,8,41828,41710,83538,5,0.338028,0.445139,5391.92619,0,0
8594038,"Yverdon, Clairs-Logis",,0.000051,35,3,2,5,8207,8203,16410,6,0.255556,0.328986,19.55,0,0
8594039,"Yverdon-les-Bains, Faïencerie",,0.000055,35,2,2,4,9985,10090,20075,5,0.318841,0.394697,13.3,0,0
8507269,"Gollion, En Crausaz",,0.000014,5,1,1,2,3027,3025,6052,40,0.044022,0.054396,2,0,0
8507271,Schönried,,0.000081,11,2,1,3,13057,13281,26338,24,0.080824,0.136608,2267.5,0,0
8507272,Saanenmöser,,0.00008,11,1,2,3,13281,13099,26380,23,0.086207,0.158583,2165.5,0,0
8507273,Oeschseite,,0.000045,11,1,1,2,11685,12137,23822,23,0.084629,0.141411,0,0,0
8507279,Lenk im Simmental,,0.000045,11,1,1,2,11941,11941,23882,23,0.084629,0.141411,245,0,0
8507288,Eifeld,,0.00004,11,1,1,2,9494,9284,18778,23,0.084629,0.141411,196,0,0
8507274,Blankenburg,,0.000011,11,0,1,1,0,11941,11941,28,0.064362,0.10558,0,0,0
8507275,Stöckli,,0.00002,11,1,1,2,11941,11941,23882,27,0.067516,0.1098,53,0,0
8507276,St. Stephan,,0.000028,11,1,1,2,11941,11941,23882,26,0.071038,0.114844,104,0,0
8507277,Matten i.S.,,0.000035,11,1,1,2,11941,11941,23882,25,0.075,0.121103,153,0,0
8507278,Boden,,0.00004,11,1,1,2,11941,11941,23882,24,0.079491,0.12934,200,0,0
8507281,Grubenwald,,0.000011,11,0,1,1,0,2214,2214,27,0.067516,0.1098,0,0,0
8507284,Enge im Simmental,,0.00002,11,1,1,2,2214,9299,11513,26,0.071038,0.114844,52,0,0
8507286,Ringoldingen,,0.000028,11,1,1,2,9299,9299,18598,25,0.075,0.121103,102,0,0
8507287,Burgholz,,0.000035,11,1,1,2,9299,9494,18793,24,0.079491,0.12934,150,0,0
8507290,Zweisimmen,,0.000156,11,4,2,6,34776,13397,48173,22,0.090566,0.164555,2483.5,0,0
8507291,Weissenbach,,0.000077,11,1,1,2,2214,2214,4428,22,0.088847,0.14678,0,0,0
8507292,Boltigen,,0.000143,11,2,2,4,13397,13199,26596,21,0.095436,0.171294,2243.5,0,0
8507293,Oberwil im Simmental,,0.000072,11,1,2,3,9549,9549,19098,21,0.093946,0.167694,338,0,0
8507295,Därstetten,,0.000046,11,1,1,2,9269,9074,18343,21,0.090336,0.14061,43,0,0
8507294,Weissenburg,,0.000041,11,1,1,2,9299,9269,18568,22,0.084615,0.132167,170,0,0
8507296,Erlenbach im Simmental,,0.000141,11,3,1,4,12974,13397,26371,20,0.096998,0.151863,1739.5,0,0
8507297,Oey-Diemtigen,,0.000131,11,1,1,2,13397,13397,26794,19,0.104859,0.168406,1608.5,0,0
8507304,"Nidau, Schlossstrasse",,0.000011,87,0,1,1,0,31623,31623,26,0.070458,0.078019,0,0,0
8507306,"Nidau, Strandweg",,0.00002,87,1,1,2,31623,31623,63246,25,0.075702,0.084666,782,0,0
8573196,"Andelfingen, Bahnhof",,0.000055,68,3,4,7,8749,11993,20742,43,0.048529,0.090554,7300.028571,0,0
8573679,Riet (Neftenbach),,0.000019,68,1,1,2,3457,3455,6912,15,0.125874,0.16434,126.333333,0,0
8507308,"Nidau, Herrenmoosweg",,0.000028,87,1,1,2,31623,31623,63246,24,0.081797,0.092861,1562,0,0
8507309,"Nidau Beunden, Bahnhof",,0.000035,87,1,2,3,31623,31623,63246,23,0.08897,0.103546,2340,0,0
8507310,"Biel/Bienne, Flurweg",,0.000026,87,1,1,2,31133,31124,62257,23,0.088866,0.102395,0,0,0
8507311,"Visp, Hubelstrasse",,0.000016,40,1,3,4,370,2693,3063,16,0.150538,0.198697,72,0,0
8507315,"Visp, Hubel-/St. Jodernstrasse",,0.000024,40,1,2,3,1345,1345,2690,16,0.148448,0.188674,110,0,0
8507313,"Visp, St. Jodern",,0.000015,40,1,1,2,1345,1345,2690,17,0.130282,0.158794,19,0,0
8507322,"Stansstad, Kilchlidossen",,0.000011,62,0,1,1,0,4343,4343,18,0.096491,0.110931,0,0,0
8575125,"Giubiasco, Tre Castelli",,0.000036,108,1,1,2,22183,22183,44366,61,0.051132,0.083471,1752,0,0
8574268,"Goldach, Rotenstein",,0.000032,72,2,1,3,10347,10347,20694,21,0.094765,0.106426,2342.75,0,0
8574269,"Goldach, Stelzenreben",,0.000032,72,2,1,3,10545,10545,21090,21,0.094765,0.106426,2342.75,0,0
8507330,"Oetwil am See, Holzhusen",,0.000027,84,2,1,3,7552,7547,15099,15,0.15161,0.176527,87.471429,0,0
8575275,"Sorengo, S. Grato",,0.000038,102,1,3,4,17835,17835,35670,11,0.221053,0.264954,749.468182,0,0
8581646,"Grancia, Centro Commerciale 2",,0.000032,102,1,3,4,31147,31147,62294,9,0.263566,0.316974,58,0,0
8507333,"Gaggio, Paese",,0.000051,102,1,1,2,4361,4361,8722,19,0.088811,0.105082,735,0,0
8507334,"Gaggio, Righetto",,0.000054,102,1,1,2,4361,4361,8722,18,0.096916,0.116698,901,0,0
8578951,"Riazzino, Stazione",,0.000121,101,3,2,5,19184,19184,38368,28,0.11036,0.146144,40185.22619,0,0
8580731,"Robasacco, Paese",,0.000045,108,2,1,3,3295,3294,6589,13,0.145833,0.178977,364,0,0
8580787,"Contone, Posta",,0.000054,108,1,1,2,13966,13966,27932,13,0.145833,0.178977,41587,0,0
8507339,"S. Antonino, Matro",,0.000019,108,1,1,2,5900,5900,11800,19,0.08785,0.107086,102,0,0
8507340,"S. Antonino, Vigana di sotto",,0.000027,108,1,1,2,5900,5900,11800,18,0.095287,0.114503,178,0,0
8507342,"Paiardi, al Maglio",,0.000034,108,1,1,2,5900,5900,11800,17,0.10419,0.123587,252,0,0
8507344,"Paiardi, San Giulio",,0.00004,108,1,1,2,5900,5900,11800,16,0.115044,0.134994,324,0,0
8507345,"Chêne-Bourg, gare-Tour",,0.000011,120,0,3,3,0,34274,34274,23,0.11865,0.13442,0,0,0
8507426,"Jussy, Lullier-Plantais",,0.000028,120,1,1,2,6095,6095,12190,23,0.106249,0.118326,1146,0,0
8507347,"Genève-Eaux-Vives, gare/Vadier",,0.000011,120,0,2,2,0,112701,112701,21,0.145328,0.166565,0,0,0
8507355,"Genève, Pré-Picot",,0.000016,120,1,4,5,112676,112725,225401,20,0.169509,0.203516,638.5,0,0
8507420,"Presinge, L'Avenir",,0.000023,120,1,1,2,16536,16537,33073,23,0.11281,0.12267,642,0,0
8507346,"Vigana, Nucleo",,0.000045,108,1,1,2,5900,5900,11800,15,0.128571,0.149798,394,0,0
8507348,"Vigana, al Sècch",,0.000049,108,1,1,2,5900,5900,11800,14,0.145902,0.169904,462,0,0
8508134,"Bernex, Vailly",,0.000031,120,2,3,5,93223,93262,186485,20,0.171855,0.205034,1874.75,0,0
8509321,"Thônex, Belle-Terre-Pl. Araire",,0.00005,120,1,2,3,72600,72601,145201,20,0.169586,0.201112,3019.961497,0,0
8587045,"Collonge-Bellerive, Collonge",,0.000026,120,2,3,5,43935,43937,87872,20,0.171137,0.204896,1695.907928,0,0
8587056,"Chêne-Bougeries, Malagnou",,0.000011,120,0,1,1,0,84180,84180,20,0.168072,0.19797,0,0,0
8507361,Eigergletscher,,0.000011,11,0,2,2,0,16493,16493,21,0.101761,0.177995,0,0,0
8507364,Jungfraujoch,,0.000016,11,1,1,2,9746,2409,12155,21,0.1,0.161877,0,0,0
8507373,Wengernalp,,0.000016,11,1,1,2,6069,8244,14313,21,0.1,0.161877,8,0,0
8507372,Wengen,,0.000011,11,0,2,2,0,14538,14538,20,0.109244,0.19095,0,0,0
8507374,Kleine Scheidegg,,0.000042,11,3,2,5,17400,16243,33643,20,0.108932,0.194898,157,0,0
8507375,Alpiglen,,0.000029,11,1,1,2,7999,7998,15997,24,0.075783,0.124076,30,0,0
8507378,Grütschalp,,0.000011,137,0,1,1,0,11343,11343,2,0.666667,0.75,0,0,0
8507379,Mürren BLM,,0.00002,137,1,1,2,11343,11439,22782,1,1,1,1,0,0
8507380,Grindelwald,,0.00005,11,2,2,4,17357,16795,34152,22,0.085271,0.150348,152,0,0
8507381,Schwendi bei Grindelwald,,0.000032,11,1,1,2,8787,7641,16428,21,0.088983,0.138005,178,0,0
8507382,Burglauenen,,0.000038,11,1,1,2,7641,7569,15210,20,0.095349,0.147436,210,0,0
8507383,Lütschental,,0.000043,11,1,1,2,7569,7947,15516,19,0.102828,0.160116,240,0,0
8507384,Lauterbrunnen,,0.000033,11,2,3,5,16713,26294,43007,19,0.107417,0.200111,210,0,0
8507387,Schynige Platte,,0.00002,11,1,1,2,3002,3002,6004,19,0.102828,0.160116,40,0,0
8507550,Allmend,,0.00002,11,1,1,2,9621,8244,17865,1,1,1,0,0,0
8507386,Breitlauenen,,0.000011,11,0,1,1,0,3002,3002,20,0.095349,0.147436,0,0,0
8507388,Wilderswil,,0.000074,11,3,1,4,18808,16852,35660,18,0.111748,0.178696,585,0,0
8507390,"Bönigen, Lütschinenbrücke",,0.000011,43,0,1,1,0,4220,4220,27,0.099143,0.119499,0,0,0
8507393,"Camorino, San Martino",,0.000052,108,1,1,2,5900,5900,11800,13,0.168906,0.199193,528,0,0
8580778,"Giubiasco, Caffè Locarno",,0.000029,108,1,3,4,22800,21379,44179,12,0.207944,0.264736,703.016667,0,0
8580789,"S. Antonino,Centri Commerciali",,0.000053,108,2,4,6,24980,27754,52734,12,0.185654,0.243173,26336.120238,0,0
8507396,"Interlaken, Geissgasse",,0.00002,43,1,2,3,4220,4220,8440,26,0.109783,0.138396,404,0,0
8507397,"Iseltwald, Sengg",,0.000019,43,1,1,2,3087,3348,6435,26,0.109541,0.136258,0,0,0
8507402,"Eriz, Säge",,0.000027,43,2,2,4,480,480,960,29,0.112259,0.14153,31.833333,0,0
8507404,"Eriz, Linden",,0.000028,43,2,1,3,480,480,960,30,0.101859,0.124087,17.333333,0,0
8574521,"Münsingen, Industrie/USM",,0.000068,100,5,3,8,7068,7066,14134,12,0.204082,0.369327,394.166667,0,0
8576566,"Heimenschwand, Badhaus",,0.000041,43,4,2,6,1888,1889,3777,22,0.07926,0.119564,2305.166667,0,0
8576569,"Heimenschwand, Rothachen",,0.000021,43,1,3,4,1049,899,1948,19,0.096217,0.147597,234.5,0,0
8576608,"Steffisburg, Haldeneggweg",,0.000046,43,1,1,2,809,30,839,7,0.25,0.370408,119,0,0
8507405,"Schwarzenegg, Dorf",,0.000042,43,3,4,7,1290,1290,2580,29,0.113127,0.146117,638.25,0,0
8576584,"Steffisburg, Glockenthalerhof",,0.000085,43,1,7,8,8425,8425,16850,13,0.158779,0.251437,9069.166667,0,0
8576597,"Oberlangenegg, Fischbach",,0.000069,43,1,2,3,810,810,1620,12,0.173184,0.262994,255,0,0
8576602,"Unterlangenegg, Hänni",,0.000066,43,1,3,4,1170,1170,2340,10,0.218487,0.339728,1831.75,0,0
8507407,"Heiligenschwendi, Dörfli",,0.000017,43,1,1,2,780,780,1560,30,0.097972,0.117261,200.5,0,0
8507408,"Heiligenschwendi, Multenegg",,0.00002,43,2,1,3,1859,1859,3718,30,0.097972,0.117261,248.5,0,0
8507409,"Goldiwil, Scheidweg",,0.000042,43,2,2,4,2639,2639,5278,29,0.108342,0.134941,1236,0,0
8507410,"Thun, Wartboden",,0.000029,43,1,2,3,2579,2579,5158,29,0.10813,0.134026,16,0,0
8507870,"Goldiwil, Dorf",,0.000023,43,1,1,2,1859,1859,3718,29,0.107888,0.13185,0,0,0
8507414,"Chambésy, Plage du Vengeron",,0.000028,120,1,1,2,12192,12193,24385,20,0.120185,0.133315,1348,0,0
8507416,"Satigny, Champ Magnin",,0.000019,120,1,1,2,11921,11921,23842,25,0.093417,0.117408,57.316667,0,0
8587381,"Satigny, Bourdigny-Dessus",,0.000028,132,1,1,2,6072,6072,12144,25,0.093417,0.117408,982,0,0
8587388,"Satigny, Peney-Dessous",,0.00002,132,1,1,2,15385,27302,42687,25,0.093417,0.117408,1587.324449,0,0
8507418,"Puplinge, Brolliets",,0.000014,120,1,1,2,16537,16536,33073,24,0.101516,0.109366,1,0,0
8507419,"Gersau, Rosenbrücke",,0.000016,91,1,1,2,2676,3185,5861,12,0.146067,0.245702,442,0,0
8507421,"Gersau, Stockli",,0.000024,91,1,1,2,3185,3185,6370,11,0.157895,0.25999,420,0,0
8507422,"Jussy, Les Mévaux",,0.000011,120,0,1,1,0,6095,6095,25,0.087894,0.09563,0,0,0
8507423,"Gersau, Platten",,0.000031,91,1,1,2,3185,3185,6370,10,0.171875,0.276371,396,0,0
8507424,"Jussy, Petit-Lullier",,0.00002,120,1,1,2,6095,6095,12190,24,0.096196,0.105569,574,0,0
8507425,"Gersau, Oberried",,0.000038,91,1,1,2,3185,3185,6370,9,0.188679,0.295397,370,0,0
8507427,"Gersau, Weidli",,0.000043,91,1,1,2,3185,3185,6370,8,0.209302,0.317857,342,0,0
8507428,"Jussy, Lullier",,0.000038,120,2,2,4,23406,23406,46812,22,0.118672,0.13585,1899.20517,0,0
8587068,"Jussy, Meurets",,0.000032,120,1,2,3,16963,16963,33926,20,0.144236,0.172407,305.226343,0,0
8587077,"Meinier, La Tour",,0.000032,120,2,2,4,24253,23445,47698,21,0.146576,0.169635,569.408123,0,0
8507429,"Gersau, Gibel",,0.000047,91,1,1,2,3185,3185,6370,7,0.235294,0.34494,312,0,0
8507430,"Vésenaz, Pointe à la Bise",,0.000027,120,1,1,2,6095,6095,12190,23,0.114544,0.12694,709.824603,0,0
8508248,"Vandoeuvres, Centre communal",,0.00002,120,1,3,4,13424,13423,26847,21,0.149918,0.174908,640,0,0
8507431,"Gersau, Ober Gibel",,0.000051,91,1,1,2,3185,3185,6370,6,0.269231,0.378571,280,0,0
8507432,"Sézegnin, Mairie d'Avusy",,0.000011,120,0,1,1,0,4948,4948,22,0.120803,0.138039,0,0,0
8507433,"Gersau, Rübi",,0.000054,91,1,1,2,3185,3185,6370,5,0.315789,0.422222,246,0,0
8507670,"Cronay, village",,0.000027,35,2,3,5,5112,5112,10224,29,0.070724,0.088609,1068.887102,0,0
8507435,"Gersau, Mittel Gschwend",,0.000057,91,1,1,2,3185,3184,6369,4,0.384615,0.483333,210,0,0
8507436,"Massongex, Vers-chez-Revet",,0.000011,37,0,1,1,0,1024,1024,17,0.136612,0.234915,0,0,0
8507437,"Gersau, Ober Gschwend",,0.000059,91,1,1,2,3184,3185,6369,3,0.5,0.583333,172,0,0
8507440,"Wil SG, Allmend",,0.00003,20,2,1,3,22642,23541,46183,46,0.04603,0.064275,2990,0,0
8507442,"Wilen bei Wil, Glärnischstr.",,0.000037,20,1,1,2,23541,23541,47082,45,0.048219,0.070777,4468,0,0
8507445,"Hirzel, Vorderi Siten",,0.000024,63,2,1,3,1117,1118,2235,12,0.146023,0.181103,216.385714,0,0
8573563,"Hirzel, Kirche",,0.000047,63,1,1,2,1717,1717,3434,12,0.146023,0.181103,3434,0,0
8507461,"Kandergrund, Altels",,0.000011,43,0,1,1,0,10204,10204,36,0.061847,0.069668,0,0,0
8507462,"Kandergrund, Riegelsee",,0.00002,43,1,1,2,10204,10207,20411,35,0.06578,0.074251,455,0,0
8507467,"Mitholz, Underem Büel",,0.000028,43,1,1,2,10207,10207,20414,34,0.070257,0.079616,908,0,0
8507469,"Frutigen, Tellenfeld",,0.000035,43,1,1,2,10207,10207,20414,33,0.075399,0.085995,1359,0,0
8507472,Ausserberg,,0.00006,4,3,2,5,8753,8605,17358,21,0.094845,0.164773,1890,0,0
8507473,Hohtenn,,0.000036,4,1,1,2,4331,4331,8662,21,0.092975,0.146212,0,0,0
8507474,Goppenstein,,0.000067,4,2,1,3,8605,8503,17108,20,0.100228,0.162005,1600,0,0
8507480,Reichenbach im Kandertal,,0.000051,11,1,1,2,12018,12229,24247,19,0.102828,0.160116,787,0,0
8576378,"Bönigen, See",,0.000026,43,2,6,8,6908,6953,13861,16,0.1373,0.269459,1670.271429,0,0
8507491,"Ringgenberg, Anhöhe-Burgseeli",,0.000021,43,1,1,2,660,8202,8862,27,0.091888,0.108137,60,0,0
8507492,Interlaken Ost,,0.000273,11,3,5,8,41294,33656,74950,16,0.136029,0.28734,20228.5,0,0
8508301,Ringgenberg,,0.000057,11,1,1,2,9026,9026,18052,18,0.104167,0.163404,0,0,0
8508302,Niederried,,0.000106,11,2,1,3,9263,9263,18526,17,0.112957,0.181224,34,0,0
8508303,Oberried am Brienzersee,,0.000147,11,2,2,4,9972,9972,19944,16,0.123596,0.216108,899,0,0
8508304,Ebligen,,0.000074,11,1,1,2,9262,9262,18524,16,0.120301,0.191612,0,0,0
8507502,"Frutigen, Kreuzgasse",,0.000011,43,0,1,1,0,3222,3222,31,0.088052,0.10258,0,0,0
8507503,"Frutigen, Ischlag",,0.00002,43,1,1,2,3222,3220,6442,30,0.096339,0.114685,450,0,0
8507504,"Reichenbach i. K., Reudlen",,0.000028,43,1,1,2,3220,3222,6442,29,0.106373,0.131103,898,0,0
8507586,"Kandergrund, Bifige",,0.000053,43,1,2,3,10207,10206,20413,29,0.106854,0.133546,3143,0,0
8507506,"Kandergrund, Post",,0.00004,43,1,1,2,10207,10207,20414,32,0.081368,0.093736,1808,0,0
8507507,Blausee BE,,0.000045,43,1,1,2,10207,10206,20413,31,0.088379,0.103387,2255,0,0
8507508,"Mitholz, Balmhorn",,0.000049,43,1,1,2,10206,10207,20413,30,0.096733,0.11592,2700,0,0
8507515,"Bulle, Bouleyres",,0.000011,13,0,1,1,0,13532,13532,20,0.107034,0.121258,0,0,0
8507517,"Bulle, Pays-d'Enhaut",,0.00002,13,1,1,2,13532,13532,27064,19,0.119555,0.13845,387,0,0
8507518,"Nivo, Campagna",,0.00002,108,1,1,2,4407,2483,6890,18,0.119382,0.163861,85,0,0
8575732,"Chiggiogna, Paese",,0.00003,108,2,1,3,13554,13554,27108,18,0.119382,0.163861,3031.4,0,0
8507869,"Gsteigwiler, Dorf",,0.000014,43,1,1,2,6969,7653,14622,26,0.110066,0.135684,0,0,0
8507542,"Eschlikon TG, Industrie",,0.000037,20,1,2,3,10127,22328,32455,45,0.048378,0.072597,7429.5,0,0
8573526,"Bichelsee, Niederhofen-Höfli",,0.000055,84,1,1,2,2574,2574,5148,45,0.048273,0.071073,59208,0,0
8578617,"Sirnach, Breite",,0.000048,20,1,1,2,26072,12201,38273,19,0.091549,0.145644,1925,0,0
8575404,"Pura, Magliasina",,0.000049,81,1,1,2,16135,16135,32270,19,0.101047,0.12577,2572,0,0
8575846,"Novaggio, Clinica",,0.000059,81,3,1,4,8279,7807,16086,7,0.25,0.370408,518.75,0,0
8575355,"Carnago, Chiesa",,0.000056,102,1,2,3,24382,24382,48764,31,0.110397,0.14345,5411,0,0
8507547,"Schwanden GL, Fryberg",,0.00002,128,1,1,2,1903,1903,3806,11,0.158358,0.197113,54,0,0
8507587,"Frutigen, Widi",,0.000057,43,2,4,6,11703,14673,26376,28,0.11877,0.156165,4692.666667,0,0
8507589,"Kandersteg, Im Kehr",,0.00005,43,1,3,4,10207,11483,21690,28,0.11883,0.156201,724.333333,0,0
8507860,"Aeschi b. Spiez, Post",,0.000011,43,0,4,4,0,10268,10268,28,0.116071,0.154911,0,0,0
8507876,"Hondrich, Schulhaus",,0.000021,43,2,2,4,4475,6209,10684,28,0.11408,0.145843,110.921989,0,0
8507588,"Frutigen, Zrydsbrügg",,0.000046,43,2,1,3,9732,10207,19939,29,0.106424,0.131422,293.333333,0,0
8576316,"Frutigen, Marktplatz",,0.000064,43,1,1,2,11452,11452,22904,28,0.114735,0.145999,9062,0,0
8576368,"Frutigen, Achere",,0.000037,43,1,1,2,10207,10207,20414,10,0.1875,0.257445,483,0,0
8572580,"Baden, Schulhausplatz",,0.000094,22,9,4,13,61327,61504,122831,21,0.133366,0.167847,59198.388047,0.000155,0.001302
8572581,"Baden, Kantonsschule",,0.000031,22,1,3,4,38786,38786,77572,22,0.119589,0.147852,1468,0.00003,0.000198
8578672,"Baden, Ruschebach",,0.000047,22,1,5,6,23102,23102,46204,21,0.132918,0.17,2118,0,0.002085
8578677,"Gebenstorf, Reuss",,0.000045,22,3,3,6,19447,19461,38908,22,0.118001,0.145524,1848.383798,0.000025,0.000612
8578668,"Baden, Bruggerstrasse",,0.00007,22,4,3,7,33200,34080,67280,21,0.131811,0.163216,2706.759243,0.00009,0.00132
8578678,"Wettingen, Zentrumsplatz",,0.000064,22,5,6,11,36381,41958,78339,21,0.133031,0.173188,6517.100929,0.000103,0.002382
8580638,"Baden, Stein",,0.000058,22,3,15,18,56779,57198,113977,20,0.163613,0.217925,73644.07824,0.000329,0.002086
8587346,"Wettingen, Kloster",,0.00006,22,5,5,10,18588,18588,37176,20,0.083697,0.119397,3110.378082,0.000586,0.001499
8590192,"Baden, Schlossbergplatz",,0.000052,22,2,7,9,35265,35265,70530,19,0.089589,0.127784,1993.188488,0.000046,0.000305
8590199,"Baden, Ziegelhau",,0.000066,22,3,4,7,24017,24017,48034,21,0.073171,0.094336,1840.616577,0.000072,0.000081
8577670,"Mézières FR, village",,0.000031,13,1,2,3,13608,13608,27216,18,0.129706,0.15912,49345.945437,0,0
8507599,"Unterterzen, Friedberg",,0.000011,124,0,1,1,0,8927,8927,3,0.5,0.611111,0,0,0
8507600,"Lenk, Brandegg",,0.000011,23,0,1,1,0,4271,4271,16,0.119355,0.170367,0,0,0
8507601,"Lenk, Buggeli",,0.00002,23,1,2,3,4271,4271,8542,15,0.131868,0.196891,36,0,0
8507602,"Lenk, Bühlberg",,0.000019,23,1,1,2,3899,3899,7798,15,0.128676,0.173945,0,0,0
8507603,"Lenk, Grün",,0.000036,23,2,1,3,4271,4271,8542,14,0.14346,0.190849,102,0,0
8507604,"Lenk, Hubel",,0.000041,23,1,1,2,4271,4271,8542,13,0.162562,0.21468,132,0,0
8507605,"Lenk, Seiten",,0.000046,23,1,1,2,4271,4271,8542,12,0.188235,0.25144,160,0,0
8507606,"Lenk, Tannenbühl",,0.00005,23,1,1,2,4271,4271,8542,11,0.224638,0.317552,186,0,0
8507611,"Lenk, Mittaghorn",,0.000049,23,2,1,3,2601,2601,5202,11,0.224638,0.317552,155,0,0
8507616,"Lenk, Rohrbrücke",,0.00004,23,1,2,3,7277,7277,14554,11,0.236486,0.340784,140,0,0
8507620,"Lenk, Zelg",,0.000045,23,1,1,2,4989,4989,9978,11,0.224638,0.317552,93,0,0
8507607,"Lenk, Alpenrösli",,0.00002,23,1,1,2,2601,2601,5202,13,0.168269,0.226222,35,0,0
8507608,"Lenk, Blatti",,0.000028,23,1,2,3,2601,2601,5202,12,0.196532,0.280767,68,0,0
8507610,"Lenk, Iffigenfall",,0.00003,23,1,1,2,1273,1273,2546,12,0.188235,0.25144,32,0,0
8507609,"Lenk, Iffigenalp",,0.000023,23,1,1,2,1273,1273,2546,13,0.162562,0.21468,3,0,0
8507612,"Lenk, Edelweiss",,0.000011,23,0,1,1,0,4989,4989,15,0.130872,0.172374,0,0,0
8507613,"Lenk, Kuspo",,0.00002,23,1,1,2,4989,7277,12266,14,0.146718,0.190747,38,0,0
8507614,"Lenk, Metschbahnen",,0.000028,23,1,1,2,7277,7277,14554,13,0.167421,0.217147,74,0,0
8507615,"Lenk, Neufeld (Camping)",,0.000035,23,1,1,2,7277,7277,14554,12,0.195652,0.25915,108,0,0
8507617,"Lenk, Rothenbach",,0.000028,23,1,1,2,4989,4989,9978,14,0.14346,0.190849,15,0,0
8507618,"Lenk, Sumpfbach",,0.000035,23,1,1,2,4989,4989,9978,13,0.162562,0.21468,43,0,0
8507619,"Lenk, Simmenfälle",,0.00004,23,1,1,2,4989,4989,9978,12,0.188235,0.25144,69,0,0
8507624,"Assens, gare",,0.000011,35,0,1,1,0,81,81,26,0.083817,0.100366,0,0,0
8507625,"Quarten, Kirche",,0.00002,124,1,1,2,8927,8919,17846,2,0.666667,0.75,2,0,0
8507626,"Etagnières, gare",,0.00002,35,1,1,2,81,81,162,25,0.091409,0.114226,1197,0,0
8507971,"Vuarrens, poste",,0.000018,35,1,2,3,5502,5161,10663,25,0.091982,0.11583,7566.036905,0,0
8570185,"Bettens, croisée",,0.000061,5,2,2,4,7680,7452,15132,25,0.091747,0.115716,103918.833333,0,0
8570195,"Penthéréaz, Champ-de-Vaud",,0.000021,35,1,2,3,1570,1570,3140,25,0.091854,0.115894,939.6,0,0
8570198,"Corcelles-sur-Chav., village",,0.000068,35,4,2,6,4175,4363,8538,25,0.092004,0.116443,11955.696429,0,0
8570202,"Echallens, Les Coulisses",,0.000059,35,1,1,2,3669,3897,7566,25,0.091409,0.114226,7182,0,0
8570204,"Echallens, La Robellaz",,0.000058,35,1,2,3,10118,10243,20361,25,0.092088,0.11622,19592.358198,0,0
8570207,"Poliez-le-Grand, village",,0.000046,35,1,4,5,7847,7858,15705,25,0.092196,0.118397,3318,0,0
8570210,"Poliez-Pittet, Grands-Champs",,0.000028,35,1,2,3,3192,3192,6384,25,0.091884,0.116011,1208,0,0
8570217,"Villars-Tiercelin, M. Villars",,0.000056,35,2,2,4,4610,4610,9220,25,0.09172,0.115693,4958,0,0
8570220,"Naz, laiterie",,0.000063,35,2,2,4,3866,3798,7664,25,0.091596,0.115468,3822,0,0
8570223,"Boulens, croisée",,0.000047,35,1,1,2,1725,2304,4029,25,0.091409,0.114226,2394,0,0
8592049,"Prilly, Galicien",,0.000129,5,6,6,12,166711,166577,333288,11,0.211813,0.286306,16095.764484,0,0
8592124,"Lausanne, Valency",,0.000052,5,1,1,2,57522,57523,115045,12,0.158683,0.203932,212,0,0
8507629,"Oberterzen, Dorf",,0.000028,124,1,1,2,8919,8931,17850,1,1,1,2,0,0
8595374,"Mols, Bahnhof",,0.000022,124,1,2,3,19053,10954,30007,1,1,1,28,0,0
8595375,"Murg, Bahnhof",,0.00002,124,1,1,2,9521,10441,19962,1,1,1,0,0,0
8507636,Tiefenau Bahnhof,,0.000011,44,0,1,1,0,1456,1456,26,0.110929,0.132997,0,0,0
8507638,Felsenau Bahnhof,,0.00002,44,1,3,4,1456,1456,2912,25,0.124603,0.158354,745,0,0
8508073,Hüslimoos,,0.000017,44,1,2,3,110,10361,10471,26,0.113156,0.139528,7.333333,0,0
8507785,"Bern, Hauptbahnhof",,0.000065,44,5,11,16,32291,78861,111152,23,0.139798,0.182094,6631.438889,0,0
8507984,"Ortschwaben, Postgasse",,0.000029,44,2,3,5,12221,12221,24442,23,0.136356,0.168351,783,0,0
8575474,"Solduno, Stazione",,0.000041,101,2,3,5,67856,67856,135712,32,0.092894,0.127454,1312,0,0
8576448,"Losone, Zandone Campeggio",,0.000067,101,1,2,3,5511,5511,11022,32,0.093413,0.124765,9922,0,0
8578924,"Losone, Ponte Maggia",,0.000094,101,4,5,9,95839,96783,192622,31,0.100099,0.144766,3783.905952,0,0
8507642,"Porrentruy, Etang Corbat",,0.000011,50,0,1,1,0,5237,5237,23,0.118261,0.173191,0,0,0
8507645,"Soglio, Plazza",,0.000011,77,0,2,2,0,3757,3757,5,0.375,0.547222,0,0,0
8509761,"Castasegna, Vecchia Dogana",,0.000016,77,1,2,3,155,155,310,4,0.454545,0.616667,2,0,0
8507647,"Tannay, giratoire",,0.000011,125,0,1,1,0,83,83,23,0.068258,0.087398,0,0,0
8579315,"La Rippe, village",,0.000033,125,2,3,5,10700,10701,21401,23,0.06892,0.099493,528.416667,0,0
8507652,"Gressy, Le Bas-des-Monts",,0.000014,35,1,2,3,8554,8226,16780,28,0.072993,0.085386,9146.133333,0,0
8507653,"Belmont-sur-Yverdon, Battoir",,0.000017,35,1,1,2,2745,2745,5490,27,0.078072,0.091979,5071.596429,0,0
8507665,"Correvon, village",,0.000025,35,1,2,3,4947,4947,9894,29,0.070705,0.08769,1270,0,0
8507672,"Démoret, haut du village",,0.00004,35,4,3,7,4129,4129,8258,29,0.071168,0.090274,4851.613265,0,0
8507674,"Donneloye, poste",,0.000043,35,4,3,7,5731,5767,11498,28,0.075776,0.097224,8991.798624,0,0
8507688,"Mézery-près-Donneloye, village",,0.000025,35,2,5,7,4101,4101,8202,27,0.080313,0.10413,9474.112299,0,0
8507960,"St-Cierges, Grande Salle",,0.000035,35,2,1,3,6137,5904,12041,27,0.079071,0.097951,5495.733333,0,0
8507690,"Cronay, Moulin du Pont",,0.000055,35,4,2,6,6870,6870,13740,29,0.070748,0.087126,1667.704762,0,0
8507660,"Chanéaz, village",,0.000016,35,1,1,2,4870,4947,9817,30,0.066084,0.07892,19,0,0
8507661,"Chapelle-sur-Moudon, poste",,0.000018,35,1,1,2,3600,3833,7433,28,0.073331,0.087459,3004.733333,0,0
8507663,"Chapelle-sur-Moudon, La Combe",,0.000011,35,0,1,1,0,2304,2304,28,0.073331,0.087459,0,0,0
8507664,"Corcelles-près-Concise,village",,0.000038,35,2,1,3,8847,8847,17694,23,0.07997,0.092967,3372.666667,0,0
8507682,"Gossens, village",,0.000022,35,2,1,3,1758,1758,3516,30,0.066122,0.078665,190.5,0,0
8507689,"Molondin, village",,0.000049,35,3,3,6,4129,4129,8258,28,0.074189,0.095748,2858.138739,0,0
8507687,"La Mauguettaz, croisée",,0.000034,35,1,2,3,2786,2786,5572,29,0.071802,0.090385,1284.471429,0,0
8507698,"Orzens, village",,0.000045,35,1,2,3,4639,4639,9278,41,0.051999,0.072043,1497.729915,0,0
8570306,"Rueyres VD, Le Dejors",,0.000049,35,1,1,2,3912,3912,7824,41,0.047329,0.062868,4333.833333,0,0
8507675,"Epautheyres, croisée",,0.000017,35,1,1,2,5481,5809,11290,27,0.078468,0.092798,5274.536905,0,0
8507677,"Fiez, village",,0.000014,35,1,1,2,950,950,1900,28,0.059316,0.068719,70,0,0
8507678,"Bonvillars, Flusel",,0.000043,35,1,2,3,8847,8847,17694,22,0.086714,0.103779,3774.666667,0,0
8507691,"Mutrux, anc. poste",,0.000029,35,1,1,2,4023,4023,8046,22,0.086525,0.101634,0,0,0
8507679,"Fontaines-sur-Grandson,collège",,0.000023,35,1,2,3,950,950,1900,27,0.062905,0.074366,473,0,0
8507680,"Fontanezier, bas du village",,0.000021,35,1,2,3,581,581,1162,26,0.066956,0.079824,429,0,0
8507684,"Villars-Burquin, Grange-Meule",,0.000029,35,2,1,3,890,890,1780,26,0.066806,0.077607,429,0,0
8507683,"Yvonand, La Grand'Moille",,0.000028,35,2,1,3,2786,2786,5572,30,0.067041,0.081078,43.471429,0,0
8507685,"Gressy, place du village",,0.000025,35,1,2,3,2745,2745,5490,26,0.084614,0.103274,6262.596429,0,0
8507970,"Villars-le-Terroir, poste",,0.000025,35,1,3,4,5809,8140,13949,26,0.08508,0.104696,6485.536905,0,0
8510402,"Chavornay, route de Corcelles",,0.000029,35,2,2,4,4494,3612,8106,26,0.084579,0.103222,28,0,0
8570194,"Penthéréaz, Le Battoir",,0.000037,35,1,3,4,2638,2590,5228,26,0.086305,0.108015,1279,0,0
8570197,"Corcelles-sur-Chav., Longeraie",,0.000028,35,1,1,2,1552,1495,3047,26,0.084317,0.101749,1216,0,0
8507953,"Pomy, village",,0.000063,35,3,2,5,7898,7898,15796,28,0.075535,0.094905,5498.657143,0,0
8570302,"Pomy, Centre Orif",,0.000028,35,1,4,5,10778,10779,21557,39,0.052572,0.078355,50531.176862,0,0
8570311,"Donneloye, En Jon",,0.00002,35,1,1,2,1825,1825,3650,39,0.051813,0.072215,1140.283333,0,0
8507695,"Onnens VD, croisée",,0.000054,35,2,2,4,8847,8847,17694,21,0.094494,0.115058,4572.666667,0,0
8507955,"Provence, poste",,0.000034,35,1,3,4,4023,4716,8739,20,0.103098,0.129741,4681.666667,0,0
8507696,"Oppens, croisée",,0.00004,35,2,1,3,4639,4639,9278,42,0.049469,0.06531,333.729915,0,0
8507700,"Goldswil, Dorf",,0.000029,43,1,1,2,8202,8202,16404,26,0.100934,0.121871,456,0,0
8507701,"Goldswil, Parkhotel",,0.000035,43,1,1,2,8202,8202,16404,25,0.111984,0.14102,850,0,0
8507703,"Nidau, Burgerallee",,0.000047,87,2,1,3,31614,31623,63237,22,0.097408,0.115663,3890,0,0
8507710,"Oberlindach, Käserei",,0.000014,44,1,1,2,7766,11225,18991,25,0.116259,0.137496,2,0,0
8507711,"Zwischenflüh, Anger",,0.000011,46,0,2,2,0,1435,1435,20,0.094697,0.204647,0,0,0
8507718,"Diemtigen, Dorf",,0.000016,46,1,1,2,1302,1302,2604,20,0.091255,0.171508,0,0,0
8507712,"Riggisberg, Spital",,0.000011,44,0,2,2,0,7090,7090,27,0.09276,0.114361,0,0,0
8507716,"Oberbalm, Dorf",,0.000016,44,1,4,5,4196,8124,12320,27,0.098419,0.12625,532.665079,0,0
8507713,"Gerzensee, Thalgut",,0.000011,100,0,1,1,0,6640,6640,19,0.11469,0.138185,0,0,0
8507714,"Kirchdorf BE, Post",,0.00002,100,1,1,2,6640,6814,13454,18,0.12866,0.158314,145,0,0
8507715,"Mühledorf, Dorf",,0.000028,100,1,1,2,6814,6788,13602,17,0.14664,0.188158,288,0,0
8507795,"Rüeggisberg, Post",,0.000036,44,2,3,5,7284,7340,14624,26,0.110764,0.135641,34232.36316,0,0
8507979,"Zimmerwald, Post",,0.000035,44,1,1,2,6062,6062,12124,26,0.108882,0.130631,2019,0,0
8571418,"Gasel, Schlatt",,0.00003,44,1,1,2,4702,4702,9404,15,0.10207,0.118503,7704,0,0
8571419,"Oberscherli, Dorf",,0.00004,44,2,1,3,6413,6412,12825,14,0.112878,0.131774,7009,0,0
8507720,"Zwischenflüh, Haueten",,0.000029,46,2,1,3,1435,1435,2870,19,0.096234,0.184585,46,0,0
8507721,"Horboden, Wirtschaft",,0.000035,46,1,2,3,1435,1435,2870,18,0.101852,0.21397,66,0,0
8507722,"Diemtigen, Schönbühl",,0.000026,46,1,1,2,1302,1302,2604,18,0.097674,0.17654,0,0,0
8507723,"Tiermatten, Wirtschaft",,0.000048,46,2,1,3,1435,1435,2870,17,0.103093,0.183436,100,0,0
8507724,"Horboden, Wampflen",,0.000052,46,1,1,2,1435,1435,2870,16,0.109195,0.191049,114,0,0
8507725,"Zwischenflüh, Post",,0.000055,46,1,1,2,1435,1435,2870,15,0.116129,0.199532,126,0,0
8507726,"Rüti b. R'berg, Dürrbach",,0.000034,126,1,2,3,501,501,1002,29,0.086382,0.102138,38738.406017,0,0
8507728,"Fultigen, Abzw.",,0.000019,44,2,4,6,7094,10823,17917,29,0.088611,0.10963,774.115079,0,0
8507739,"Mühlethurnen, Pontel",,0.000022,44,1,2,3,3336,3336,6672,28,0.093762,0.112939,12,0,0
8507727,"Englisberg, Dorf",,0.000011,44,0,2,2,0,6062,6062,28,0.089762,0.103207,0,0,0
8507735,"Englisberg, Abzw. Kühlewil",,0.000016,44,1,1,2,864,864,1728,28,0.089641,0.101878,0,0,0
8571420,"Oberscherli, Scherliau",,0.000048,44,2,1,3,8123,8124,16247,13,0.126344,0.150501,6318.333333,0,0
8507729,"Riggisberg, Graben",,0.000029,44,2,3,5,873,8145,9018,28,0.094377,0.115279,40281.240938,0,0
8507731,"Helgisried-Rohrbach, Post",,0.000019,44,1,2,3,497,6452,6949,28,0.09399,0.113461,336,0,0
8507737,"Mühlethurnen, Post",,0.000027,44,1,2,3,3460,3460,6920,28,0.093833,0.11317,1015,0,0
8507738,Oberbütschel,,0.000015,44,1,1,2,2958,4322,7280,28,0.093593,0.111595,701.834921,0,0
8507744,"Vorderfultigen, Käserei",,0.000024,44,1,2,3,2521,2521,5042,27,0.098894,0.12079,1092.319048,0,0
8507747,"Mamishaus, Wyden",,0.000049,44,1,1,2,5466,5466,10932,28,0.093593,0.111595,4740,0,0
8507748,"Burgistein, Weier",,0.00002,44,1,1,2,1647,2179,3826,28,0.093593,0.111595,948,0,0
8507758,"Gurnigel, Bad",,0.000041,44,1,1,2,501,501,1002,28,0.093593,0.111595,948,0,0
8507732,"Hinterfultigen, Post",,0.000015,44,1,1,2,1842,2521,4363,28,0.090081,0.105567,147.319048,0,0
8507733,"Rüschegg Gambach, Hirschhorn",,0.000019,44,1,1,2,5466,5466,10932,33,0.064028,0.070264,285,0,0
8507734,"Kirchenthurnen, Abzw.",,0.000019,44,1,1,2,3460,3460,6920,29,0.085866,0.099723,120,0,0
8507736,"Mamishaus, Dorf",,0.000027,44,1,1,2,5466,5466,10932,32,0.068337,0.075516,1180,0,0
8507740,"Rohrbach b. Riggisberg,Schulh.",,0.000034,44,1,1,2,5466,5466,10932,31,0.073272,0.08176,2073,0,0
8507742,"Rüschegg Graben, Kreuzung",,0.00004,44,1,1,2,5466,5466,10932,30,0.078982,0.089353,2964,0,0
8507743,"Mamishaus, Schönentannen",,0.000045,44,1,1,2,5466,5466,10932,29,0.085665,0.098897,3853,0,0
8507765,"Riggisberg, Post",,0.000164,44,9,9,18,23004,23196,46200,27,0.103148,0.131118,56332.075859,0,0
8507745,"Wattenwil, Pflegeheim",,0.000011,44,0,1,1,0,1647,1647,29,0.085665,0.098897,0,0,0
8507749,"Rüti b. R'berg, Brügghüsi",,0.000035,44,2,1,3,502,501,1003,29,0.085665,0.098897,59,0,0
8507750,"Beatenberg, bei den Kirchen",,0.000011,43,0,1,1,0,4827,4827,31,0.072064,0.082747,0,0,0
8507751,"Beatenberg, Station",,0.00002,43,1,1,2,4827,4827,9654,30,0.077465,0.089793,396,0,0
8507756,"Grimmialp, Hotel Spillgerten",,0.000057,46,1,1,2,1435,1435,2870,14,0.124088,0.209099,136,0,0
8507757,"Guggisberg, Post",,0.000011,126,0,2,2,0,2451,2451,11,0.161184,0.192099,0,0,0
8571660,"Rüti b. R'berg, Neuhaus",,0.000062,126,1,1,2,501,501,1002,16,0.090629,0.103698,2877,0,0
8571669,"Riedstätt, Post",,0.00007,126,1,1,2,2605,2605,5210,11,0.158305,0.182783,3172,0,0
8507759,"Habkern, Post",,0.000011,43,0,1,1,0,3221,3221,27,0.099393,0.11937,0,0,0
8507791,"Unterseen, Luegibrüggli",,0.000026,43,1,1,2,4661,4661,9322,27,0.099393,0.11937,774,0,0
8571407,"Riggisberg, Hasli",,0.000042,44,1,4,5,7098,7098,14196,26,0.111581,0.137386,3519,0,0
8571430,"Kaufdorf, Lochpinte",,0.000041,44,1,1,2,4686,4686,9372,13,0.122624,0.145049,502.7,0,0
8571431,"Rümligen, Kettenschmiede",,0.000061,44,2,3,5,4810,4810,9620,12,0.138678,0.172655,839.7,0,0
8571698,"Wislisau, Wirtschaft",,0.000062,44,1,2,3,5466,5466,10932,12,0.137001,0.16181,1217,0,0
8571700,"Helgisried-Rohrbach, Säge",,0.000037,44,1,1,2,2736,2736,5472,12,0.136069,0.155158,0,0,0
8571687,"Guggisberg, Gehlismatt",,0.000071,126,1,3,4,1331,1331,2662,10,0.18705,0.23036,660,0,0
8507768,Schwefelberg Bad,,0.000026,44,1,1,2,501,472,973,25,0.052174,0.066067,2220,0,0
8507769,"Stechelberg, Post",,0.000011,43,0,1,1,0,6882,6882,28,0.098007,0.130873,0,0,0
8507772,"Beatenberg, Parkplatz Lood",,0.000028,43,1,1,2,4827,4827,9654,29,0.083757,0.098656,790,0,0
8507774,Trümmelbachfälle,,0.00002,43,1,1,2,6882,7076,13958,27,0.107735,0.14883,117,0,0
8507775,"Beatenberg, Waldegg",,0.000035,43,1,2,3,4827,4827,9654,28,0.091183,0.110782,1182,0,0
8507946,"Beatenberg, Hohlen",,0.000035,43,1,1,2,4424,4424,8848,28,0.090297,0.105993,398,0,0
8507776,"Frieswil, Dorf",,0.000035,44,1,2,3,7206,7206,14412,25,0.109847,0.128235,2376,0,0
8507985,"Wahlendorf, Wendeplatz",,0.000019,44,1,2,3,6543,6543,13086,23,0.125919,0.151041,17.166667,0,0
8507780,"Riedli, Talstation Wiriehorn",,0.00006,46,1,1,2,1435,1435,2870,13,0.133333,0.220065,144,0,0
8507781,"Rüschegg Gambach, Dorf",,0.000026,44,1,1,2,5466,5465,10931,21,0.064303,0.079155,740,0,0
8507783,"Rüschegg Heubach, Post",,0.000033,44,1,1,2,5465,5466,10931,20,0.068216,0.082934,801,0,0
8507974,"Detligen, Post",,0.000031,44,2,1,3,7206,7206,14412,25,0.108418,0.124234,102.642857,0,0
8507949,Grächwil,,0.000016,44,1,1,2,6543,6543,13086,24,0.120131,0.140732,0,0,0
8507975,"Hinterkappelen, Post",,0.000016,44,1,1,2,6624,6624,13248,25,0.114388,0.133119,0,0,0
8507977,"Innerberg BE, Bergweid",,0.000042,44,2,3,5,7491,7491,14982,24,0.121443,0.144738,941.142857,0,0
8507976,"Uettligen, Post",,0.000016,44,1,1,2,4081,4081,8162,25,0.113267,0.134784,0,0,0
8571262,"Lobsigen, Dorf",,0.000042,44,1,1,2,2924,3692,6616,25,0.113267,0.134784,624,0,0
8571346,"Hinterkappelen, Bennenboden",,0.000052,44,4,2,6,13317,13318,26635,25,0.113865,0.137166,49307.5,0,0
8571351,"Innerberg BE, Weidhaus",,0.000062,44,2,3,5,7491,7491,14982,25,0.1143,0.141091,4299.694444,0,0
8571353,"Detligen, Schulhausweg",,0.000035,44,1,3,4,7206,7206,14412,25,0.114042,0.14004,683,0,0
8571357,Universität,,0.000011,44,0,1,1,0,11296,11296,25,0.113267,0.134784,0,0,0
8507788,"Gurnigel, Berghaus",,0.000033,44,1,1,2,472,501,973,24,0.054693,0.068438,2301,0,0
8507986,"Gelterfingen, Dorf",,0.000021,100,1,2,3,1783,1783,3566,14,0.189542,0.309824,21.333333,0,0
8571622,"Münsingen, Neuhaus",,0.000027,100,1,1,2,7066,7086,14152,14,0.174699,0.255555,261,0,0
8507790,"Kehrsatz, Tannacker",,0.000029,44,2,1,3,6062,6062,12124,27,0.098322,0.114125,1348,0,0
8507792,"Unterseen, St. Niklausen",,0.000042,43,2,2,4,7882,7881,15763,26,0.110081,0.137923,1554,0,0
8507794,"Gurnigel, Gantrischhütte",,0.000039,44,1,1,2,501,472,973,23,0.057484,0.071078,2380,0,0
8571402,"Rüeggisberg, Than",,0.00003,44,1,1,2,4322,4322,8644,30,0.077607,0.087077,838.75,0,0
8571403,"Rüeggisberg, Gemeindehaus",,0.000047,44,2,2,4,7220,7220,14440,29,0.08401,0.096177,1812.75,0,0
8507797,"Stechelberg, Hotel",,0.000028,43,1,2,3,7076,7075,14151,26,0.119711,0.177462,232,0,0
8507799,"Stechelberg, Schilthornbahn",,0.000023,43,1,1,2,6993,7033,14026,26,0.118802,0.17031,0,0,0
8507896,"Wilderswil, Hotel Heimat",,0.00003,43,1,2,3,8111,9287,17398,26,0.110955,0.141383,498,0,0
8507798,"Beatenberg, Hohlenweg",,0.000029,43,1,1,2,4661,4424,9085,29,0.083014,0.095989,16,0,0
8507850,"Achseten, Kirche",,0.000037,43,2,1,3,11927,11452,23379,42,0.047835,0.065142,672,0,0
8507851,"Adelboden, Post",,0.000042,43,1,4,5,11452,24832,36284,41,0.050125,0.074829,1099,0,0
8507852,"Adelboden, Hirzboden",,0.00002,43,1,1,2,11452,11452,22904,41,0.049014,0.063183,0,0,0
8507858,"Adelboden, Boden Wendeplatz",,0.000035,43,2,2,4,9637,9637,19274,40,0.050727,0.064384,430,0,0
8507853,"Adelboden, Oey",,0.000037,43,2,4,6,20327,21154,41481,40,0.05142,0.071278,1103,0,0
8507857,"Adelboden, Unter dem Birg",,0.000019,43,1,1,2,5614,5614,11228,41,0.048387,0.059356,0,0,0
8507996,"Adelboden, Ausserschwand",,0.000035,43,2,2,4,7467,7403,14870,40,0.05065,0.064197,676,0,0
8507998,"Adelboden, Neuweg",,0.000044,43,1,1,2,11452,11452,22904,40,0.050577,0.061271,1684,0,0
8507855,"Frutigen, Ried",,0.000019,43,1,1,2,11452,11452,22904,44,0.042424,0.050278,72,0,0
8507856,"Frutigen, Rohrbach",,0.000027,43,1,1,2,11452,11452,22904,43,0.044199,0.052439,478,0,0
8507859,"Frutigen, Gantengraben",,0.000034,43,1,1,2,11452,11452,22904,42,0.046134,0.054907,882,0,0
8507861,"Krattigen, Post",,0.000013,43,1,3,4,4588,4204,8792,29,0.10284,0.131875,6.833333,0,0
8507875,"Aeschi b. Spiez, Friedegg",,0.000027,43,2,3,5,3800,3800,7600,28,0.113481,0.146775,339.483333,0,0
8507862,"Aeschiried, Schulhaus",,0.000017,43,2,2,4,3680,3800,7480,29,0.102374,0.12724,16.5,0,0
8576350,"Krattigen, Kirche",,0.000037,43,1,1,2,4464,4464,8928,21,0.090692,0.159526,722.666667,0,0
8507874,"Spiez, Höhe",,0.000022,43,2,2,4,3209,4464,7673,28,0.112486,0.143767,493.016667,0,0
8571323,"Wilderswil, Bahnhof",,0.000055,43,3,3,6,9287,9287,18574,24,0.145777,0.24458,984.390476,0,0
8576374,"Interlaken, Kursaal",,0.000029,43,1,2,3,6827,6827,13654,26,0.118119,0.205327,45,0,0
8576375,"Interlaken, Drei Tannen",,0.000023,43,1,1,2,4906,4906,9812,26,0.117107,0.197536,0,0,0
8507872,"Wattenwil, Mettlen",,0.000014,43,1,1,2,510,1857,2367,22,0.103161,0.125539,24,0,0
8576346,"Hondrich, Bühlen",,0.000027,43,2,2,4,4475,4475,8950,15,0.141732,0.222366,761,0,0
8576352,"Krattigen, Stuhlegg",,0.000031,43,1,2,3,4345,4588,8933,19,0.102857,0.189507,365,0,0
8507880,"Schwanden, Dorf",,0.00002,43,2,1,3,870,1140,2010,8,0.233333,0.315561,48,0,0
8507881,"Sigriswil, Post",,0.00002,43,2,1,3,1977,1978,3955,13,0.14,0.235089,111,0,0
8507882,"Gunten, Bellevue",,0.000028,43,1,1,2,1978,1978,3956,12,0.151163,0.248324,111,0,0
8507883,"Tschingel, Dorf",,0.000028,43,1,2,3,1140,1140,2280,7,0.282609,0.400733,57,0,0
8576749,"Tschingel, Bösenzelg",,0.000071,43,1,1,2,570,570,1140,7,0.258065,0.365774,109,0,0
8507884,"Schwanden, Säge",,0.000023,43,1,1,2,570,570,1140,11,0.164384,0.263561,24,0,0
8507885,"Gunten, Wislikehr",,0.000034,43,1,1,2,1978,1978,3956,11,0.164384,0.263561,109,0,0
8507886,"Aeschlen ob Gunten, Dorf",,0.00003,43,1,1,2,570,570,1140,10,0.180328,0.281421,29,0,0
8576745,"Sigriswil, Endorf",,0.00004,43,1,1,2,1978,1978,3956,10,0.180328,0.281421,105,0,0
8507887,"Thierachern, Räbgass",,0.000024,43,2,1,3,2247,2247,4494,20,0.128375,0.16627,561,0,0
8507891,"Blumenstein, Dorf",,0.000027,43,2,2,4,1857,1857,3714,21,0.113737,0.143403,25,0,0
8507900,"Wattenwil, Stockern",,0.000033,43,2,1,3,1857,1857,3714,21,0.11332,0.139807,15,0,0
8576824,"Pohlern, Kreuzgasse",,0.000057,43,1,1,2,1138,1138,2276,16,0.107656,0.136602,2810,0,0
8507895,"Matten b. I., Gsteigstrasse",,0.000023,43,1,1,2,8111,8111,16222,27,0.100101,0.121522,117,0,0
8571318,"Lauterbrunnen, Bahnhof",,0.000055,43,3,3,6,7447,9431,16878,25,0.133646,0.213078,607.533333,0,0
8507898,"Thierachern, unterer Schwand",,0.000029,43,2,1,3,1947,1947,3894,20,0.127283,0.163366,235,0,0
8507901,"Wattenwil, Rössli",,0.000055,43,3,1,4,2427,2457,4884,20,0.127242,0.164889,308,0,0
8571653,"Burgistein, Hohlenwegen",,0.000039,43,1,1,2,1647,1647,3294,20,0.127242,0.164889,17252,0,0
8507907,"Grellingen, Seefeld",,0.000019,53,1,1,2,5674,5674,11348,13,0.135338,0.211066,10,0,0
8571732,"Utzigen, Wohn- und Pflegeheim",,0.000011,47,0,1,1,0,7437,7437,25,0.122931,0.151424,0,0,0
8571858,"Boveresse, gare",,0.000019,49,1,1,2,745,745,1490,28,0.052796,0.062096,0,0,0
8571807,"Le Prévoux, La Soldanelle",,0.000066,134,4,4,8,6414,6414,12828,28,0.063357,0.112075,10032.025,0,0
8571815,"Le Cerneux-Péquignot, M-Lidor",,0.000057,134,1,3,4,3847,3847,7694,35,0.048671,0.09512,2499,0,0
8507926,"Wigoltingen, Schulweg",,0.000062,65,2,2,4,9378,9378,18756,39,0.044132,0.070933,854,0,0
8507928,"Wigoltingen, Engwangerstrasse",,0.000037,65,1,1,2,2921,2921,5842,9,0.178571,0.25254,199.5,0,0
8573338,"Hörhausen, Freihof",,0.000069,65,1,2,3,10974,10974,21948,36,0.04886,0.082305,3180,0,0
8507929,"L'Etivaz, Les Vieux Bains",,0.00004,36,1,1,2,841,841,1682,7,0.246377,0.313305,62,0,0
8507942,"Chur, Prasserieweg",,0.000011,109,0,2,2,0,10688,10688,22,0.106867,0.150365,0,0,0
8507945,"Chur, Tellostrasse",,0.00002,109,1,2,3,3734,3720,7454,22,0.106867,0.150365,596,0,0
8509730,"Tamins, Unterdorf",,0.000011,109,0,7,7,0,9979,9979,20,0.114053,0.159883,0,0,0
8571313,"Chur, Post I",,0.000044,109,6,7,13,41310,159439,200749,21,0.115355,0.167655,4782.289286,0,0
8571950,"Chur, Gewerbliche Berufsschule",,0.000024,109,1,3,4,37355,37276,74631,18,0.14125,0.197182,942.833333,0,0
8572404,"Chur, Wiesental",,0.000034,109,2,2,4,22241,22462,44703,23,0.113914,0.166005,2599.333333,0,0
8572453,"Chur, Lachen",,0.000031,109,2,6,8,44122,44167,88289,23,0.121295,0.180011,2822,0,0
8572658,"Chur, Daleustrasse",,0.000026,109,1,3,4,21996,22004,44000,23,0.120413,0.173651,878,0,0
8574493,"Chur, Malteser",,0.000113,109,11,4,15,51953,54073,106026,23,0.125185,0.178576,11958.466667,0,0
8574669,"Chur, Kalchbühl",,0.000089,109,2,2,4,45674,45676,91350,23,0.153479,0.218082,3783.166667,0,0
8574670,"Chur, Plankis",,0.00008,109,4,3,7,45109,42890,87999,23,0.155448,0.22164,1573.6,0,0
8574699,"Chur, Masans Kirche",,0.000086,109,1,6,7,40453,39977,80430,11,0.193036,0.247788,80175.064103,0,0
8574701,"Chur, Halbmil",,0.000031,109,1,4,5,17041,17042,34083,12,0.181818,0.235263,3021,0,0
8574705,"Trimmis, Alt Strass",,0.000059,109,2,7,9,17860,18318,36178,11,0.191186,0.249003,65962,0,0
8574707,"Untervaz, Bahnhof",,0.000037,109,3,4,7,16924,17114,34038,23,0.164312,0.239071,150467.784524,0,0
8574710,"Chur, Hof",,0.000011,109,0,1,1,0,5158,5158,23,0.157277,0.222146,0,0,0
8580587,"Domat/Ems, Abzw. Felsberg",,0.000063,109,2,2,4,16295,16306,32601,23,0.158268,0.226665,63911,0,0
8580882,"Sevelen, Rietli",,0.000088,73,3,3,6,17349,17349,34698,23,0.171765,0.242843,85452.13515,0,0
8580926,"Untervaz, Holcim",,0.000055,109,4,2,6,14485,10969,25454,23,0.159366,0.226321,6788.5,0,0
8581040,"Igis, Castaletweg",,0.000057,109,2,4,6,10260,10260,20520,23,0.1595,0.234811,15745,0,0
8581043,"Igis, Gruobhof",,0.000054,109,1,2,3,9908,5811,15719,23,0.1574,0.224634,215,0,0
8507943,"Chur, Ruchenbergstrasse",,0.000011,109,0,1,1,0,3734,3734,23,0.096696,0.124991,0,0,0
8507947,"Beatenberg, Tourist-Center",,0.000056,43,2,1,3,4590,4827,9417,27,0.099005,0.119052,1576,0,0
8570284,"Mutrux, Le Ravin (Sylvabella)",,0.000046,35,1,3,4,4023,4023,8046,19,0.107728,0.140848,1748,0,0
8507956,"Rances, bif.",,0.000033,35,2,2,4,4384,4455,8839,45,0.045516,0.064066,1444,0,0
8570243,"Rances, Praz-Riond",,0.000033,35,1,1,2,4175,4356,8531,25,0.083137,0.102122,464,0,0
8507959,"Rueyres VD, croisée",,0.00003,35,1,2,3,3912,3912,7824,43,0.048428,0.066966,576.666667,0,0
8570304,"Ursins, Grange-des-Bois",,0.000025,35,1,1,2,2881,2881,5762,43,0.04332,0.054211,1983.833333,0,0
8507962,"Suscévaz, village",,0.000025,35,1,1,2,4356,4356,8712,44,0.047479,0.068078,2398,0,0
8570178,"Bottens, croisée",,0.000065,10,2,2,4,20959,21113,42072,26,0.085685,0.101775,13545.975668,0,0
8570309,"Cronay, église",,0.000025,35,1,2,3,5112,5112,10224,37,0.056705,0.078082,18869.348291,0,0
8570317,"Thierrens, En Tombaz",,0.000042,13,2,2,4,4947,4944,9891,37,0.054801,0.073568,28346.361255,0,0
8507965,"Tuileries-de-Grandson, Kiosque",,0.000095,35,4,3,7,9827,9827,19654,24,0.076537,0.091935,4719.333333,0,0
8507968,"Villars-Burquin, pl. fontaine",,0.000038,35,1,1,2,950,950,1900,24,0.076194,0.087505,0,0,0
8557045,"Bonvillars, la Croix",,0.000038,35,1,1,2,8847,8847,17694,24,0.076194,0.087505,0,0,0
8507966,"Ursins, Le Battoir",,0.000024,35,1,1,2,2881,2881,5762,43,0.048817,0.068434,782.666667,0,0
8507992,"Bern, Bremgartenfriedhof",,0.000041,44,3,2,5,39949,40016,79965,24,0.128994,0.157063,1700.660317,0,0
8571345,"Eymatt b. Bern, Camping",,0.000039,44,2,5,7,32235,32235,64470,26,0.103867,0.128543,5762.100794,0,0
8507978,"Gurnigel, Wasserscheide",,0.000044,44,1,1,2,472,443,915,22,0.060594,0.074036,2457,0,0
8507980,"Frauenkappelen, Post",,0.000016,44,1,1,2,7172,7906,15078,13,0.134266,0.160595,86,0,0
8507981,"Beatenberg, Mättli",,0.000058,43,1,2,3,4827,4827,9654,26,0.109601,0.137527,1954,0,0
8571312,"Unterseen, Hohmüedig",,0.000054,43,2,2,4,7882,7882,15764,6,0.275,0.34697,215,0,0
8507983,"Niedermuhlern, Baumgärtli",,0.000055,44,3,4,7,10886,10886,21772,25,0.122004,0.155276,38044.664747,0,0
8571413,Brühlplatz,,0.000023,44,1,1,2,14343,14343,28686,26,0.108921,0.127856,10355,0,0
8571626,Thalgutstrasse,,0.000042,100,1,3,4,6825,6788,13613,13,0.2,0.351872,83,0,0
8571628,"Gerzensee, Studienzentrum",,0.00003,100,1,3,4,5025,5025,10050,13,0.193277,0.353484,23,0,0
8507990,Belp Mühlematt,,0.000011,100,0,1,1,0,6427,6427,8,0.197183,0.231519,0,0,0
8510151,Holligen,,0.000015,44,1,1,2,9797,10028,19825,25,0.119972,0.148948,50453.666667,0,0
8507993,Bethlehem Säge,,0.000015,44,1,1,2,22284,23816,46100,26,0.107374,0.128341,7413.666667,0,0
8571343,"Bern, Weyermannshaus",,0.00003,44,3,2,5,32235,32235,64470,26,0.10892,0.133254,479.600794,0,0
8571257,"Wiler bei Seedorf, Grissenberg",,0.000023,44,1,1,2,3471,3471,6942,24,0.104687,0.118054,504,0,0
8571258,"Seedorf BE, Schulhaus",,0.000051,44,3,2,5,7877,7877,15754,23,0.116757,0.135635,1332.333333,0,0
8571260,"Aarberg, Bernfeld",,0.000039,44,1,1,2,4307,497,4804,23,0.116477,0.133841,685,0,0
8571372,Ausserortschwaben,,0.000036,44,1,2,3,11206,11206,22412,28,0.075312,0.085161,29242.5,0,0
8571373,"Ortschwaben, Gehracker",,0.000046,44,3,2,5,9963,9963,19926,28,0.078616,0.08861,1690.916667,0,0
8576306,"Adelboden, Mineralquelle",,0.000084,43,1,3,4,21154,21154,42308,38,0.055994,0.073075,5677,0,0
8507997,"Frutigen, Chriesbaum",,0.00004,43,1,1,2,11452,11452,22904,41,0.048251,0.057786,1284,0,0
8508006,Wynigen,,0.000029,11,1,1,2,9923,9920,19843,26,0.076152,0.098754,0,0,0
8508020,"Ascharina, Tola",,0.000011,112,0,1,1,0,736,736,24,0.065465,0.077601,0,0,0
8508022,"Ascharina, Bartlischhus",,0.00002,112,1,1,2,736,791,1527,23,0.069797,0.08353,275,0,0
8508024,"Ascharina, Alpstrasse",,0.000028,112,1,1,2,791,791,1582,22,0.074761,0.091322,548,0,0
8508026,"Ascharina, Gürgetsch",,0.000035,112,1,3,4,791,791,1582,21,0.080507,0.103628,819,0,0
8508030,"St. Antönien, Stapfaschärma",,0.000029,112,1,2,3,514,528,1042,21,0.079988,0.098858,271,0,0
8508031,"St. Antönien, Bord",,0.000033,112,2,2,4,530,544,1074,20,0.086538,0.108099,1085,0,0
8508028,"St. Antönien, Gafierstrasse",,0.000021,112,1,1,2,478,514,992,22,0.074317,0.08893,4,0,0
8508029,"Sarn, Lescha Gianal",,0.000011,109,0,1,1,0,26,26,34,0.061858,0.07383,0,0,0
8509735,Gadenstätt,,0.000051,112,1,3,4,4252,4252,8504,19,0.093805,0.118124,792,0,0
8509736,"Luzein, Strilserrank",,0.000025,112,1,2,3,3516,3649,7165,19,0.093487,0.114821,0,0,0
8577814,"Granges-Paccot, Chenevière",,0.000058,126,1,1,2,16382,16382,32764,15,0.129719,0.149776,3095.612121,0,0
8508036,"Dardagny, Route de Malval",,0.00002,120,1,1,2,11073,11073,22146,23,0.095541,0.104899,615,0,0
8508038,"Dardagny, douane",,0.000028,120,1,1,2,11073,11073,22146,22,0.105462,0.117444,1228,0,0
8508051,Bern Felsenau,,0.000038,11,1,1,2,29350,29350,58700,6,0.264706,0.319444,1464,0,0
8508056,Moosseedorf,,0.000043,11,1,1,2,34768,34753,69521,6,0.25,0.316667,1504,0,0
8508057,Schönbühl RBS,,0.000047,11,1,1,2,34753,34740,69493,5,0.305556,0.366667,763,0,0
8508059,Jegenstorf,,0.000114,11,3,4,7,58595,49143,107738,3,0.6,0.703704,6754,0,0
8508060,Grafenried,,0.000035,11,1,1,2,11674,16148,27822,5,0.333333,0.420833,0,0,0
8508062,Büren zum Hof,,0.000038,11,1,3,4,9860,9860,19720,3,0.6,0.722222,7,0,0
8508063,Schalunen,,0.000049,11,2,1,3,9649,9634,19283,5,0.333333,0.456667,3,0,0
8508068,Biberist RBS,,0.000087,11,1,1,2,23880,642,24522,2,0.666667,0.75,17,0,0
8508061,Fraubrunnen,,0.000065,11,2,2,4,16357,16357,32714,4,0.4375,0.559524,1519,0,0
8508066,Lohn-Lüterkofen,,0.00009,11,2,1,3,23883,23880,47763,3,0.5,0.611111,776,0,0
8508070,Oberzollikofen,,0.00012,11,3,1,4,34883,34768,69651,1,1,1,763,0,0
8508072,Schönbühl,,0.000011,89,0,2,2,0,4865,4865,4,0.4,0.555556,0,0,0
8508894,Bäriswil,,0.000016,89,1,1,2,2486,2486,4972,4,0.357143,0.466667,0,0,0
8571391,"Zollikofen, Wydacker",,0.000074,44,1,1,2,11335,11321,22656,25,0.123128,0.152063,6305.916667,0,0
8576991,Kasernenstrasse,,0.000018,44,1,2,3,8185,8185,16370,14,0.133211,0.165598,171.267857,0,0
8576992,Aespliz,,0.000072,44,6,2,8,17444,17445,34889,14,0.135254,0.170399,8605.95119,0,0
8576983,Worblaufen,,0.000059,44,3,4,7,9017,11048,20065,15,0.125277,0.166632,12407.85,0,0
8576993,Papiermühle,,0.000068,44,4,5,9,17860,16414,34274,13,0.149554,0.198022,22359.638095,0,0
8576998,"Bolligen, Bahnhof",,0.000045,44,3,6,9,17782,22705,40487,21,0.113826,0.16485,13365.75,0,0
8571364,"Uettligen, Dorf",,0.00005,44,2,3,5,14319,13962,28281,24,0.08509,0.106672,6205,0,0
8571384,"Kirchlindach, Heimenhaus",,0.000036,44,1,1,2,7766,7766,15532,31,0.071324,0.078467,5705.5,0,0
8571387,"Zollikofen, Webergutstrasse",,0.000068,44,1,1,2,11225,11225,22450,28,0.090269,0.101888,6877.916667,0,0
8576978,Waldegg,,0.000072,44,1,2,3,8928,7412,16340,18,0.09375,0.11747,2571,0,0
8576980,"Zollikofen, alte Post",,0.000042,44,1,1,2,3662,3662,7324,18,0.093387,0.113682,0,0,0
8508078,Rössli,,0.000015,44,1,2,3,550,7377,7927,25,0.122653,0.153085,1129.291667,0,0
8576458,"Bolligen, Stockeren",,0.000055,44,1,1,2,4452,4452,8904,26,0.109272,0.129379,7361,0,0
8576459,"Bolligen, Halen",,0.000064,44,2,1,3,8202,8202,16404,25,0.122478,0.151704,7962,0,0
8508079,"Krauchthal, Post",,0.000011,44,0,1,1,0,4694,4694,36,0.053001,0.059099,0,0,0
8508080,Oberburg,,0.000029,11,1,1,2,30291,30037,60328,10,0.191011,0.243775,1021.125,0,0
8508262,Walkringen,,0.0001,11,1,2,3,19036,19182,38218,5,0.37931,0.487879,1639,0,0
8508264,Schafhausen i.E.,,0.000056,11,1,1,2,10568,10568,21136,5,0.346154,0.42963,9,0,0
8508083,Burgdorf Buchmatt,,0.000037,11,2,1,3,17868,14598,32466,13,0.132075,0.167819,770,0,0
8508085,Aefligen,,0.000069,11,3,1,4,18698,18698,37396,11,0.171533,0.220999,3168,0,0
8508087,Wiler,,0.00004,11,1,1,2,18447,18498,36945,12,0.145161,0.184077,1528,0,0
8508088,Gerlafingen,,0.000045,11,1,1,2,18498,18099,36597,11,0.166038,0.211446,808,0,0
8508093,"Satigny, Choully-Nord",,0.00002,132,1,1,2,6072,6072,12144,26,0.085595,0.103089,492,0,0
8508099,"Grand-Saconnex, temple",,0.000035,120,1,2,3,12193,12193,24386,19,0.1364,0.155584,2019,0,0
8510219,"Chambésy, Pierrière",,0.000026,120,1,1,2,6098,6097,12195,19,0.136225,0.154327,0,0,0
8508101,Roggwil-Wynau,,0.000033,9,1,1,2,16641,16634,33275,2,0.666667,0.75,1522,0,0
8508102,Murgenthal,,0.000039,9,1,1,2,16634,15747,32381,1,1,1,762,0,0
8508113,"Vandoeuvres, Sous Pressy",,0.000011,120,0,1,1,0,13424,13424,22,0.13055,0.146405,0,0,0
8508122,"Sirnach, Ebnet",,0.000023,20,1,1,2,14062,13679,27741,23,0.078832,0.122539,31.5,0,0
8508124,"Sirnach, Sonnenberg",,0.00003,20,1,1,2,13679,14062,27741,22,0.083994,0.131474,81.5,0,0
8508126,"Münchwilen TG, Sirnacherstr.",,0.000037,20,1,1,2,14062,14062,28124,21,0.089965,0.144386,129.5,0,0
8578600,"Sirnach, Kläffler",,0.000053,20,1,1,2,22834,22834,45668,21,0.089965,0.144386,2230,0,0
8508128,"Bernex, Hainard",,0.000011,120,0,1,1,0,58672,58672,22,0.129456,0.144168,0,0,0
8508130,"Bernex, Luchepelet",,0.00002,120,1,3,4,58672,111343,170015,21,0.148481,0.171292,660,0,0
8508132,"Bernex, Pré-Marais",,0.000017,120,1,1,2,58672,58640,117312,21,0.146842,0.166628,0,0,0
8508151,Langenthal Gaswerk,,0.000033,9,1,2,3,36658,36658,73316,7,0.25,0.35372,12156,0,0
8508152,Hard-Mumenthal,,0.000025,9,1,1,2,18553,18553,37106,6,0.266667,0.3625,6076,0,0
8508153,Aarwangen,,0.000032,9,1,1,2,18553,18553,37106,5,0.318182,0.409524,5321,0,0
8508154,Aarwangen Schloss,,0.000038,9,1,1,2,18553,18553,37106,4,0.4,0.486111,4564,0,0
8508155,Bannwil,,0.000043,9,1,2,3,18553,18502,37055,3,0.555556,0.666667,3805,0,0
8508159,Niederbipp Dorf,,0.000041,9,1,1,2,17632,17632,35264,2,0.666667,0.75,4,0,0
8508157,Holzhäusern,,0.000029,9,1,1,2,17684,17632,35316,4,0.4,0.520833,1532,0,0
8508158,Scharnageln,,0.000036,9,1,1,2,17632,17632,35264,3,0.5,0.611111,769,0,0
8508161,Kaltenherberg,,0.000025,9,1,1,2,18105,18105,36210,5,0.333333,0.436111,4572,0,0
8508162,Roggwil Dorf,,0.000032,9,1,1,2,18105,18105,36210,4,0.416667,0.516667,3815,0,0
8508163,St. Urban,,0.000038,9,1,2,3,18105,18105,36210,3,0.571429,0.708333,3056,0,0
8508164,St. Urban Ziegelei,,0.000027,9,1,1,2,9556,9556,19112,3,0.5,0.611111,0,0,0
8508168,Roggwil Buchägerten,,0.00005,9,2,1,3,18105,18105,36210,2,0.666667,0.75,1532,0,0
8508957,"Thunstetten, Schloss",,0.000016,88,1,2,3,6976,7473,14449,12,0.169118,0.221183,42,0,0
8576917,"Herzogenbuchsee, Bahnhof",,0.000132,88,5,6,11,38711,38710,77421,11,0.188732,0.284027,2835.833333,0,0
8576925,"Langenthal, Zelgli",,0.000056,88,1,2,3,21235,21235,42470,20,0.143204,0.253436,354,0,0
8508173,Roggwil Schmitten,,0.000053,9,1,1,2,18105,18105,36210,1,1,1,767,0,0
8508174,Gutenburg,,0.000033,9,1,1,2,16404,16051,32455,11,0.136364,0.209129,5360,0,0
8508175,"Huttwil, Fiechten",,0.000011,45,0,2,2,0,5861,5861,11,0.170507,0.23695,0,0,0
8508179,Tschäppel,,0.00002,45,1,1,2,7767,7767,15534,12,0.158798,0.207477,37,0,0
8508188,"Eriswil, Hinterdorf",,0.000033,45,2,2,4,8382,7825,16207,11,0.183673,0.251158,92,0,0
8508189,"Eriswil, Station",,0.000025,45,1,2,3,7433,7970,15403,11,0.198864,0.271872,76,0,0
8508178,"Huttwil, Uech",,0.000011,45,0,1,1,0,7767,7767,13,0.140221,0.183156,0,0,0
8508181,Langenthal Süd,,0.000039,9,1,1,2,16051,16404,32455,10,0.149123,0.221312,4616,0,0
8508182,Lotzwil,,0.000044,9,1,1,2,16404,16404,32808,9,0.164948,0.235962,3870,0,0
8508183,Madiswil,,0.000048,9,1,1,2,16404,16051,32455,8,0.185185,0.254206,3122,0,0
8508184,Lindenholz,,0.000052,9,1,1,2,16051,16404,32455,7,0.212121,0.278061,2372,0,0
8508185,Kleindietwil,,0.000055,9,1,1,2,16404,16404,32808,6,0.25,0.311538,1620,0,0
8508186,Rohrbach,,0.000058,9,1,1,2,16404,16374,32778,5,0.307692,0.363889,866,0,0
8508250,Schwäbis,,0.00004,11,1,1,2,11572,11572,23144,12,0.13986,0.210123,0,0,0
8508255,Oberdiessbach,,0.000078,11,2,2,4,20433,20447,40880,8,0.217391,0.325159,845,0,0
8508256,Stalden i.E.,,0.000044,11,1,1,2,11572,472,12044,8,0.205882,0.276956,0,0,0
8508203,Zäziwil,,0.00004,11,1,2,3,19313,19214,38527,10,0.175758,0.259373,2310,0,0
8508204,Bowil,,0.000028,11,1,1,2,19126,19131,38257,10,0.170732,0.232922,0,0,0
8508208,Trubschachen,,0.000041,11,1,1,2,18985,19257,38242,7,0.217391,0.281746,7676,0,0
8508210,Escholzmatt,,0.000046,11,1,1,2,19257,18999,38256,6,0.259259,0.325,6915,0,0
8508211,Schüpfheim,,0.00005,11,1,2,3,18999,19249,38248,5,0.325,0.412821,6152,0,0
8508212,Hasle LU,,0.000032,11,1,1,2,10459,10190,20649,5,0.307692,0.363889,0,0,0
8508215,Wolhusen,,0.000122,9,3,5,8,55202,40139,95341,3,0.625,0.733333,7910,0,0
8508217,Schachen LU,,0.000038,9,1,1,2,10060,10060,20120,5,0.333333,0.456667,5,0,0
8508292,Hüswil,,0.000032,9,1,1,2,9735,9686,19421,5,0.333333,0.456667,0,0,0
8508219,Littau,,0.000065,9,1,1,2,13480,3437,16917,3,0.5,0.611111,9,0,0
8508294,Gettnau,,0.000061,9,1,1,2,14334,14334,28668,3,0.5,0.611111,6,0,0
8508216,Werthenstein,,0.000032,9,1,1,2,10060,10060,20120,6,0.285714,0.408333,792,0,0
8508218,Malters,,0.000064,9,2,1,3,22551,13480,36031,4,0.4,0.520833,800,0,0
8570487,"Corserey, Café du Châtaignier",,0.000025,126,1,1,2,4803,4803,9606,22,0.087313,0.099265,6382.978484,0,0
8508236,"Chalais, Bozon",,0.000026,39,1,1,2,16534,16534,33068,23,0.07959,0.113265,3481.833333,0,0
8508238,"Noës, Ecossia",,0.000033,39,1,2,3,16534,16534,33068,22,0.086045,0.132277,3636.833333,0,0
8508241,"Sierre, Sablons",,0.000025,39,1,1,2,8082,8281,16363,22,0.083438,0.117315,183,0,0
8574788,"St. Moritz, Kulm",,0.000033,30,4,3,7,8284,14546,22830,10,0.203883,0.261187,73.809524,0,0
8574935,"Pontresina, Bahnhof",,0.000026,30,2,2,4,7032,7313,14345,9,0.241245,0.294886,42.245635,0,0
8587029,"Anières, village",,0.000011,120,0,1,1,0,30882,30882,21,0.146325,0.166471,0,0,0
8587054,"Meinier, Corsinge-village",,0.00004,120,2,2,4,6299,6299,12598,22,0.129135,0.147123,1276.824603,0,0
8587061,"Genève, Rive",,0.000072,120,5,15,20,291513,401941,693454,18,0.206863,0.264087,6768.179937,0,0
8587066,"Gy, temple",,0.000032,120,2,2,4,18365,18365,36730,22,0.13147,0.151884,111.377778,0,0
8587067,"Hermance, village",,0.000022,120,2,2,4,43936,43937,87873,22,0.13282,0.154842,290.14596,0,0
8508251,Steffisburg,,0.000074,11,2,1,3,20447,20282,40729,11,0.154472,0.228009,3869,0,0
8508252,Lädeli,,0.000074,11,1,1,2,20282,20087,40369,10,0.173077,0.255203,3116,0,0
8508253,Heimberg,,0.000074,11,1,2,3,20087,20447,40534,9,0.197674,0.311578,2361,0,0
8508254,Brenzikofen,,0.000042,11,1,1,2,11572,11558,23130,9,0.188235,0.268552,0,0,0
8508258,"Montbovon, gare",,0.000023,13,1,2,3,422,872,1294,20,0.107876,0.124714,378,0,0
8508270,"Lessoc, gare",,0.000021,13,1,1,2,450,450,900,20,0.107628,0.122458,0,0,0
8508260,Grosshöchstetten,,0.000111,11,3,1,4,19182,19182,38364,7,0.240741,0.310989,3171,0,0
8508261,Biglen,,0.000105,11,1,1,2,19182,19036,38218,6,0.292683,0.366667,2406,0,0
8508263,Bigenthal,,0.000054,11,1,1,2,10568,10568,21136,6,0.277778,0.356667,780,0,0
8508271,Grünenmatt,,0.000025,11,1,1,2,18309,18309,36618,1,1,1,2,0,0
8508267,Ramsei,,0.000032,11,1,2,3,19357,27608,46965,4,0.461538,0.597222,2368,0,0
8508268,Zollbrück,,0.000025,11,1,1,2,9299,9299,18598,3,0.5,0.611111,792,0,0
8508277,"Albeuve, gare",,0.000038,13,2,1,3,872,872,1744,19,0.120298,0.140291,900,0,0
8508281,"Wasen i.E., Oberei",,0.000011,45,0,1,1,0,9093,9093,14,0.13245,0.203193,0,0,0
8508282,"Sumiswald, Forum",,0.00002,45,1,1,2,9093,9093,18186,13,0.145038,0.217146,19,0,0
8508283,"Sumiswald, Ey",,0.000028,45,1,1,2,9093,9093,18186,12,0.160714,0.23543,36,0,0
8508293,Zell LU,,0.000059,9,2,1,3,14295,14334,28629,4,0.4,0.520833,796,0,0
8508295,Willisau,,0.000138,9,3,1,4,21015,21019,42034,2,0.666667,0.75,1598,0,0
8508297,Menznau,,0.000129,9,1,1,2,21019,17338,38357,1,1,1,800,0,0
8508308,Meiringen,,0.000173,11,3,3,6,16393,28648,45041,14,0.142857,0.260373,17510,0,0
8508314,Sarnen,,0.000082,9,1,2,3,29164,22033,51197,8,0.261538,0.362815,8499,0,0
8508309,Brünig-Hasliberg,,0.00006,9,1,1,2,7468,7556,15024,13,0.133333,0.195363,10819,0,0
8508310,Lungern,,0.000062,9,1,1,2,7556,7556,15112,12,0.146853,0.208789,10000,0,0
8508313,Sachseln,,0.000084,9,2,1,3,29164,29164,58328,9,0.216867,0.28772,9326,0,0
8508321,Luzern Allmend/Messe,,0.000038,9,2,3,5,42517,42532,85049,6,0.36,0.55,314.5,0,0
8508384,Niederrickenbach Station,,0.000044,9,3,2,5,9292,9292,18584,5,0.388889,0.540476,3507,0,0
8508320,Hergiswil Matt,,0.000021,9,1,1,2,39693,39678,79371,7,0.285714,0.392619,0,0,0
8508327,Ewil Maxon,,0.000041,9,1,1,2,19604,19604,39208,1,1,1,123.5,0,0
8508391,Stans,,0.000076,9,2,2,4,32441,29351,61792,4,0.454545,0.616667,3842.5,0,0
8508392,Dallenwil,,0.000043,9,1,2,3,20316,20316,40632,3,0.571429,0.708333,2565,0,0
8508394,Wolfenschiessen,,0.000029,9,1,2,3,19814,19578,39392,2,0.75,0.833333,1712,0,0
8508399,Engelberg,,0.000031,9,1,1,2,9056,252,9308,1,1,1,1,0,0
8508323,Sarnen Nord,,0.000036,9,2,1,3,21608,19604,41212,2,0.666667,0.75,974.5,0,0
8577731,"La Tour-de-Trême, Centre",,0.000088,13,3,5,8,39616,42129,81745,13,0.148663,0.215963,21109.740765,0,0
8508350,Brienz BRB,,0.000011,24,0,1,1,0,1532,1532,2,0.666667,0.75,0,0,0
8508351,Planalp,,0.00002,24,1,1,2,1532,1532,3064,1,1,1,1,0,0
8508359,Innertkirchen Kraftwerk (Bahn),,0.00006,11,1,1,2,12390,12390,24780,5,0.333333,0.456667,4200,0,0
8508370,Interlaken Ost (See),,0.000011,25,0,1,1,0,1211,1211,5,0.35,0.445238,0,0,0
8508371,Bönigen,,0.00002,25,1,2,3,1211,1211,2422,4,0.461538,0.597222,6,0,0
8508372,Ringgenberg (See),,0.000019,25,1,3,4,1022,871,1893,3,0.625,0.766667,5,0,0
8508373,Niederried (See),,0.000016,25,1,1,2,454,342,796,3,0.5,0.611111,0,0,0
8508374,Oberried am Brienzersee (See),,0.000025,25,2,1,3,300,340,640,3,0.5,0.611111,3,0,0
8508376,Brienz (See),,0.000052,25,3,1,4,988,1211,2199,2,0.666667,0.75,10,0,0
8508378,Giessbach See,,0.000055,25,1,1,2,1211,1211,2422,1,1,1,6,0,0
8508390,Stansstad,,0.000055,9,3,1,4,23652,23637,47289,5,0.352941,0.463889,1357.5,0,0
8508395,Innertkirchen Grimseltor,,0.000062,11,1,1,2,12390,12390,24780,4,0.4,0.520833,3364,0,0
8508396,Grafenort,,0.000023,9,1,1,2,9056,9056,18112,2,0.666667,0.75,857,0,0
8508449,Aemsigen,,0.000011,26,0,1,1,0,2990,2990,2,0.666667,0.75,0,0,0
8508732,"Stansstad, Abzw. Rotzloch",,0.000011,62,0,1,1,0,3730,3730,48,0.06921,0.115588,0,0,0
8508734,"Stans, St. Josef",,0.000023,62,1,2,3,6641,6641,13282,48,0.069662,0.118502,1262,0,0
8508769,"Kerns, Post",,0.000041,62,3,3,6,10659,14063,24722,48,0.069829,0.121923,6222,0,0
8508799,"Ennetbürgen, Dorf",,0.00004,62,1,1,2,1675,1675,3350,48,0.06921,0.115588,2504,0,0
8508896,"Stans, Bahnhof",,0.000078,62,5,6,11,12181,17624,29805,47,0.074237,0.140439,12315.5,0,0
8508754,"Eigenthal, Eigenthalerhof",,0.000042,90,1,3,4,4349,4349,8698,47,0.070296,0.127373,4500.708333,0,0
8573043,"Luzern, Eichhof",,0.000032,90,3,8,11,202216,197321,399537,45,0.078851,0.176119,23605.970238,0,0
8573046,"Obernau, Dorf",,0.000039,90,1,3,4,66686,66592,133278,45,0.074244,0.134773,1469,0,0
8572928,"Stansstad, Bahnhof",,0.000079,62,3,3,6,6365,8154,14519,14,0.150148,0.187693,2260,0,0
8577144,Luzern Schönbühl,,0.000015,90,2,4,6,91158,94760,185918,50,0.060031,0.140959,390.910073,0,0
8581978,Luzern Wey,,0.000038,90,2,5,7,93043,92901,185944,11,0.240527,0.294708,898.001099,0,0
8589694,Horw Waldegg,,0.000079,90,3,3,6,45366,43759,89125,9,0.232759,0.277254,4947.257143,0,0
8589696,Horw Seefeld,,0.000033,90,1,2,3,34979,34980,69959,9,0.230548,0.268219,0,0,0
8573022,"Luzern, Pilatusplatz",,0.000041,90,5,5,10,347550,390275,737825,46,0.074648,0.150153,22673.339286,0,0
8589769,Luzern Bodenhofterrasse,,0.00004,90,2,2,4,62064,62054,124118,9,0.246795,0.294563,125,0,0
8589772,Luzern Brüelstrasse,,0.000142,90,8,6,14,140882,144859,285741,8,0.32377,0.398749,5850.192613,0,0
8589774,Luzern Brünigstrasse,,0.000053,90,1,2,3,48648,48600,97248,9,0.245223,0.288719,804.52381,0,0
8508456,Pilatus Kulm,,0.00002,26,1,1,2,2990,2990,5980,1,1,1,1,0,0
8508459,Verkehrshaus-Lido,,0.000011,27,0,8,8,0,4477,4477,7,0.350649,0.525044,0,0,0
8508462,Hertenstein (See),,0.000012,27,1,1,2,3130,3787,6917,7,0.272727,0.343122,0,0,0
8508478,Kastanienbaum (See),,0.000012,27,1,3,4,319,525,844,2,0.636364,0.714286,0.6,0,0
8508480,Kehrsiten Dorf,,0.000015,27,2,2,4,488,488,976,3,0.5,0.611111,0.5,0,0
8508481,Hergiswil (See),,0.000022,27,3,3,6,656,656,1312,2,0.714286,0.8,4.6,0,0
8508461,Seeburg,,0.000012,27,1,1,2,268,268,536,4,0.357143,0.466667,2,0,0
8508464,Vitznau,,0.000077,27,2,3,5,10393,3812,14205,6,0.355556,0.490625,230,0,0
8508466,Buochs (See),,0.000039,27,1,1,2,247,247,494,6,0.311111,0.394048,14,0,0
8508467,Beckenried (See),,0.000072,27,3,5,8,3349,3202,6551,5,0.419355,0.598718,205,0,0
8508470,Brunnen (See),,0.000047,27,1,3,4,2320,2210,4530,3,0.555556,0.633333,125,0,0
8508476,Flüelen (See),,0.000073,27,5,2,7,2018,1945,3963,2,0.666667,0.75,20,0,0
8508483,Stansstad (See),,0.000025,27,3,2,5,587,587,1174,2,0.666667,0.75,3.1,0,0
8508485,Hermitage,,0.000029,27,1,1,2,268,268,536,2,0.6,0.666667,6,0,0
8508488,Küssnacht am Rigi (See),,0.000012,27,1,1,2,144,144,288,2,0.6,0.666667,0.6,0,0
8508489,Kehrsiten-Bürgenstock,,0.000084,27,5,1,6,445,5060,5505,2,0.6,0.666667,0,0,0
8508465,Ennetbürgen (See),,0.000033,27,1,1,2,227,247,474,7,0.25,0.317302,18,0,0
8508468,Gersau (See),,0.000023,27,1,1,2,2023,2203,4226,5,0.292683,0.35,0,0,0
8508471,Rütli,,0.000024,27,1,4,5,1902,1945,3847,3,0.5625,0.685185,99,0,0
8508473,Tellsplatte,,0.00003,27,2,2,4,799,799,1598,3,0.5,0.595238,7,0,0
8508474,Bauen (See),,0.000029,27,2,2,4,1449,1398,2847,3,0.5,0.611111,27,0,0
8508475,Isleten-Isenthal,,0.000023,27,1,1,2,1370,1370,2740,3,0.454545,0.533333,0,0,0
8508469,Treib,,0.000043,27,2,1,3,2320,2320,4640,4,0.37931,0.431818,137,0,0
8508472,Sisikon (See),,0.000016,27,1,1,2,771,771,1542,4,0.363636,0.4375,0,0,0
8508479,Tribschen,,0.000021,27,1,1,2,268,268,536,3,0.444444,0.541667,5,0,0
8508492,Luzern Bahnhofquai,,0.000222,27,11,2,13,10415,1049,11464,1,1,1,78,0,0
8508646,"Flühli LU, Schintmoos",,0.000011,92,0,1,1,0,3971,3971,22,0.083056,0.110412,0,0,0
8508647,"Flühli LU, Golfplatz",,0.00002,92,1,1,2,3971,3891,7862,21,0.089372,0.117646,74,0,0
8508648,"Flühli LU, Hirseggbrücke",,0.000028,92,1,1,2,3891,3891,7782,20,0.096817,0.126691,146,0,0
8508649,"Sörenberg, Hirsegg",,0.000035,92,1,1,2,3891,3891,7782,19,0.105727,0.138483,216,0,0
8508708,"Mauensee, Dorf",,0.000019,59,2,1,3,3200,3200,6400,52,0.052133,0.082107,166.666667,0,0
8572761,"Nebikon, Käserei",,0.000036,59,3,2,5,9325,9450,18775,52,0.052538,0.086086,687,0,0
8572763,"Schötz, St. Mauritz",,0.000044,59,3,4,7,11609,11534,23143,52,0.052504,0.088532,1073.5,0,0
8572792,"Willisau, Käppelimatt",,0.000035,59,1,3,4,3075,3075,6150,54,0.047331,0.072236,1518,0,0
8508651,"Alberswil, Dorf",,0.000013,59,1,3,4,2160,10372,12532,53,0.050575,0.083465,249.066667,0,0
8557106,"Altishofen, Kreisel",,0.000019,59,1,1,2,6717,6527,13244,54,0.047738,0.069615,3,0,0
8572760,"Nebikon, Bahnhof",,0.000034,59,3,2,5,10611,10561,21172,53,0.050047,0.077973,597.5,0,0
8557089,"Dagmersellen, Löwen",,0.000027,59,3,1,4,10579,10723,21302,52,0.052721,0.084012,168.5,0,0
8508655,"Schwarzenbach(Huttwil),Bühlweg",,0.00004,45,3,1,4,5841,5861,11702,12,0.15493,0.202683,75,0,0
8508656,"Wyssachen, Dürrenbühl",,0.000045,45,1,1,2,5861,5861,11722,11,0.177778,0.233632,102,0,0
8508657,"Marbach LU, Mösli",,0.000011,61,0,1,1,0,4749,4749,14,0.128571,0.200292,0,0,0
8508658,"Huttwil, Schwarzenbach",,0.000049,45,1,2,3,5861,14686,20547,10,0.209459,0.29214,127,0,0
8571536,"Affoltern i.E., Dorf",,0.000058,45,1,2,3,7023,7023,14046,10,0.198582,0.275822,756,0,0
8508659,"Wyssachen, Dorf",,0.000032,45,1,1,2,5861,5861,11722,14,0.148352,0.209773,16,0,0
8508661,"Rüegsbach, Britternmatte",,0.000011,45,0,1,1,0,7023,7023,18,0.110803,0.134679,0,0,0
8508662,"Rüegsbach, Dorf",,0.00002,45,1,2,3,7023,7023,14046,17,0.123572,0.155222,119,0,0
8508884,"Rüegsau, Dorf",,0.000019,45,1,2,3,6874,6874,13748,16,0.139645,0.178745,117,0,0
8508663,"Obergoldbach, Abzw. Landiswil",,0.000011,100,0,1,1,0,2215,2215,10,0.173077,0.245194,0,0,0
8508664,"Landiswil, Dorf",,0.00002,100,1,1,2,2215,2215,4430,9,0.197674,0.278408,17,0,0
8508665,"Obergoldbach, Post",,0.000028,100,1,2,3,2215,2947,5162,8,0.231884,0.346429,32,0,0
8508667,"Schwanden i.E., Schwandenmatt",,0.00003,100,1,2,3,2215,2215,4430,7,0.259259,0.376361,26,0,0
8508666,"Schwanden i.E., Post",,0.000023,100,1,1,2,2215,2215,4430,8,0.217391,0.299524,15,0,0
8571750,"Arni BE, Walke",,0.00005,100,1,2,3,2453,2453,4906,4,0.421053,0.53125,228,0,0
8508668,"Heimisbach, Post",,0.000011,45,0,1,1,0,3740,3740,19,0.093985,0.161116,0,0,0
8508669,"Sarnen, Kreuzstrasse",,0.000011,62,0,1,1,0,4189,4189,20,0.078777,0.106733,0,0,0
8508749,"Flüeli-Ranft, St. Dorothea",,0.000049,62,1,1,2,2672,2672,5344,50,0.06171,0.093353,3810,0,0
8508758,"Flüeli-Ranft, Dorf",,0.000057,62,2,3,5,3295,3299,6594,49,0.065665,0.107354,4446,0,0
8508672,"Malters, Oberdorf",,0.000014,90,1,1,2,3194,4388,7582,55,0.045544,0.058845,6,0,0
8508673,"Malters, Hinter-Widenmatt",,0.000023,90,1,1,2,4388,4388,8776,54,0.047635,0.062487,584,0,0
8508674,"Malters, Mattgut",,0.00003,90,1,1,2,4388,4387,8775,53,0.049931,0.066756,1160,0,0
8508675,"Malters, Liebetsegg",,0.000037,90,1,1,2,4387,4388,8775,52,0.052464,0.071848,1734,0,0
8508676,"Schwarzenberg LU, Schlatt",,0.000042,90,1,1,2,4388,4388,8776,51,0.055273,0.078071,2306,0,0
8508677,"Schwarzenberg LU, Kappelen",,0.000047,90,1,1,2,4388,4388,8776,50,0.058405,0.085955,2876,0,0
8508679,Klusstalden,,0.00004,92,1,1,2,3891,3971,7862,18,0.116585,0.154988,284,0,0
8508680,"Eigenthal, Hochwäldli",,0.000037,90,3,1,4,4423,4349,8772,48,0.065786,0.107518,3939.708333,0,0
8508681,"Sörenberg, Südelhöchi",,0.000045,92,1,2,3,3971,3891,7862,17,0.130112,0.182435,350,0,0
8508682,"Sörenberg, Platz",,0.00003,92,1,2,3,2425,3152,5577,16,0.146809,0.209589,396,0,0
8508683,"Glaubenbielen, Parkplatz",,0.000024,92,1,3,4,742,1045,1787,15,0.165,0.244962,456,0,0
8508759,"Flühli LU, Post",,0.000047,92,1,1,2,3971,3891,7862,13,0.160656,0.20571,55,0,0
8508789,"Sörenberg, Post",,0.000058,92,2,2,4,4633,4633,9266,12,0.1875,0.253457,104,0,0
8508684,Mörlialp,,0.000018,92,1,1,2,221,221,442,14,0.128,0.215849,128,0,0
8508691,"Finsterwald LU, alte Post",,0.000011,92,0,1,1,0,2298,2298,10,0.172589,0.230871,0,0,0
8508692,Gfellen,,0.00002,92,1,2,3,2298,2298,4596,9,0.202454,0.290007,33,0,0
8557064,"Glaubenberg, Passhöhe",,0.00004,92,1,1,2,325,325,650,9,0.189542,0.258169,87,0,0
8572843,"Wolhusen, Viadukt",,0.00002,92,1,2,3,4662,4662,9324,14,0.164794,0.246581,1276,0,0
8572845,"Wolhusen, Emsern",,0.000027,92,1,2,3,4528,4527,9055,12,0.176471,0.255547,432,0,0
8572870,"Schüpfheim, Bahnhof",,0.000054,92,4,4,8,5195,5255,10450,14,0.205479,0.337884,626.5,0,0
8508695,"Grasswil, Post",,0.000011,45,0,1,1,0,7352,7352,14,0.1275,0.147947,0,0,0
8508696,"Rumisberg, Bären",,0.000011,88,0,1,1,0,6948,6948,25,0.060686,0.08494,0,0,0
8508697,"Brienzwiler, Banholzfluh",,0.00002,114,1,1,2,5780,5780,11560,21,0.130366,0.202018,82,0,0
8508698,"Ballenberg West, Museum",,0.000028,114,1,7,8,5780,5780,11560,20,0.14808,0.275474,162,0,0
8508699,"Ballenberg Ost, Museum",,0.000014,114,1,4,5,2308,2308,4616,20,0.136538,0.240095,0,0,0
8557100,"Brienzwiler, Schulhaus",,0.000017,114,2,2,4,237,237,474,20,0.128968,0.211745,0,0,0
8508878,"Hasliberg Wasserwendi, Twing",,0.000046,114,2,3,5,6748,2850,9598,21,0.116788,0.19946,184,0,0
8557129,"Brienz BE, Chilchgasse",,0.000043,114,1,1,2,970,970,1940,22,0.100993,0.146295,187,0,0
8508752,"Axalp, Sportbahnen",,0.000011,114,0,1,1,0,975,975,20,0.122153,0.191753,0,0,0
8571576,"Brünig-Hasliberg, Bahnhof",,0.00003,114,3,2,5,4094,5250,9344,20,0.127789,0.212647,225,0,0
8571580,"Hasliberg Goldern, Urseni",,0.00008,114,2,2,4,4197,3972,8169,20,0.12369,0.209549,499,0,0
8576727,"Brienz BE, Gärbi",,0.000054,114,1,1,2,1337,1337,2674,20,0.122153,0.191753,295,0,0
8508700,"Thörigen, Post",,0.000011,88,0,2,2,0,7971,7971,12,0.155211,0.204736,0,0,0
8508702,"Seeberg BE, Stalderhof",,0.00002,45,1,2,3,7352,9006,16358,13,0.145177,0.174396,152,0,0
8508999,"Oberönz, Kreuzstr.-Burgäschi",,0.000019,45,1,1,2,8510,8506,17016,13,0.144359,0.168928,0,0,0
8508703,"Marbach LU, Post",,0.00002,61,1,2,3,4749,6201,10950,13,0.142077,0.238753,26,0,0
8508704,"Marbach LU, Untergasse",,0.000019,61,1,2,3,4749,4745,9494,13,0.138122,0.228303,2,0,0
8508706,"Bumbach, Alpenrose",,0.000019,61,1,1,2,1954,1957,3911,13,0.133333,0.196149,0,0,0
8508707,"Flühli LU, Krutacher",,0.000043,92,2,1,3,3876,3971,7847,14,0.140845,0.178523,13,0,0
8508709,"Stansstad, Abzw. Fürigen",,0.00002,62,1,1,2,4343,4343,8686,17,0.106285,0.12368,208,0,0
8508710,"Ennetbürgen, Flugplatz",,0.000011,62,0,1,1,0,1675,1675,52,0.054503,0.074221,0,0,0
8508713,"Stans, Kreuzstrasse",,0.00002,62,1,1,2,1675,1675,3350,51,0.057553,0.080877,629,0,0
8508715,"Balm b. Messen, Wendeplatz",,0.000011,87,0,1,1,0,323,323,27,0.079992,0.088395,0,0,0
8508717,"Limpach, Post",,0.000015,87,1,1,2,323,536,859,26,0.086832,0.097569,7.5,0,0
8508720,"Brunnenthal, Dorf",,0.00002,87,1,1,2,323,1550,1873,26,0.086832,0.097356,761,0,0
8508723,Färnigen,,0.00002,114,1,1,2,254,254,508,24,0.09107,0.113199,206,0,0
8508724,"Meien, Husen",,0.000028,114,1,2,3,254,254,508,23,0.099708,0.129243,410,0,0
8508791,"Gadmen, Obermaad",,0.000038,114,1,3,4,2589,2737,5326,22,0.112257,0.150712,1176,0,0
8508726,Langis,,0.000019,92,1,1,2,325,325,650,12,0.130081,0.177808,6,0,0
8508730,"Ennetmoos, Allweg",,0.00002,62,2,1,3,6641,6641,13282,50,0.061623,0.091806,12,0,0
8508731,"Obbürgen, alte Post",,0.000028,62,1,2,3,4343,5339,9682,16,0.118353,0.142182,414,0,0
8557028,"Bürgenstock, Zentrum",,0.000023,62,1,1,2,3934,4076,8010,16,0.117849,0.138018,0,0,0
8508733,St. Jakob (Ennetmoos),,0.000028,62,1,2,3,6641,8783,15424,49,0.065567,0.104486,646,0,0
8508737,"Wiggen, Hilfernstrasse",,0.000044,61,3,1,4,6200,6201,12401,12,0.147436,0.214047,92,0,0
8508738,"Marbach LU, Neugaden",,0.000048,61,1,1,2,6201,6201,12402,11,0.165414,0.241362,110,0,0
8508739,"Marbach LU, Ey",,0.000052,61,1,2,3,6201,6201,12402,10,0.189189,0.296013,126,0,0
8508768,Kemmeriboden,,0.000033,61,1,1,2,1957,1957,3914,10,0.181818,0.260813,0,0,0
8508740,"Hasliberg Hohfluh, Wetterhorn",,0.000014,114,1,1,2,122,3972,4094,25,0.087485,0.130338,24,0,0
8508741,"Hasliberg Hohfluh, Weisstannen",,0.000023,114,1,1,2,3972,4046,8018,24,0.094541,0.14624,92,0,0
8508742,"Hasliberg Goldern, Sandhubel",,0.00003,114,1,2,3,4046,4197,8243,23,0.102941,0.174447,158,0,0
8508765,"Hasliberg Hohfluh, Post",,0.000024,114,1,2,3,4119,4119,8238,23,0.10177,0.169729,6,0,0
8508766,"Hasliberg Hohfluh,Privatklinik",,0.000021,114,1,1,2,4046,4046,8092,23,0.100443,0.157519,0,0,0
8508743,"Sachseln, Dorf",,0.000011,62,0,1,1,0,2634,2634,56,0.045393,0.05786,0,0,0
8508744,"Sachseln, Steinen",,0.00002,62,1,1,2,2634,2634,5268,55,0.047478,0.061391,640,0,0
8508745,"Sachseln, Felsenheim",,0.000028,62,1,1,2,2634,2634,5268,54,0.049766,0.065509,1278,0,0
8508746,"Flüeli-Ranft, Chilchweg",,0.000035,62,1,1,2,2634,2564,5198,53,0.052291,0.070392,1914,0,0
8508747,"Flüeli-Ranft, Kehrwäldli",,0.00004,62,1,1,2,2564,2672,5236,52,0.05509,0.076308,2548,0,0
8508748,"Flüeli-Ranft, Z'Mos",,0.000045,62,1,1,2,2672,2672,5344,51,0.05821,0.083692,3180,0,0
8508750,"Arni BE, Dorf",,0.000036,100,2,1,3,2453,2453,4906,8,0.203125,0.28489,37,0,0
8508751,"Arnisäge BE, Post",,0.000041,100,1,1,2,2453,2040,4493,7,0.235294,0.323016,44,0,0
8571747,"Biglen, Sonne",,0.000043,100,1,1,2,3702,3702,7404,7,0.235294,0.323016,264,0,0
8508757,"Fankhaus (Trub), Schulhaus",,0.000011,123,0,1,1,0,6177,6177,22,0.110683,0.145108,0,0,0
8572916,"Sachseln, Bahnhof",,0.000032,62,1,1,2,2634,2634,5268,1,1,1,38,0,0
8508760,"Gadmen, Post",,0.000023,114,1,1,2,131,2589,2720,25,0.086477,0.107647,24,0,0
8508763,"Guttannen, Dorf",,0.00002,114,1,3,4,1890,1985,3875,25,0.087123,0.117366,205,0,0
8508764,"Handegg, Gelmerbahn",,0.000017,114,1,1,2,1234,1234,2468,25,0.086477,0.107647,0,0,0
8571610,"Guttannen, Boden",,0.000043,114,1,2,3,1890,1890,3780,1,1,1,16,0,0
8508767,"Innertkirchen, Grimseltor",,0.00005,114,3,2,5,4479,4627,9106,24,0.0942,0.122194,829,0,0
8508866,"St. Niklausen OW, alte Post",,0.000043,62,1,1,2,3663,3663,7326,19,0.085018,0.11523,555,0,0
8508770,"Marbach LU, Dorf",,0.000061,61,2,2,4,6201,6201,12402,9,0.211111,0.325773,152,0,0
8508784,"Schangnau, Post",,0.000037,61,1,2,3,4749,4976,9725,9,0.204545,0.316093,9,0,0
8508868,"Bumbach, Skilift",,0.000027,61,1,2,3,2910,2912,5822,9,0.2125,0.327334,3.5,0,0
8508771,"Melchtal, Dorf",,0.000023,62,1,2,3,3658,3663,7321,21,0.073725,0.097807,42,0,0
8508854,Stöckalp,,0.00002,62,1,1,2,1552,1552,3104,21,0.073362,0.092983,0,0,0
8508772,"Menzberg, Dorfplatz",,0.000011,60,0,1,1,0,2024,2024,9,0.22,0.332937,0,0,0
8581330,"Jegenstorf, Zentrum",,0.000073,87,2,2,4,1606,1606,3212,4,0.454545,0.616667,5787.333333,0,0
8581782,"Lyss, Hirschenplatz",,0.00015,87,5,8,13,12737,12815,25552,20,0.164013,0.251487,222606.961905,0,0
8508775,"Nessental, Dorf",,0.000032,114,1,1,2,2737,2589,5326,23,0.10139,0.12791,988,0,0
8508778,"Hasliberg Reuti, Dorf",,0.000052,114,3,3,6,4197,6256,10453,22,0.110016,0.194494,344,0,0
8508795,"Hasliberg Wasserwendi, Dorf",,0.000026,114,1,1,2,3284,3925,7209,22,0.107667,0.165876,0,0,0
8508857,"Hasliberg Goldern, Post",,0.000047,114,2,2,4,4195,4197,8392,21,0.11883,0.202289,273,0,0
8508779,"Richigen, Dorf",,0.000011,100,0,2,2,0,4441,4441,15,0.151316,0.20345,0,0,0
8508785,"Schlosswil, Dorf",,0.000016,100,1,1,2,3576,3576,7152,15,0.149918,0.194697,0,0,0
8571620,Münsingen Bahnhof,,0.000072,100,4,8,12,14679,46506,61185,16,0.179389,0.280289,1435,0,0
8508780,"Romoos, Post",,0.000011,92,0,1,1,0,2881,2881,17,0.110976,0.141781,0,0,0
8508781,"Rosenlaui, Hotel",,0.000011,114,0,1,1,0,1194,1194,39,0.051214,0.07633,0,0,0
8508786,"Schnottwil, Post",,0.00002,87,1,3,4,957,6031,6988,25,0.085441,0.100925,679,0,0
8571486,"Gossliwil, Dorf",,0.000048,87,1,1,2,2394,2394,4788,25,0.093951,0.115324,1314,0,0
8571497,"Gächliwil, alte Post",,0.000055,87,1,1,2,2485,2485,4970,25,0.093951,0.115324,1533,0,0
8508787,"Schwarzenberg LU, Rössli",,0.000044,90,2,1,3,4388,4387,8775,16,0.10977,0.124919,148.291667,0,0
8508788,Schwarzwaldalp,,0.00002,114,1,1,2,1194,1194,2388,38,0.053701,0.082706,193,0,0
8508790,"Stalden (Sarnen), Post",,0.000011,62,0,1,1,0,523,523,26,0.055314,0.070786,0,0,0
8508792,Susten Passhöhe,,0.000034,114,2,1,3,254,254,508,22,0.106791,0.134503,585,0,0
8508877,"Steingletscher, Susten",,0.00005,114,2,2,4,389,389,778,21,0.118945,0.158124,1567,0,0
8508793,"Trub, Dorf",,0.00002,123,1,2,3,6177,9604,15781,21,0.123377,0.171481,114,0,0
8508984,"Emmenmatt, Obermatt",,0.000019,123,1,2,3,6942,9750,16692,20,0.139163,0.203823,111,0,0
8508881,"Etzelkofen, Dorf",,0.000048,87,1,2,3,1550,1550,3100,23,0.116582,0.135937,1862.042857,0,0
8508797,"Beckenried, Post",,0.000028,62,1,1,2,1675,1675,3350,50,0.060971,0.089247,1256,0,0
8508798,"Buochs, Post",,0.000035,62,1,1,2,1675,1675,3350,49,0.064826,0.100218,1881,0,0
8508850,"Iffwil, Strücki",,0.000043,87,3,1,4,1550,1550,3100,24,0.10455,0.118247,1209.042857,0,0
8508851,"Wilen (Sarnen), Dorf",,0.00002,62,1,1,2,523,3422,3945,25,0.058246,0.074913,190,0,0
8508852,"Oberwilen, Forst",,0.000028,62,1,1,2,3422,3421,6843,24,0.061523,0.080248,378,0,0
8508853,"Wilen (Sarnen), Wilerbad",,0.000035,62,1,2,3,3421,3422,6843,23,0.06521,0.088591,564,0,0
8508856,"Stalden (Sarnen), Geren",,0.000026,62,1,1,2,523,523,1046,23,0.064885,0.083717,0,0,0
8508855,"Kerns, Chäli-Burgflue",,0.000038,62,2,1,3,3663,3663,7326,20,0.078747,0.102127,386,0,0
8571579,"Hasliberg Goldern, Gletscherb.",,0.000058,114,1,1,2,4046,4046,8092,21,0.111732,0.171924,128,0,0
8572366,"Wolfwil, Fulenbacherstrasse",,0.00007,94,1,1,2,7360,7360,14720,12,0.171315,0.207162,849,0,0
8577985,"Olten, Haslistrasse",,0.00004,94,1,3,4,31334,31086,62420,20,0.119923,0.174135,372,0,0
8572882,"Sörenberg, Schulhaus",,0.000064,92,1,2,3,3891,2425,6316,4,0.454545,0.616667,75,0,0
8572885,"Sörenberg, Habchegg",,0.000059,92,1,2,3,2538,2538,5076,1,1,1,20,0,0
8508875,"Marbachegg, Talstation",,0.000064,61,3,2,5,6201,6201,12402,8,0.228571,0.342336,159.833333,0,0
8508873,"Büetigen, Dorf",,0.000017,87,1,1,2,953,957,1910,26,0.086134,0.094252,888,0,0
8508874,"Diessbach bei Büren, Dorf",,0.000025,87,1,1,2,957,957,1914,25,0.094109,0.103942,1541,0,0
8508876,"Schangnau, Waldegg",,0.000049,61,2,2,4,2912,2910,5822,8,0.238095,0.355635,77.666667,0,0
8572863,"Marbach LU, Schufelbühl",,0.000061,61,1,2,3,6201,6201,12402,6,0.282609,0.396154,98.166667,0,0
8571577,"Hasliberg Hohfluh, Bodemli",,0.000037,114,2,1,3,3934,3971,7905,23,0.093939,0.136473,15,0,0
8508882,"Pfaffnau, Post",,0.00004,94,1,2,3,11988,12170,24158,12,0.158654,0.233131,627,0,0
8508883,"Roggliswil, Post",,0.000028,94,1,2,3,10514,18564,29078,11,0.179775,0.254428,290,0,0
8572710,"Pfaffnau, Dorfplatz",,0.000039,94,2,2,4,10774,12170,22944,11,0.177143,0.251883,331,0,0
8508969,"Burgdorf, Spital",,0.000024,45,1,3,4,20533,19836,40369,16,0.168588,0.24275,724,0,0
8509022,"Weier i.E., Lehn",,0.000028,45,2,1,3,6331,6331,12662,16,0.138626,0.171726,117,0,0
8508885,"Huttwil, Stadt",,0.000021,45,1,1,2,7767,7767,15534,12,0.193798,0.289509,90,0,0
8571569,"Huttwil, Alterssiedlung",,0.000027,45,1,1,2,8825,8825,17650,12,0.193798,0.289509,576,0,0
8571570,"Wyssachen, Mösli",,0.000043,45,1,1,2,5861,5861,11722,12,0.193798,0.289509,50,0,0
8508890,"Koppigen, Post",,0.000011,45,0,2,2,0,15082,15082,20,0.116685,0.146545,0,0,0
8508893,"Eggiwil, Dorf",,0.000011,123,0,1,1,0,12098,12098,18,0.12809,0.16552,0,0,0
8508970,"Kerns, Boll",,0.00007,62,3,3,6,14068,14068,28136,18,0.092416,0.138137,1197,0,0
8508898,"Doppleschwand, Post",,0.00002,92,1,1,2,2881,2895,5776,16,0.123457,0.162671,90,0,0
8573008,Sempach Station,,0.000063,59,2,5,7,26484,26493,52977,44,0.067826,0.107481,41163.214286,0,0
8573033,"Emmenbrücke, Lohrensäge",,0.000023,90,1,1,2,8227,8227,16454,22,0.095489,0.131702,1951,0,0
8572840,"Wolhusen, Bahnhof",,0.000031,92,2,3,5,5370,7137,12507,15,0.13928,0.200107,1608,0,0
8577293,"Ruswil, Neumüli",,0.000064,92,1,1,2,3850,3850,7700,13,0.126801,0.170358,2180,0,0
8508951,"Hettiswil b. H., Kreuz",,0.00002,44,1,2,3,4694,4696,9390,35,0.055878,0.063179,625,0,0
8508952,Obermoos,,0.000019,44,1,1,2,3959,3959,7918,35,0.055794,0.061678,0,0,0
8508953,"Heimiswil, Oberdorf",,0.000011,45,0,1,1,0,7004,7004,19,0.11939,0.150561,0,0,0
8508954,"Burgdorf, Fischermätteli",,0.00002,45,1,2,3,7004,13861,20865,18,0.134557,0.179563,132,0,0
8508955,"Kaltacker, Ramisberg",,0.000019,45,1,2,3,6991,7693,14684,18,0.134084,0.179025,6,0,0
8508967,"Kirchberg BE, Post",,0.000081,45,3,4,7,28088,28088,56176,18,0.147493,0.201674,2000,0,0
8576470,Rumistal,,0.000042,45,1,2,3,7004,6810,13814,9,0.239344,0.290058,270,0,0
8508960,"Bützberg, Tell",,0.00002,88,2,1,3,14730,21249,35979,13,0.146552,0.182971,66.166667,0,0
8508998,"Bleienbach, Post",,0.000022,88,2,1,3,7971,7971,15942,12,0.160757,0.211381,52,0,0
8571644,"Riedtwil, Bahnhof",,0.000036,45,2,2,4,9002,9006,18008,12,0.167598,0.206374,450,0,0
8571772,"Wynigen, Bahnhof",,0.000043,45,2,4,6,15245,15245,30490,12,0.185323,0.236053,1108,0,0
8576916,"Herzogenbuchsee, Jurablick",,0.000077,88,1,1,2,12417,12417,24834,12,0.160757,0.211381,1569,0,0
8508962,St. Niklaus b. Koppigen,,0.000022,45,2,1,3,16390,7286,23676,23,0.086461,0.100891,8,0,0
8508963,Oeschberg,,0.00003,45,1,1,2,7286,8595,15881,22,0.094183,0.110418,210,0,0
8508964,"Niederösch, Oberdorf",,0.000036,45,1,1,2,8595,8595,17190,21,0.103466,0.122594,410,0,0
8508965,Oberösch,,0.000042,45,1,1,2,8595,8595,17190,20,0.114838,0.138868,608,0,0
8571528,"Hasle-Rüegsau, Bahnhof",,0.000049,45,3,3,6,15364,15364,30728,15,0.15956,0.21173,1026.5,0,0
8576486,"Burgdorf, Tiergarten",,0.000058,45,4,3,7,32520,48459,80979,9,0.231884,0.289623,1403.5,0,0
8508968,"Burgdorf, Hallenbad",,0.000045,45,3,3,6,18024,46065,64089,17,0.149425,0.206614,920,0,0
8576440,"Burgdorf, Bernstrasse",,0.000021,45,1,2,3,11379,11379,22758,10,0.225989,0.278373,10,0,0
8576439,"Burgdorf Steinhof, Bahnhof",,0.000024,45,1,2,3,10242,25023,35265,11,0.221918,0.276059,155,0,0
8576463,"Burgdorf, Hasleweg",,0.000039,45,1,2,3,25532,25532,51064,9,0.232836,0.282804,205,0,0
8576464,"Burgdorf, Ziegelei",,0.000027,45,1,2,3,14111,14111,28222,9,0.235474,0.284854,124,0,0
8576474,Lueg,,0.000047,45,1,1,2,1825,942,2767,9,0.234114,0.276298,140,0,0
8576489,"Kirchberg BE, Elsässer",,0.000059,45,1,2,3,28088,28088,56176,9,0.2375,0.286722,314,0,0
8576490,"Kirchberg BE, Bütikofenstrasse",,0.000036,45,1,2,3,15269,15269,30538,9,0.238854,0.288323,150,0,0
8576492,"Niederösch, Unterdorf",,0.000033,45,1,2,3,8594,8595,17189,9,0.239344,0.290058,166,0,0
8576493,"Koppigen, Sternen",,0.000025,45,1,2,3,7672,7647,15319,9,0.238411,0.289457,66,0,0
8576495,"Alchenstorf, Oberalchenstorf",,0.000029,45,1,1,2,6487,6487,12974,9,0.234114,0.276298,70,0,0
8576497,"Hasle b.B., Dorf",,0.000041,45,2,1,3,8341,8341,16682,9,0.234114,0.276298,175,0,0
8508971,"Melchtal, Sportcamp",,0.000031,62,1,1,2,1552,1552,3104,19,0.084967,0.121327,0,0,0
8508974,"Kägiswil, Dorf",,0.00002,62,1,2,3,4189,4189,8378,19,0.085047,0.12499,182,0,0
8508975,"Stans, Spital",,0.000042,62,2,2,4,6641,6641,13282,17,0.099129,0.139734,1047.5,0,0
8508980,"Oberwilen, Mos",,0.000062,62,1,1,2,3422,3422,6844,19,0.084967,0.121327,1638,0,0
8557024,"Sachseln, Seehof/Brüggi",,0.000034,62,1,2,3,2632,2634,5266,19,0.085394,0.126128,305,0,0
8557092,"Sachseln, Brünigstrasse",,0.000025,62,1,1,2,1300,1300,2600,19,0.084967,0.121327,0,0,0
8508972,"Wilen (Sarnen), Kurhaus am See",,0.000047,62,2,2,4,3422,3422,6844,22,0.069017,0.092317,930,0,0
8508976,"Sarnen, Sonnenberg",,0.000031,62,1,1,2,523,523,1046,22,0.068671,0.087411,0,0,0
8572897,"Sarnen, Bahnhof",,0.000172,62,7,7,14,24233,24275,48508,18,0.092347,0.154232,3738,0,0
8572909,"Alpnach Dorf, Bahnhof",,0.000043,62,1,2,3,3908,3908,7816,3,0.555556,0.666667,154,0,0
8581326,"Alpnach Dorf, untere Feldstr.",,0.000041,62,1,1,2,2455,3593,6048,2,0.666667,0.75,4,0,0
8572900,"Kerns, Kernwald",,0.000041,62,2,1,3,5632,5923,11555,17,0.089398,0.104041,2754,0,0
8508977,"Wilen (Sarnen), Badmatt",,0.000057,62,2,1,3,3422,3420,6842,21,0.073336,0.095001,1288,0,0
8508978,"Oberwilen, Seefuren",,0.00006,62,1,1,2,3420,3422,6842,20,0.07871,0.105367,1464,0,0
8508981,Kaltenbrunnen bei Meiringen,,0.000028,114,1,1,2,1194,1194,2388,37,0.056454,0.091744,384,0,0
8570264,"Geissholz, Dorf",,0.000011,114,0,1,1,0,1970,1970,37,0.056454,0.091744,0,0,0
8570532,"Innertkirchen,Abzw. Riglisflie",,0.000057,114,3,2,5,2737,2723,5460,32,0.06904,0.108779,1040,0,0
8570534,"Unterbach BE, Unterheidstrasse",,0.00002,114,1,1,2,2851,2851,5702,37,0.056454,0.091744,192,0,0
8508982,Tiefenbach (Furka),,0.000024,108,1,1,2,257,257,514,16,0.146341,0.19645,312,0,0
8508988,"Schüpbach, Dorf",,0.000031,123,2,3,5,12006,12747,24753,16,0.164444,0.23608,309,0,0
8508989,"Oberfrittenbach, Aeugstmatt",,0.000011,123,0,1,1,0,2818,2818,20,0.137206,0.193982,0,0,0
8508990,"Bärau, Dorf",,0.000028,123,2,2,4,10844,17199,28043,20,0.138272,0.201179,114,0,0
8508991,"Gohl, Mettlen",,0.000023,123,1,1,2,2738,3194,5932,20,0.137206,0.193982,0,0,0
8508985,"Aeschau, Dorf",,0.00002,123,1,3,4,12098,12098,24196,17,0.145619,0.203746,113,0,0
8508986,"Röthenbach i.E., Dorf",,0.000017,123,1,1,2,11928,11928,23856,17,0.142313,0.185724,0,0,0
8576703,"Schüpbach, Hölzli",,0.000034,123,1,2,3,950,950,1900,22,0.087002,0.129478,243,0,0
8576710,"Eggiwil, Holzmatt",,0.000071,123,1,3,4,12098,12098,24196,18,0.119874,0.177026,732,0,0
8588363,"Schüpbach, Buebenei",,0.000075,123,3,2,5,12006,12033,24039,13,0.159574,0.312009,685,0,0
8509006,Chur Wiesental,,0.000012,28,1,3,4,14886,14905,29791,27,0.066759,0.089512,27,0,0
8509055,Igis,,0.000043,28,1,2,3,14905,14905,29810,24,0.079843,0.101026,2790,0,0
8509167,Trin,,0.000022,28,2,2,4,9273,9782,19055,17,0.115318,0.167687,21,0,0
8509050,Chur West,,0.00002,28,2,6,8,22083,22058,44141,27,0.06726,0.097154,4751,0,0
8509168,Versam-Safien,,0.000045,28,3,2,5,9513,9276,18789,16,0.127907,0.188612,1705,0,0
8509170,Castrisch,,0.000044,28,1,1,2,9543,9543,19086,16,0.124756,0.171069,64,0,0
8509056,Landquart Ried,,0.000029,28,1,3,4,14655,14655,29310,23,0.086182,0.111428,2352,0,0
8509060,Schiers,,0.000047,28,4,4,8,26746,26717,53463,21,0.100073,0.130049,269555,0,0
8509171,Ilanz,,0.000076,28,4,3,7,10812,11218,22030,15,0.140312,0.211691,5016,0,0
8509180,Felsberg,,0.00008,28,6,1,7,17790,17714,35504,15,0.129187,0.171179,120,0,0
8509181,Domat/Ems,,0.00013,28,5,2,7,28470,27106,55576,14,0.145604,0.203086,940.166667,0,0
8509182,Ems Werk,,0.000087,28,2,1,3,19203,18492,37695,14,0.143251,0.18776,0,0,0
8509183,Reichenau-Tamins,,0.000167,28,4,2,6,33326,23453,56779,13,0.163987,0.22762,1054,0,0
8509186,Rothenbrunnen,,0.000089,28,2,2,4,10602,10614,21216,13,0.15894,0.219277,1800,0,0
8509188,Cazis,,0.000052,28,1,1,2,10336,10317,20653,13,0.153846,0.196202,46,0,0
8509189,Thusis,,0.00017,28,4,1,5,17763,8575,26338,12,0.177866,0.231967,778,0,0
8509068,Klosters Platz,,0.000068,28,4,8,12,20674,26508,47182,10,0.278689,0.411539,12855,0,0
8509195,Filisur,,0.000175,28,4,2,6,16894,9328,26222,10,0.219251,0.300968,1689.833333,0,0
8509198,Preda,,0.00005,28,1,3,4,8250,7818,16068,10,0.21547,0.307855,884.666667,0,0
8509199,Spinas,,0.000025,28,1,2,3,3762,3752,7514,10,0.211111,0.289641,0,0,0
8509250,Bever,,0.000082,28,4,1,5,6652,16889,23541,10,0.206704,0.270442,5.666667,0,0
8509003,Maienfeld,,0.000012,28,1,1,2,19343,19343,38686,6,0.3125,0.395,0,0,0
8509057,Malans GR,,0.000021,28,2,3,5,16555,16343,32898,22,0.091576,0.115525,3480,0,0
8509058,Seewis-Pardisla,,0.000017,28,1,2,3,10196,10046,20242,22,0.091374,0.113373,0,0,0
8509059,Grüsch,,0.000025,28,3,1,4,16087,16085,32172,22,0.091172,0.11121,0,0,0
8509062,Jenaz,,0.000039,28,2,2,4,10055,10239,20294,20,0.1064,0.131818,268204,0,0
8509063,Fideris,,0.000027,28,1,2,3,3453,3515,6968,19,0.116825,0.145235,267696,0,0
8509064,Küblis,,0.000051,28,4,3,7,20614,20574,41188,11,0.227848,0.308283,2206,0,0
8509065,Saas im Prättigau,,0.000025,28,1,2,3,10255,10295,20550,11,0.224576,0.295231,0,0,0
8509067,Klosters Dorf,,0.000036,28,2,1,3,10044,10044,20088,11,0.221277,0.281678,0,0,0
8509051,Haldenstein,,0.000017,28,2,1,3,7942,7863,15805,27,0.064808,0.07563,0,0,0
8509015,"Choëx, ch. de la Montagne",,0.000053,103,1,1,2,545,545,1090,12,0.153226,0.192682,266,0,0
8509016,"Le Quartier, Calame",,0.000022,134,1,1,2,7369,7369,14738,28,0.057947,0.077869,437.5,0,0
8571822,"La Chaux-du-Milieu, Les Jolys",,0.000063,134,1,2,3,2567,2567,5134,28,0.059202,0.087129,3940,0,0
8509018,"Les Giettes, Prafenne",,0.000056,103,1,1,2,545,545,1090,11,0.17619,0.219596,296,0,0
8509019,"Les Giettes, La Tardive",,0.000058,103,1,1,2,545,545,1090,10,0.208092,0.26272,324,0,0
8570637,"Bex, gare",,0.000068,103,4,3,7,3109,3217,6326,10,0.217021,0.295495,675,0,0
8570638,"Bex, temple",,0.00003,103,1,4,5,1578,1578,3156,10,0.257862,0.36415,232,0,0
8575520,"Collombey, Les Neyres Chapelle",,0.000011,103,0,2,2,0,1087,1087,10,0.213018,0.284943,0,0,0
8509053,Untervaz-Trimmis,,0.000032,28,3,1,4,14903,14905,29808,26,0.069138,0.081796,3500,0,0
8509054,Zizers,,0.000038,28,1,1,2,14905,14905,29810,25,0.0741,0.089704,3146,0,0
8509061,Furna,,0.000021,28,1,1,2,3452,3453,6905,21,0.096388,0.114362,0,0,0
8509069,Cavadürli,,0.000018,28,1,1,2,8234,8246,16480,18,0.090416,0.131783,0,0,0
8509070,Davos Laret,,0.000034,28,2,2,4,11149,11150,22299,17,0.097416,0.148516,846,0,0
8509071,Davos Wolfgang,,0.000025,28,1,1,2,10646,10646,21292,17,0.095618,0.130777,0,0,0
8509197,Bergün/Bravuogn,,0.000137,28,2,3,5,8764,9083,17847,11,0.224719,0.328633,4220.333333,0,0
8509251,Samedan,,0.000193,28,6,5,11,22910,24424,47334,9,0.253521,0.377767,24605,0,0
8509253,St. Moritz,,0.000062,28,2,3,5,14508,12342,26850,8,0.257812,0.352092,4958.333333,0,0
8509254,Punt Muragl,,0.000044,28,1,1,2,9134,9270,18404,11,0.202454,0.277131,0,0,0
8509263,Susch,,0.000103,28,2,2,4,13070,9133,22203,4,0.4,0.555556,576,0,0
8509268,Scuol-Tarasp,,0.000071,28,2,1,3,14964,14868,29832,1,1,1,4,0,0
8509072,Davos Dorf,,0.000054,28,3,1,4,14225,14330,28555,16,0.103524,0.138604,4154,0,0
8509073,Davos Platz,,0.000057,28,1,1,2,14330,7786,22116,15,0.113022,0.148249,3400,0,0
8509075,Davos Frauenkirch,,0.000059,28,1,1,2,7786,7786,15572,14,0.124654,0.160513,2644,0,0
8509076,Davos Glaris,,0.000061,28,1,1,2,7786,7546,15332,13,0.139241,0.176767,1886,0,0
8509077,Davos Monstein,,0.000063,28,1,1,2,7546,7546,15092,12,0.158088,0.199622,1126,0,0
8509078,Davos Wiesen,,0.000064,28,1,1,2,7546,7546,15092,11,0.183406,0.234932,364,0,0
8509192,Tiefencastel,,0.000182,28,3,3,6,9469,9478,18947,11,0.211538,0.301977,8660.166667,0,0
8509193,Surava,,0.000062,28,1,2,3,1807,1807,3614,11,0.186957,0.252724,859,0,0
8509194,Alvaneu,,0.000037,28,1,1,2,1556,1541,3097,11,0.183406,0.234932,0,0,0
8509150,Chur Altstadt,,0.000017,28,1,1,2,8462,8491,16953,6,0.285714,0.408333,4668,0,0
8509152,Lüen-Castiel,,0.000025,28,1,1,2,8491,8541,17032,5,0.333333,0.456667,3895,0,0
8509153,St. Peter-Molinis,,0.000032,28,1,1,2,8541,8541,17082,4,0.4,0.520833,3120,0,0
8509154,Peist,,0.000038,28,1,1,2,8541,8535,17076,3,0.5,0.611111,2343,0,0
8509155,Langwies GR,,0.000043,28,1,1,2,8535,8535,17070,2,0.666667,0.75,1564,0,0
8509156,Litzirüti,,0.000048,28,1,1,2,8535,8371,16906,1,1,1,783,0,0
8509169,Valendas-Sagogn,,0.000039,28,2,1,3,9559,9543,19102,17,0.112457,0.14977,788,0,0
8509173,Rueun,,0.000032,28,1,2,3,8992,8992,17984,17,0.108202,0.150834,3981,0,0
8509174,Waltensburg/Vuorz,,0.000025,28,1,1,2,8745,8745,17490,17,0.106643,0.136913,0,0,0
8509175,Tavanasa-Breil/Brigels,,0.000046,28,2,1,3,8992,9022,18014,16,0.117417,0.149325,2519,0,0
8509176,Trun,,0.00005,28,1,1,2,9022,8992,18014,15,0.13082,0.166014,1785,0,0
8509177,Rabius-Surrein,,0.000053,28,1,1,2,8992,9022,18014,14,0.147959,0.190053,1049,0,0
8509184,Bonaduz,,0.000088,28,2,2,4,16967,17666,34633,14,0.142045,0.199604,3408,0,0
8509185,Rhäzüns,,0.000048,28,1,1,2,17430,10366,27796,14,0.139601,0.18327,0,0,0
8509187,Rodels-Realta,,0.000049,28,1,1,2,10364,10336,20700,14,0.135838,0.173338,855,0,0
8509225,Lago di Luzzone,,0.000011,108,0,1,1,0,142,142,3,0.5,0.566667,0,0,0
8578850,"Campo (Blenio), Ponte Semina",,0.000031,108,1,1,2,4888,4888,9776,3,0.5,0.566667,347,0,0
8509240,"Ruggell, REC",,0.000011,73,0,1,1,0,388,388,47,0.063539,0.087215,0,0,0
8509241,"Sennwald, Hof",,0.00002,73,1,1,2,388,388,776,46,0.067792,0.098925,1165,0,0
8509611,"Balzers, Rietstrasse",,0.000011,73,0,3,3,0,6399,6399,46,0.067815,0.100284,0,0,0
8509244,"Les Geneveys-sur-Coffrane,gare",,0.000024,48,1,1,2,29,29,58,20,0.09865,0.1248,17598.315476,0,0
8571796,La Sauge,,0.000042,48,2,2,4,5441,5441,10882,16,0.130187,0.158611,1705.738095,0,0
8509252,Celerina,,0.000044,28,1,2,3,13802,13904,27706,9,0.2125,0.284057,0,0,0
8509255,Pontresina,,0.000144,28,5,5,10,17566,17222,34788,10,0.246154,0.390265,16952,0,0
8509257,Madulain,,0.0001,28,1,1,2,11466,11466,22932,8,0.211538,0.306926,36.666667,0,0
8509351,Punt Muragl Staz,,0.000041,28,1,1,2,6796,6545,13341,10,0.161905,0.230415,17,0,0
8509354,Bernina Suot,,0.000071,28,1,1,2,6779,6779,13558,7,0.245614,0.309014,56,0,0
8509356,Ospizio Bernina,,0.000096,28,2,1,3,7138,7153,14291,6,0.302326,0.367949,65,0,0
8509256,La Punt Chamues-ch,,0.000104,28,4,1,5,11610,11466,23076,9,0.1875,0.279729,912.666667,0,0
8509258,Zuoz,,0.000113,28,2,1,3,14234,14219,28453,7,0.243902,0.348571,4108,0,0
8509259,S-chanf,,0.000107,28,1,2,3,14219,13134,27353,6,0.290323,0.438889,3228,0,0
8509260,Cinuos-chel-Brail,,0.000056,28,1,2,3,10128,9953,20081,5,0.347826,0.497917,727.5,0,0
8509262,Zernez,,0.00008,28,2,1,3,12928,13039,25967,5,0.318182,0.42619,727.5,0,0
8509264,Lavin,,0.000062,28,2,1,3,14767,15130,29897,4,0.384615,0.483333,3576,0,0
8509265,Guarda,,0.000064,28,1,1,2,15130,15115,30245,3,0.5,0.583333,2686,0,0
8509266,Ardez,,0.000065,28,1,2,3,15115,14921,30036,2,0.75,0.833333,1794,0,0
8509267,Ftan Baraigla,,0.000038,28,1,1,2,9058,9101,18159,2,0.666667,0.75,0,0,0
8509298,"Landquart, Neuhof",,0.000011,109,0,2,2,0,8038,8038,23,0.104921,0.136017,0,0,0
8574489,"Seewis-Pardisla, Bahnhof",,0.000023,28,1,1,2,62,62,124,18,0.123263,0.153085,267241,0,0
8574563,"Maienfeld, Bahnhof",,0.000045,109,1,4,5,5152,7036,12188,18,0.12468,0.162678,3329,0,0
8574565,"Malans, Postplatz",,0.00004,109,3,2,5,6554,6546,13100,18,0.123858,0.156607,698.333333,0,0
8574568,"Landquart, Marktplatz",,0.000035,109,1,1,2,6476,9960,16436,18,0.123263,0.153085,337,0,0
8509307,"Avers, Juf",,0.000011,109,0,1,1,0,2118,2118,31,0.085201,0.102895,0,0,0
8509315,"Thônex, Belle-Terre-Ecole",,0.000041,120,4,1,5,72590,72595,145185,22,0.126956,0.140151,1751.961497,0,0
8509319,"Thônex, Belle-Terre-Pl. Turin",,0.000046,120,1,1,2,72595,72600,145195,21,0.145191,0.164378,2386.961497,0,0
8509350,Celerina Staz,,0.000035,28,1,1,2,6780,6796,13576,11,0.146341,0.215831,887,0,0
8509352,Surovas,,0.00007,28,2,1,3,6781,6779,13560,9,0.181818,0.248834,1806,0,0
8509353,Morteratsch,,0.000071,28,1,1,2,6779,6779,13558,8,0.208333,0.273413,932,0,0
8509357,Alp Grüm,,0.000117,28,2,2,4,8295,8271,16566,5,0.4,0.495833,10716,0,0
8509358,Cavaglia,,0.000061,28,1,2,3,6765,6690,13455,5,0.392857,0.495455,894,0,0
8509359,Cadera,,0.000037,28,1,1,2,4172,4276,8448,5,0.37037,0.445,0,0,0
8509361,Poschiavo,,0.000117,28,3,4,7,8300,9259,17559,4,0.529412,0.675926,8064,0,0
8509363,Li Curt,,0.000036,28,1,1,2,5239,5150,10389,4,0.4,0.46875,0,0,0
8509364,Le Prese,,0.000066,28,2,3,5,7782,7797,15579,3,0.583333,0.690476,3146.5,0,0
8509366,Brusio,,0.000036,28,1,2,3,6474,6474,12948,3,0.5,0.633333,904,0,0
8509367,Campascio,,0.000026,28,1,1,2,3976,3991,7967,3,0.444444,0.541667,0,0,0
8509369,Tirano,,0.000108,28,2,2,4,7884,6271,14155,1,1,1,12,0,0
8509368,Campocologno,,0.000092,28,4,1,5,7943,7823,15766,2,0.6,0.666667,457.5,0,0
8509365,Miralago,,0.00003,28,1,1,2,6414,6474,12888,4,0.375,0.472222,1798,0,0
8509373,Bernina Lagalb,,0.000082,28,2,1,3,6751,6765,13516,1,1,1,897,0,0
8509384,"Bellelay, Le Domaine",,0.000034,1,3,2,5,2861,2834,5695,17,0.115274,0.191173,194.333333,0,0
8571939,"Tavannes, rte de Reconvilier",,0.000032,1,1,1,2,923,923,1846,17,0.110465,0.161761,38,0,0
8509400,Oberriet SG,,0.000135,28,2,1,3,10038,10039,20077,8,0.22,0.306169,1320,0,0
8509401,Rüthi SG,,0.000126,28,1,1,2,10039,10039,20078,7,0.25641,0.342619,679,0,0
8509411,Sargans,,0.00016,28,5,3,8,69663,18260,87923,4,0.5,0.680556,4728,0,0
8509412,Mels,,0.000056,28,1,1,2,9269,9809,19078,5,0.333333,0.456667,0,0,0
8509413,Flums,,0.000104,28,2,1,3,11045,10745,21790,4,0.4,0.520833,4,0,0
8509414,Walenstadt,,0.000145,28,2,1,3,18500,9809,28309,3,0.5,0.611111,2373,0,0
8509416,Unterterzen,,0.000134,28,1,1,2,9809,9224,19033,2,0.666667,0.75,1584,0,0
8509417,Murg,,0.000125,28,1,1,2,9224,9524,18748,1,1,1,793,0,0
8509453,"Balen-Gassaura, Dorf",,0.000011,109,0,1,1,0,6169,6169,23,0.080979,0.100064,0,0,0
8509454,"Balen-Gassaura, Alpenrösli",,0.00002,109,1,4,5,6169,5916,12085,22,0.087872,0.116447,363,0,0
8509459,Mapragg,,0.000031,109,1,1,2,4228,3990,8218,23,0.080036,0.095854,720,0,0
8509460,Wartenstein,,0.000042,109,2,2,4,4272,4540,8812,22,0.086757,0.108482,1083,0,0
8509684,"Malans, Älplibahn",,0.000011,109,0,4,4,0,6546,6546,19,0.114587,0.148279,0,0,0
8509697,"Bad Ragaz, Post",,0.000035,109,3,3,6,4900,4900,9800,21,0.094584,0.122088,2051.333333,0,0
8509858,"Pfäfers, Postplatz",,0.00006,109,4,4,8,7057,6997,14054,34,0.063731,0.09706,774,0,0
8509955,"Vättis, Dorf",,0.000024,109,1,1,2,4183,4228,8411,34,0.0625,0.082376,0,0,0
8509455,Ragol,,0.000011,109,0,2,2,0,4392,4392,36,0.05724,0.080724,0,0,0
8574572,"Pfäfers, Grosswies",,0.000048,109,1,1,2,2498,2196,4694,1,1,1,13,0,0
8509456,"St. Margrethenberg, Dorf",,0.000016,109,1,2,3,1602,2517,4119,35,0.060396,0.08692,234,0,0
8509468,"Vadura, Dorf",,0.000017,109,1,1,2,2196,2196,4392,35,0.060154,0.083018,0,0,0
8509457,"Vasön, Dorf",,0.000015,109,1,1,2,3945,3990,7935,25,0.069335,0.080369,4,0,0
8509458,"Vasön, Tschenner",,0.000024,109,1,1,2,3990,4228,8218,24,0.074295,0.087129,363,0,0
8509461,"Fli, Seestern",,0.000011,106,0,1,1,0,16736,16736,11,0.170732,0.245637,0,0,0
8509462,"Amden, Forten",,0.00002,106,1,2,3,16736,16736,33472,10,0.196078,0.300675,20,0,0
8509463,"Amden, Hinterstein",,0.000019,106,1,2,3,6742,7242,13984,10,0.206522,0.314307,6.333333,0,0
8509464,"Amden, Lehni",,0.000028,106,2,2,4,16736,16736,33472,9,0.219512,0.326213,32.833333,0,0
8509465,"Amden, Soldanella",,0.000031,106,2,2,4,7242,7242,14484,9,0.232877,0.344841,28.5,0,0
8509990,"Amden, Dorf",,0.000036,106,2,2,4,16736,16736,33472,8,0.25,0.359449,42.666667,0,0
8509466,"Flumserberg Portels, Dorf",,0.000011,124,0,1,1,0,502,502,11,0.158416,0.207466,0,0,0
8509467,"Flumserberg Saxli, Saxli",,0.00002,124,1,1,2,502,502,1004,10,0.182353,0.240169,31,0,0
8509469,"Voralp, Kurhaus",,0.000011,73,0,1,1,0,1352,1352,42,0.076083,0.106596,0,0,0
8509780,"Gams, Zentrum",,0.000049,73,4,4,8,19458,20460,39918,42,0.076585,0.109826,12924.2,0,0
8509499,"Gersau, Rotacher",,0.000061,91,1,2,3,3185,3185,6370,2,0.75,0.833333,132,0,0
8509538,"Gersau, Altes Rathaus",,0.000037,91,1,1,2,2779,2765,5544,2,0.666667,0.75,0,0,0
8509512,"Le Brouillet, Bémont",,0.000014,49,1,1,2,1594,1594,3188,21,0.079327,0.134188,4632,0,0
8509552,"Granges VS, Centre PCI",,0.000029,39,2,1,3,7184,7184,14368,21,0.094441,0.116548,189,0,0
8509599,"Marly, Ancienne Papeterie",,0.000025,126,2,1,3,37343,37343,74686,27,0.081788,0.097178,480,0,0
8509609,"Gaflei, Klinik",,0.000011,73,0,1,1,0,860,860,25,0.075499,0.090337,0,0,0
8509616,"Malbun, Jugendheim",,0.000011,73,0,1,1,0,1691,1691,25,0.075499,0.090337,0,0,0
8509612,"Bendern, Post",,0.000031,73,2,8,10,3522,20101,23623,45,0.072659,0.117461,3240.314527,0,0
8509613,"Eschen, Post",,0.000017,73,2,6,8,10864,12393,23257,45,0.070373,0.108282,242.285827,0,0
8509620,"Vaduz, Mühleholz",,0.000025,73,2,5,7,8765,8765,17530,45,0.070255,0.106522,1627.791118,0,0
8509619,"Mauren FL, Post",,0.000022,73,2,3,5,6736,8970,15706,46,0.06782,0.101035,124.858528,0,0
8509621,"Nendeln, Sebastianstrasse",,0.000024,73,3,4,7,5254,7308,12562,21,0.105281,0.144928,1093.149818,0,0
8509622,"Planken, Saroja",,0.000011,73,0,1,1,0,767,767,21,0.102751,0.134905,0,0,0
8509625,"Schaanwald, Zuschg",,0.00002,73,2,3,5,8967,8967,17934,21,0.105129,0.143543,202.73273,0,0
8509985,"Vaduz, Post",,0.000098,73,8,5,13,13714,16918,30632,21,0.105622,0.149794,6827.795378,0,0
8509626,"Schellenberg, Post",,0.000025,73,4,5,9,6905,6941,13846,26,0.069798,0.110227,154.733944,0,0
8574316,"Salez-Sennwald, Bahnhof",,0.000058,73,1,3,4,20558,20572,41130,27,0.074639,0.116158,57564.683333,0,0
8574343,"Schaan, Hilti",,0.000055,73,3,2,5,7308,6875,14183,27,0.065755,0.0982,1524.221429,0,0
8574344,"Nendeln, Tonwarenfabrik",,0.000034,73,1,2,3,6301,6734,13035,27,0.065663,0.097988,49.666667,0,0
8574345,"Eschen, Presta",,0.000078,73,7,6,13,8198,7644,15842,26,0.069845,0.114114,59315.637628,0,0
8574346,"Eschen, Eintracht",,0.000032,73,3,4,7,7929,8268,16197,25,0.07338,0.110126,27072.837973,0,0
8509614,"Vaduz, Ebenholz/Universität",,0.00002,73,3,2,5,7434,8765,16199,46,0.065786,0.093303,19.899647,0,0
8509617,"Triesenberg, Abzw. Masescha",,0.000029,73,2,2,4,2551,2551,5102,24,0.081533,0.100971,1238,0,0
8509618,"Masescha, Kapelle",,0.000023,73,1,1,2,860,860,1720,23,0.088235,0.111044,1845,0,0
8509630,"Triesen, Vaschiel",,0.000049,73,2,2,4,2733,4949,7682,22,0.096637,0.128337,1338,0,0
8509629,"Triesen, Post",,0.000029,73,4,2,6,6755,7797,14552,22,0.096643,0.127873,110,0,0
8509698,"Triesenberg, Post",,0.000052,73,2,3,5,4767,5021,9788,22,0.096617,0.129496,2576,0,0
8509699,"Malbun, Jöraboda",,0.000026,73,1,1,2,1691,1691,3382,22,0.095674,0.124412,0,0,0
8574365,"Bendern, Pinocchio",,0.00002,73,1,3,4,4256,4376,8632,26,0.068252,0.1024,162.233333,0,0
8574367,"Gamprin, Gemeindehaus",,0.000039,73,5,2,7,4985,5069,10054,27,0.064023,0.090289,1426.066667,0,0
8509624,"Dardin, vitg",,0.00002,110,1,1,2,653,4271,4924,10,0.154519,0.1955,53,0,0
8509991,"Schaan, Bahnhof",,0.000051,73,5,7,12,12483,17670,30153,20,0.114329,0.166094,9389.232073,0,0
8574349,"Mauren FL, Freiendorf",,0.000033,73,1,2,3,6736,5935,12671,25,0.071873,0.099256,4886,0,0
8574350,"Mauren FL, Freihof",,0.000029,73,2,2,4,5748,6549,12297,28,0.060401,0.079948,3617.083333,0,0
8509627,"Steg FL, Tunnel",,0.000023,73,1,1,2,1691,1691,3382,24,0.081216,0.098259,6,0,0
8509628,"Steg FL, Hotel",,0.000031,73,1,1,2,1691,1691,3382,23,0.088252,0.110609,619,0,0
8509632,"Danis, vitg",,0.000028,110,1,2,3,4271,4415,8686,9,0.17931,0.239881,104,0,0
8509637,"Marly, piscine",,0.000032,126,1,1,2,37343,37340,74683,26,0.088777,0.106985,659,0,0
8509638,"Marly, Innovation Center",,0.000038,126,1,1,2,37340,36218,73558,25,0.0971,0.119615,836,0,0
8509641,"Les Collons, Les Plans Verneys",,0.000033,39,2,1,3,1383,1383,2766,21,0.124601,0.156866,786,0,0
8579516,"Vex, bif. des Agettes",,0.000044,39,1,1,2,4551,4551,9102,19,0.125,0.164282,1292,0,0
8509650,"Flums, Post",,0.000028,124,1,2,3,502,7617,8119,9,0.215827,0.302474,60,0,0
8574775,"Flumserberg Saxli, Saxlirank",,0.000057,124,1,1,2,502,502,1004,9,0.213592,0.288925,154,0,0
8509658,"Oberschan, Malans",,0.000011,73,0,1,1,0,5818,5818,25,0.06336,0.073515,0,0,0
8509659,"Azmoos, Post",,0.00002,73,1,1,2,5818,5818,11636,24,0.067485,0.079266,418,0,0
8509660,"Rongellen, Abzw.",,0.000015,109,1,1,2,909,1154,2063,30,0.092833,0.115251,8,0,0
8509664,"Andeer, Rofflaschlucht",,0.000033,109,1,2,3,3725,3727,7452,29,0.102212,0.135531,878,0,0
8509667,"Hinterrhein, Tunnel Nordportal",,0.000027,109,1,2,3,2587,2816,5403,29,0.10175,0.134361,72.333333,0,0
8509752,"Andeer, posta",,0.000043,109,3,6,9,7043,7491,14534,28,0.112727,0.161532,2026.95,0,0
8509888,"Sufers, Underem Dorf",,0.000028,109,1,4,5,4006,4233,8239,27,0.122542,0.174923,269.1,0,0
8509966,"Wergenstein, Dorf",,0.000029,109,2,1,3,2551,2551,5102,28,0.109367,0.142985,71.166667,0,0
8509663,"Andeer, Bärenburg",,0.000026,109,2,1,3,3648,3725,7373,30,0.092925,0.116112,451,0,0
8509665,"Medels im Rheinwald, Abzw.",,0.000031,109,2,1,3,4111,4111,8222,30,0.092386,0.115273,54,0,0
8509668,"S. Bernardino, Muc. Casa Cant.",,0.000022,109,1,2,3,530,530,1060,29,0.09667,0.121324,10.5,0,0
8509671,"Davos Glaris, Mühle",,0.000011,131,0,2,2,0,17903,17903,17,0.115527,0.145483,0,0,0
8574503,"Lenzerheide/Lai, Clavadoiras",,0.000065,131,2,4,6,7628,7626,15254,17,0.116109,0.151694,2423,0,0
8509673,"Mels, Lütsch",,0.000011,73,0,1,1,0,6893,6893,22,0.07877,0.091785,0,0,0
8509674,"Schwendi i. W., Dorf",,0.00002,73,1,1,2,6893,6893,13786,21,0.085297,0.101506,409,0,0
8509675,"Mels, Hienzi",,0.000028,73,1,1,2,6893,6893,13786,20,0.093023,0.114721,816,0,0
8509678,"Mels, Pizolpark",,0.000035,73,1,3,4,6893,34289,41182,19,0.102313,0.135272,1221,0,0
8574401,"Balzers, Roxy",,0.000074,73,3,5,8,11077,11077,22154,19,0.105421,0.144939,62155.935949,0,0
8574409,"Trübbach, Dornau",,0.000076,73,4,4,8,23097,22942,46039,19,0.10521,0.144585,101018.24948,0,0
8574413,"Sargans, Post",,0.000082,73,4,1,5,35584,39913,75497,19,0.100959,0.127848,1739.730769,0,0
8509772,"Fläsch, Dorf",,0.000023,109,2,2,4,5557,5718,11275,20,0.100555,0.120392,2326.666667,0,0
8574564,"Maienfeld, Herrenfeld",,0.00002,109,1,1,2,6321,6329,12650,19,0.110497,0.132349,0,0,0
8509688,Wägerhus/Abzw. Jöriseen,,0.000011,131,0,2,2,0,1083,1083,18,0.103423,0.126762,0,0,0
8509715,"Susch, Röven",,0.000031,131,1,1,2,619,619,1238,18,0.102555,0.121591,562,0,0
8509689,"Susch, Chantsura",,0.000016,131,1,1,2,619,619,1238,20,0.085628,0.098623,2,0,0
8574039,"Buchs SG, Werdenberg",,0.000071,73,2,2,4,15269,15269,30538,20,0.106322,0.139999,127998,0,0
8574040,"Buchs SG, Rathaus",,0.000044,73,2,2,4,13717,13946,27663,20,0.112326,0.14898,44820.142857,0,0
8574147,"Altstätten SG, Rathaus",,0.000114,73,5,7,12,55310,57630,112940,29,0.069118,0.114806,82918.613095,0,0
8574178,"Oberriet SG, Bahnhof",,0.000052,73,2,4,6,15173,15242,30415,29,0.067068,0.101012,13269,0,0
8574311,"Frümsen, Rathaus",,0.000066,73,1,2,3,8030,8030,16060,29,0.065712,0.091594,4340,0,0
8574313,"Sennwald, Dornen",,0.000044,73,1,1,2,4002,4002,8004,29,0.065491,0.089133,535,0,0
8509692,"Susch, Abzw. Schwarzhorn",,0.000024,131,1,1,2,619,619,1238,19,0.093316,0.108612,283,0,0
8509696,"Degen, vitg",,0.000011,78,0,1,1,0,1206,1206,4,0.384615,0.45,0,0,0
8509767,"Cumbel, vitg",,0.000011,78,0,1,1,0,79,79,4,0.384615,0.45,0,0,0
8571030,"Haldenstein, Dorf",,0.000028,109,1,1,2,15103,15103,30206,25,0.09084,0.11035,1198,0,0
8571107,"Haldenstein, Hanfländer",,0.000036,109,2,2,4,15664,16134,31798,24,0.09975,0.127344,1796,0,0
8509725,"Laax GR, Caltgera",,0.000011,110,0,3,3,0,5157,5157,9,0.227106,0.283052,0,0,0
8509727,"Laax GR, Rancho",,0.000014,110,1,3,4,660,768,1428,9,0.225926,0.282227,1,0,0
8509728,"Sagogn, Vitg dado",,0.000018,110,2,1,3,4175,4500,8675,9,0.221402,0.259153,0,0,0
8509774,"Flims Waldhaus, Caumasee",,0.00003,110,1,1,2,768,768,1536,10,0.204301,0.248886,57,0,0
8509879,"Siat, vitg",,0.000011,110,0,2,2,0,2104,2104,8,0.233333,0.281851,0,0,0
8510418,"Schluein, industria",,0.000016,110,1,1,2,1456,1456,2912,8,0.229665,0.26689,23,0,0
8557046,"Ilanz, Grüneck",,0.000024,110,2,2,4,4467,4467,8934,7,0.243655,0.291518,165.5,0,0
8570469,"Cazis, Ausserdorf",,0.000012,109,1,5,6,86,5509,5595,25,0.121533,0.161791,202,0,0
8572659,"Chur, Sommerau",,0.000026,109,4,2,6,41970,42933,84903,24,0.114656,0.154223,603.55,0,0
8572662,"Felsberg, Emserstrasse",,0.000023,109,2,7,9,30871,30189,61060,24,0.115144,0.161973,542.1,0,0
8572664,"Felsberg, Post",,0.000025,109,2,4,6,14453,14537,28990,24,0.113908,0.154212,548.033333,0,0
8509733,"Pragg, Bahnhof Furna",,0.000036,112,2,3,5,5652,5651,11303,17,0.111925,0.140057,825,0,0
8509779,"Furna, Post",,0.000021,112,1,3,4,1803,1804,3607,18,0.103357,0.129807,40,0,0
8510103,"Furna, Riedji",,0.000017,112,1,2,3,480,480,960,18,0.102747,0.125102,5,0,0
8510104,"Furna, Boden",,0.000018,112,1,2,3,400,429,829,18,0.102719,0.125247,8,0,0
8509734,"Ascharina, alte Post",,0.000047,112,3,1,4,777,4252,5029,20,0.086052,0.103358,531,0,0
8509746,"St. Antönien, Rüti",,0.00005,112,3,2,5,2539,2627,5166,19,0.093432,0.115942,1357,0,0
8509737,Fuorns (Medel),,0.000018,108,1,1,2,715,2004,2719,7,0.255319,0.346032,108,0,0
8509738,"Platta, Pardé",,0.000026,108,1,2,3,2004,2004,4008,6,0.314286,0.45,110,0,0
8509740,"Platta, Lai da Sontga Maria",,0.00003,108,1,1,2,715,715,1430,6,0.28125,0.383333,9,0,0
8509739,"Platta, Sogn Gagl",,0.000022,108,1,1,2,715,715,1430,7,0.238095,0.331905,11,0,0
8509741,"Lantsch/Lenz, St. Cassian",,0.000016,131,1,1,2,3623,3623,7246,21,0.080708,0.093586,15,0,0
8509742,"Mumpé Medel, spartavias",,0.000047,108,2,2,4,2004,2004,4008,5,0.347826,0.497917,104,0,0
8509744,"Platta, Sogn Gions",,0.000037,108,1,1,2,715,715,1430,5,0.3,0.413889,6,0,0
8509743,Pardatsch,,0.000031,108,1,1,2,715,715,1430,6,0.259259,0.37381,14,0,0
8509745,"Sarn, Dorf",,0.00002,109,1,1,2,26,3288,3314,33,0.065663,0.078526,240,0,0
8509853,"Pany, Dorf",,0.000057,112,3,2,5,4315,4352,8667,18,0.102356,0.127697,2068,0,0
8509749,"Tschlin, cumün",,0.000011,74,0,1,1,0,3115,3115,3,0.5,0.611111,0,0,0
8509751,"Alvaneu Dorf, Dorfplatz",,0.000024,131,1,1,2,3623,3623,7246,20,0.087511,0.102808,323,0,0
8576261,"Ferrera, Plan Davains",,0.000068,109,1,1,2,2118,1875,3993,4,0.428571,0.513889,90,0,0
8579861,"Zillis, Schulhaus",,0.00007,109,3,1,4,2772,2559,5331,4,0.428571,0.513889,44.7,0,0
8580179,"Thusis, Bahnhof",,0.000266,109,10,9,19,16224,15794,32018,25,0.129785,0.195995,71714.783333,0,0
8509753,"Andiast, vitg",,0.000023,110,1,1,2,144,2884,3028,8,0.187266,0.225071,94.5,0,0
8509754,"Ferrera, Ausserferrera",,0.000017,109,1,1,2,2076,2118,4194,19,0.09375,0.174542,270,0,0
8509757,"Breil/Brigels, casa communala",,0.000023,110,1,3,4,4271,4270,8541,10,0.19337,0.28763,55.5,0,0
8509984,"Waltensburg/Vuorz, Cadruvi",,0.00003,110,1,3,4,2884,2884,5768,7,0.225806,0.288338,140.5,0,0
8575055,"Rueun, S. Clau",,0.000035,110,2,1,3,2685,2685,5370,10,0.176768,0.222188,189,0,0
8575059,"Waltensburg/Vuorz, Ucliva",,0.000045,110,1,5,6,2884,2881,5765,6,0.3875,0.484946,183.5,0,0
8575056,"Waltensburg/Vuorz, Crap Bargis",,0.000055,110,3,2,5,2952,2952,5904,9,0.208589,0.272981,274.5,0,0
8575061,"Tavanasa-Breil/Brigels,staziun",,0.000025,110,2,2,4,4129,4130,8259,3,0.5,0.595238,24,0,0
8509759,Buffalora P10,,0.000011,30,0,1,1,0,3285,3285,13,0.140065,0.191084,0,0,0
8509860,"Promontogno, Posta",,0.000022,77,2,1,3,3679,3679,7358,4,0.4,0.520833,2,0,0
8574946,"St. Moritz, Schulhausplatz",,0.000066,30,6,5,11,25517,26202,51719,8,0.307692,0.403892,559.63254,0,0
8574947,"St. Moritz Bad, Reithalle",,0.000016,30,1,2,3,206,206,412,9,0.242857,0.306365,0,0,0
8574948,"St. Moritz Bad, Sonne",,0.000057,30,5,3,8,19905,20630,40535,9,0.243902,0.317492,52.333333,0,0
8509766,"Avers, Cresta",,0.000025,109,1,1,2,2118,2118,4236,18,0.098522,0.181005,272,0,0
8509769,"Curaglia, posta",,0.000063,108,2,1,3,2004,2004,4008,4,0.357143,0.466667,80,0,0
8509771,"Filzbach, Sportzentrum",,0.000027,106,2,1,3,5951,6101,12052,13,0.163043,0.211661,171,0,0
8509785,"Jenins, Rathaus",,0.000023,109,2,1,3,6407,6399,12806,20,0.100292,0.117827,2.333333,0,0
8509773,"Flims Dorf, Post",,0.000022,110,2,1,3,768,768,1536,11,0.172107,0.205023,4,0,0
8509775,"Flüela, Ospiz",,0.000042,131,2,1,3,1083,1083,2166,17,0.113867,0.13944,1120,0,0
8509777,"Fuldera, cumün",,0.00002,30,1,2,3,3285,3371,6656,12,0.159091,0.230398,42,0,0
8509778,Il Fuorn P6,,0.000019,30,1,1,2,3135,3285,6420,12,0.155894,0.211628,0,0,0
8510114,"Gams, Madrusa",,0.000021,73,1,2,3,7293,7527,14820,36,0.045569,0.056178,0,0,0
8570047,"Frümsen, Luftseilbahn Staubern",,0.00003,73,2,1,3,4002,4002,8004,36,0.045489,0.054443,0,0,0
8574028,"Wildhaus, Schönau",,0.000065,73,1,2,3,11883,10019,21902,29,0.057022,0.077082,126187,0,0
8574035,"Gams, Simmirank",,0.000061,73,1,1,2,12157,12157,24314,23,0.08095,0.094452,127068,0,0
8574037,"Grabs, Feld",,0.000067,73,1,1,2,12635,12635,25270,21,0.09625,0.119246,127690,0,0
8509796,"Mathon, Dorf",,0.000029,109,3,2,5,2542,2551,5093,28,0.104816,0.132771,26.666667,0,0
8509784,"Ferrera, Innerferrera",,0.000032,109,1,1,2,2118,2118,4236,17,0.103825,0.188047,272,0,0
8509983,"Laax GR, Bergbahnen",,0.000018,110,1,1,2,332,438,770,13,0.124711,0.153345,0,0,0
8509987,"Falera, center",,0.000018,110,1,2,3,2138,3510,5648,9,0.217391,0.267984,4.5,0,0
8574683,"Laax GR, Marcau",,0.000049,110,1,2,3,768,768,1536,9,0.224215,0.282317,200,0,0
8509789,"Lantsch/Lenz, Vischnanca",,0.000031,131,1,1,2,3623,3623,7246,19,0.095593,0.114944,629,0,0
8509790,"Lenzerheide/Lai, Post",,0.000038,131,1,2,3,3623,7628,11251,18,0.105353,0.132651,933,0,0
8557055,"Lantsch/Lenz, Biathlon Arena",,0.000045,131,1,1,2,3623,3623,7246,18,0.104339,0.127527,909,0,0
8509792,"Maienfeld, Post",,0.00004,109,2,1,3,6552,5152,11704,19,0.111147,0.135133,2998,0,0
8509798,"Müstair, posta",,0.000036,30,2,2,4,3521,3406,6927,11,0.18018,0.263107,120,0,0
8509861,Punt la Drossa P4,,0.000033,30,1,2,3,3135,3787,6922,10,0.197917,0.286383,38,0,0
8509850,"Oberschan, Museum",,0.000028,73,1,2,3,5818,5818,11636,23,0.072195,0.087008,834,0,0
8574333,"Trübbach, Haus Dr. Sulser",,0.000023,73,1,1,2,3962,3962,7924,23,0.072035,0.084813,0,0,0
8557123,"Netstal, Kublihoschet",,0.000011,106,0,1,1,0,4626,4626,14,0.159091,0.219063,0,0,0
8573886,"Näfels, Freulerpalast",,0.000042,106,1,1,2,9846,9846,19692,14,0.159091,0.219063,112,0,0
8573891,"Filzbach, Römerturm",,0.000043,106,1,1,2,6114,6114,12228,15,0.116766,0.17263,167,0,0
8509865,"St. Antönien, Platz",,0.000056,112,2,3,5,4445,4394,8839,18,0.102286,0.130706,855,0,0
8509855,Süsom Givè (Passhöhe),,0.000026,30,1,1,2,2971,3135,6106,11,0.168831,0.22605,4,0,0
8509856,"Passugg, Hotelfachschule",,0.000011,109,0,2,2,0,3532,3532,24,0.111927,0.147516,0,0,0
8509897,"Tschiertschen, Dorf",,0.000024,109,1,1,2,2769,2930,5699,24,0.11149,0.144681,425,0,0
8572689,"Felsberg, Rjterstutz/Aeuli",,0.000044,109,1,3,4,13969,13983,27952,24,0.113193,0.152146,1436.066667,0,0
8572786,"Felsberg, Brugg",,0.000042,109,1,2,3,6990,6957,13947,24,0.112553,0.149245,1275,0,0
8573042,"Rhäzüns, Luftseilbahn LRF",,0.000051,109,2,4,6,11565,11566,23131,24,0.127392,0.176002,1914.883333,0,0
8574559,"Pfäfers, Eselrank",,0.000024,109,1,1,2,321,321,642,3,0.5,0.611111,0,0,0
8509859,"Praden, alte Post",,0.000016,109,1,1,2,2769,2769,5538,25,0.100519,0.124005,1,0,0
8509869,"Sta. Maria Val Müstair, cumün",,0.00004,30,2,3,5,3720,3615,7335,10,0.20442,0.311883,168,0,0
8509951,"Valchava, cumün",,0.000041,30,2,3,5,3490,3490,6980,10,0.204678,0.3178,91,0,0
8509863,"Ramosch, Plaz",,0.000011,29,0,2,2,0,3174,3174,1,1,1,0,0,0
8509973,"Vnà, Jalmèr",,0.000016,29,1,1,2,2931,2931,5862,1,1,1,0,0,0
8575085,"Ascharina, Alpbachbrücke",,0.000046,112,2,2,4,4307,4131,8438,3,0.571429,0.708333,2877,0,0
8575086,"St. Antönien, Waldheim",,0.000031,112,1,2,3,3516,3314,6830,2,0.75,0.833333,1,0,0
8509898,"Tschierv, plaz",,0.000022,30,1,1,2,3371,3371,6742,11,0.173913,0.241151,0,0,0
8509875,"Schmitten (Albula), Dorf",,0.000027,131,1,1,2,3623,3623,7246,21,0.080126,0.092327,15,0,0
8509883,"Soglio, Villaggio",,0.000036,77,2,1,3,3757,3757,7514,3,0.5,0.611111,9,0,0
8509884,"Splügen, Dorf",,0.000041,109,3,2,5,5748,5504,11252,27,0.116299,0.153084,1271.833333,0,0
8574882,"Passugg, Brugg",,0.000053,109,1,2,3,3693,3693,7386,27,0.115083,0.150438,1884,0,0
8574887,"Praden, Kurhaus",,0.000052,109,1,1,2,2769,2769,5538,27,0.114127,0.146522,1564,0,0
8509887,"Strada i. E., Cuncalada",,0.00002,74,1,1,2,3115,3174,6289,2,0.666667,0.75,2,0,0
8575178,"Bellinzona, Piazza Mesolcina",,0.000038,108,2,3,5,39083,41794,80877,58,0.05655,0.127573,10457.125,0,0
8575224,"Castione, Stazione",,0.000072,108,3,2,5,42652,35401,78053,27,0.119297,0.163977,2007,0,0
8575240,"Mesocco, Posta",,0.000129,109,7,2,9,3622,3622,7244,27,0.119729,0.165276,12400.7,0,0
8575242,"Mesocco, Ponte Anzone",,0.000067,109,1,2,3,2027,1957,3984,26,0.127765,0.176984,387,0,0
8578953,"Gerra Piano, Paese",,0.000062,101,1,3,4,18503,18503,37006,27,0.122173,0.168973,38439.488095,0,0
8579671,"Bellinzona, Via dei Gaggini",,0.00007,108,2,2,4,33548,33548,67096,27,0.119495,0.164414,3204,0,0
8579672,"Bellinzona, Viale Franscini",,0.000041,108,1,1,2,9080,9080,18160,27,0.119224,0.162255,0,0,0
8580886,"Andeer, Heilbad",,0.000159,109,4,3,7,7400,5476,12876,3,0.625,0.766667,938.616667,0,0
8509899,"Davos Dorf, Tschuggen",,0.000047,131,1,1,2,1083,1083,2166,16,0.12804,0.166562,1395,0,0
8574738,"Grüsch, Oberdorf",,0.00003,131,2,1,3,62,62,124,16,0.12804,0.166562,102251.897436,0,0
8574830,"Davos Platz, Spital",,0.000029,131,2,2,4,17820,22924,40744,16,0.127882,0.16935,2805,0,0
8574836,"Davos Glaris, Ortolfi",,0.000057,131,1,2,3,17903,17903,35806,16,0.129496,0.17118,1539,0,0
8574642,"Tschierv, spv. Minschuns",,0.00005,30,1,1,2,3285,3135,6420,8,0.186441,0.282792,63,0,0
8574647,"Fuldera, Furom",,0.000067,30,1,1,2,3371,3371,6742,5,0.275862,0.366667,69,0,0
8509958,"Vella, posta",,0.000029,78,2,4,6,1285,2647,3932,3,0.5625,0.685185,18,0,0
8574984,"Vattiz, vitg",,0.000025,78,1,1,2,70,77,147,3,0.5,0.611111,3,0,0
8575025,"Morissen, center communal",,0.000033,78,1,1,2,3028,3028,6056,1,1,1,2,0,0
8509959,"Vilters, Zentrum",,0.000021,73,1,1,2,12642,15366,28008,21,0.084365,0.098962,8,0,0
8509963,"Mels, Waldheim",,0.000021,73,1,1,2,6893,6893,13786,23,0.075345,0.086324,12,0,0
8509964,"Wangs, Post",,0.000029,73,1,1,2,15366,15366,30732,20,0.091909,0.110822,405,0,0
8509979,"Mels, Aussicht",,0.000041,73,1,2,3,6893,6893,13786,20,0.096557,0.119178,1203,0,0
8574412,"Sargans, Rose",,0.000031,73,1,2,3,17349,17349,34698,18,0.102218,0.124659,2754,0,0
8509965,"Weisstannen, Oberdorf",,0.000029,73,1,1,2,6893,6893,13786,22,0.081283,0.094325,411,0,0
8509967,"Davos Wiesen, Kirche",,0.000034,131,1,1,2,3623,3623,7246,20,0.08682,0.101042,315,0,0
8574535,"Zillis, Rania",,0.00002,109,1,1,2,1154,1154,2308,27,0.109136,0.136261,0,0,0
8574576,"Sils im Domleschg, Dorf",,0.000065,109,3,2,5,1190,1331,2521,27,0.109922,0.139607,9998.666667,0,0
8574900,"Thusis, Caznerwiesen",,0.00006,109,4,3,7,5302,5124,10426,26,0.116238,0.152674,2820.1,0,0
8509970,"Brienz/Brinzauls, Dorf",,0.00004,131,1,1,2,3623,3623,7246,19,0.094763,0.112235,613,0,0
8509974,"Valens, Post",,0.000058,109,4,3,7,6214,6169,12383,33,0.066374,0.093868,1266.666667,0,0
8557109,"Pfäfers, Taminabrücke",,0.000027,109,1,3,4,4480,4287,8767,33,0.066121,0.092071,14,0,0
8574556,"Valens, Duonig",,0.000019,109,1,2,3,3990,4228,8218,33,0.065847,0.088036,0,0,0
8574557,"Bad Ragaz, Dorfbad",,0.000043,109,3,1,4,3161,3101,6262,33,0.065574,0.083965,0,0,0
8509975,"Luzein, alte Post",,0.000051,112,2,2,4,3649,3649,7298,17,0.111584,0.135819,3328,0,0
8510106,"St. Antönien, Sagaris",,0.000033,112,1,1,2,1692,1692,3384,17,0.111206,0.132508,0,0,0
8509978,"Mels, Oberdorf",,0.000035,73,1,1,2,6893,6893,13786,21,0.088255,0.10464,808,0,0
8574614,"Sargans, Bahnhof",,0.000119,73,4,8,12,56810,56694,113504,18,0.112016,0.157864,144433.230927,0,0
8509981,"Platta, vitg",,0.000064,108,1,1,2,2004,2004,4008,3,0.444444,0.541667,68,0,0
8575018,"Ilanz, S. Clau sura",,0.000036,110,2,2,4,4466,4467,8933,6,0.283465,0.333333,269.75,0,0
8574342,"Schaan, Im Besch",,0.000025,73,1,1,2,3929,3929,7858,28,0.061819,0.085404,482,0,0
8574390,"Vaduz, Quäderle",,0.000044,73,1,3,4,6718,6718,13436,25,0.070358,0.102337,1374,0,0
8574387,"Schaan, Zentrum/LKW",,0.000133,73,10,5,15,9459,9532,18991,24,0.075303,0.10852,67269.472107,0,0
8574392,"Vaduz, Spital",,0.00004,73,2,1,3,12618,12618,25236,24,0.072712,0.088783,1170,0,0
8574394,"Vaduz, Rütti",,0.000047,73,1,1,2,10230,9561,19791,22,0.084173,0.108711,55585,0,0
8509986,"Versam, Post",,0.000011,110,0,1,1,0,2491,2491,6,0.252427,0.291026,0,0,0
8509992,"Arvenbüel, Arven",,0.000039,106,2,2,4,7242,7242,14484,8,0.267857,0.388968,48.666667,0,0
8574353,"Schaanwald, Zollamt",,0.000049,73,1,3,4,8967,8967,17934,25,0.072057,0.104016,2409.25,0,0
8574362,"Planken, Vorderplanken",,0.000032,73,1,2,3,767,767,1534,25,0.070316,0.094483,936,0,0
8574363,"Planken, Schulhaus",,0.000025,73,1,1,2,401,401,802,25,0.070173,0.092493,0,0,0
8574364,"Schaan, Hilcona",,0.000031,73,2,3,5,7181,7061,14242,25,0.072248,0.106376,655.232088,0,0
8574372,"Ruggell, Sennerei",,0.000037,73,1,3,4,5664,5664,11328,25,0.071884,0.104197,1896,0,0
8574383,"Eschen, Brühl",,0.000062,73,4,4,8,6549,6609,13158,25,0.07171,0.110443,25290.497619,0,0
8574386,"Schaan, Zollstrasse",,0.000033,73,1,2,3,5755,5755,11510,25,0.070259,0.095094,13636.247161,0,0
8578497,"Amden, Brugg",,0.000052,106,1,1,2,16736,16736,33472,5,0.35,0.445238,43,0,0
8509994,"Zernez, staziun",,0.000048,30,3,4,7,3762,6370,10132,14,0.164251,0.292926,234,0,0
8574650,"Müstair, Somvih",,0.000078,30,1,2,3,3490,3489,6979,2,0.625,0.7,75,0,0
8574853,"Tschierv, Orasom",,0.000048,30,1,1,2,3371,3371,6742,2,0.6,0.666667,3,0,0
8581567,"Müstair, Clostra Son Jon",,0.000095,30,3,2,5,3615,3548,7163,1,1,1,33,0,0
8570559,"Cully, gare",,0.000031,13,3,3,6,3928,5228,9156,11,0.201493,0.320945,2434.833333,0,0
8582779,"Grandvaux, Le Signal",,0.000072,13,1,2,3,1555,1555,3110,4,0.454545,0.616667,1925.2,0,0
8510015,"Gersau, Huob",,0.000068,91,2,1,3,3171,3185,6356,1,1,1,46,0,0
8570706,"Jonen, Weingasse",,0.000045,85,5,2,7,12145,12148,24293,18,0.139428,0.161653,1729.516613,0.00337,0.000102
8510057,"Arbon, Frohmattstrasse",,0.00002,71,1,2,3,16803,31807,48610,18,0.139211,0.160236,360,0,0
8574246,"Arbon, Alpenblick",,0.000049,71,2,1,3,9024,9024,18048,18,0.139104,0.158384,2612.703571,0,0
8574248,"Arbon, Romanshornerstrasse",,0.000037,71,1,1,2,9024,9024,18048,18,0.138599,0.156941,293,0,0
8510069,"Villars-sur-Ollon, rte du Roc",,0.000045,103,1,1,2,1734,1734,3468,13,0.121588,0.15444,245,0,0
8510070,"Villars-sur-Ollon, télécabine",,0.000049,103,1,1,2,1734,1734,3468,12,0.135593,0.169786,288,0,0
8510071,"Villars-sur-Ollon, Hôtels",,0.000053,103,1,1,2,1734,1667,3401,11,0.153595,0.191237,329,0,0
8510074,"Baden, Kurtheater",,0.000014,22,1,1,2,4602,5746,10348,22,0.117096,0.136368,2,0.000006,0
8572556,"Niederrohrdorf, Hiltiberg",,0.000082,22,1,3,4,17959,17959,35918,22,0.107755,0.13432,61874.924277,0,0.001132
8572560,"Berikon-Widen, Bahnhof",,0.000038,85,4,5,9,21579,21137,42716,19,0.130608,0.158626,76800.601385,0.019045,0.001288
8572578,"Untersiggenthal, Gemeindehaus",,0.000072,22,4,5,9,27297,27294,54591,21,0.13312,0.169059,9509.84074,0.000005,0.002311
8572585,"Ehrendingen, Tiefenwaag",,0.000032,22,2,4,6,6685,6529,13214,21,0.131298,0.163757,4718.394135,0.000037,0.001578
8578679,"Würenlos, Bettlen",,0.00002,22,1,2,3,12123,12123,24246,21,0.130478,0.159531,9.75,0.000055,0.001348
8578682,"Baden, Rütihof Haberacher",,0.000038,22,2,1,3,13097,13097,26194,21,0.130251,0.157527,129.475061,0.000083,0.001079
8578683,"Baden, Segelhof",,0.000033,22,1,2,3,13839,13839,27678,21,0.130673,0.160279,210.558272,0.000018,0.001665
8578903,"Lengnau AG, Gewerbegebiet",,0.00007,22,2,2,4,12406,12164,24570,21,0.130381,0.159277,2623,0,0.001503
8510076,"Biederthal, Village (F)",,0.000037,54,2,1,3,2141,2097,4238,15,0.14094,0.229893,34.4,0,0
8510210,"Rodersdorf, Rösmatt",,0.000042,54,1,2,3,2097,2097,4194,14,0.15625,0.278411,47.4,0,0
8572159,Challhöchi,,0.000047,54,1,2,3,663,663,1326,14,0.153285,0.258805,323,0,0
8572160,"Metzerlen, Felsplatte",,0.000031,54,1,1,2,332,332,664,14,0.147059,0.221745,0,0,0
8510080,"Châtillon FR, école",,0.000031,13,2,1,3,1442,616,2058,19,0.124191,0.165487,288,0,0
8510082,"St. Silvester, Chrache",,0.000016,126,1,1,2,1053,1134,2187,6,0.268293,0.354545,5,0,0
8510105,"Altdorf UR, Bahnhof West",,0.000024,90,2,2,4,6703,6703,13406,46,0.073362,0.138827,4674.630952,0,0
8573027,Reussbühl Frohburg,,0.000014,90,1,3,4,104980,104959,209939,46,0.073109,0.137622,850.916667,0,0
8510107,"Schuders, Abzw. Valmära",,0.000011,112,0,1,1,0,979,979,27,0.097087,0.120517,0,0,0
8574754,"Schiers, Schulhaus Farb",,0.000049,112,1,2,3,1963,1980,3943,25,0.119641,0.161899,1440,0,0
8510154,"Bellevue, Limites",,0.00003,120,1,1,2,10420,10419,20839,21,0.098655,0.106157,14,0,0
8577643,"Missy, nord",,0.000043,126,2,2,4,4423,4423,8846,13,0.167553,0.198009,375.119048,0,0
8577825,"Avenches, Faubourg",,0.000064,126,2,1,3,10715,10715,21430,13,0.165554,0.189106,3986.333333,0,0
8577831,"Delley, En Roche",,0.000041,126,1,1,2,7159,7159,14318,13,0.128342,0.145611,1212,0,0
8577832,"Delley, école",,0.000053,126,2,1,3,7335,7335,14670,12,0.146012,0.166394,784,0,0
8510189,"Marly, Bel-Air",,0.000043,126,1,1,2,36218,36218,72436,24,0.107182,0.136676,1011,0,0
8510193,"Düdingen, Tennishalle",,0.000049,126,2,1,3,25794,25794,51588,17,0.122222,0.204576,206,0,0
8510194,"Düdingen, Haslerastrasse",,0.000053,126,1,1,2,25794,25794,51588,16,0.132911,0.228051,207,0,0
8510195,"Düdingen, Brugerastrasse",,0.000056,126,1,2,3,25794,25794,51588,15,0.145985,0.277221,206,0,0
8510196,"Düdingen, Kirchstrasse",,0.000035,126,1,1,2,25544,25544,51088,15,0.139706,0.23918,0,0,0
8580591,"Gurmels, Sonneck",,0.000033,126,1,1,2,4227,4227,8454,15,0.139706,0.23918,3649,0,0
8581035,"Bösingen, Cholholz",,0.000035,126,1,1,2,5234,5112,10346,15,0.139706,0.23918,69,0,0
8510197,"Düdingen, Käsereistrasse",,0.000025,126,1,1,2,7491,7491,14982,1,1,1,17,0,0
8510201,"Ascharina, Bellawiese",,0.000027,112,1,2,3,735,791,1526,3,0.545455,0.638889,39,0,0
8575083,"Luzein, Langraus",,0.000041,112,1,1,2,3649,3649,7298,3,0.428571,0.5,8574,0,0
8575084,"Pany, Schulhaus",,0.000057,112,2,2,4,4223,4233,8456,2,0.625,0.7,7152,0,0
8572166,"Mariastein, Abzw. Rotberg",,0.00006,54,1,2,3,6364,1318,7682,2,0.75,0.833333,82.6,0,0
8510220,"Genthod, Chênes",,0.000036,120,1,1,2,10419,10419,20838,20,0.109291,0.118723,681,0,0
8510223,"Bettlach, Gesundheitszentrum",,0.000011,127,0,3,3,0,12196,12196,17,0.117874,0.159352,0,0,0
8577914,"Grenchen Süd, Bahnhof",,0.000015,127,1,15,16,83347,101133,184480,15,0.145755,0.224694,296.188384,0,0
8577942,"Grenchen, Bürgerhaus",,0.000035,127,3,5,8,57047,57056,114103,15,0.139172,0.18945,2032.589394,0,0
8577945,"Grenchen, Sonnmatt",,0.000021,127,2,4,6,18616,18625,37241,13,0.153952,0.193742,2682.166667,0,0
8510277,"Brüttisellen, Gemeindehaus",,0.000011,107,0,1,1,0,14799,14799,16,0.089728,0.097779,0,0,0
8588830,"Morlon, En Perrey",,0.000052,13,1,2,3,27601,27601,55202,12,0.168421,0.230937,230,0,0
8577737,"Gruyères, gare",,0.000067,13,3,4,7,7070,5136,12206,11,0.198312,0.29518,1157.145455,0,0
8587253,"Enney, zone d'activités",,0.000039,13,2,1,3,4251,4251,8502,11,0.190678,0.252743,89,0,0
8588862,"Epagny, aérodrome",,0.000034,13,1,2,3,8463,8463,16926,10,0.215311,0.29224,540,0,0
8593277,"Bulle, Espace Gruyère",,0.000057,13,1,2,3,26700,26700,53400,11,0.194093,0.268988,139.5,0,0
8593278,"Bulle, Le Terraillet",,0.000044,13,1,2,3,28515,28515,57030,11,0.198238,0.278458,1737,0,0
8593279,"Bulle, Pierre-Alex",,0.000057,13,2,1,3,26701,27601,54302,11,0.190678,0.252743,169.5,0,0
8510282,"Amriswil, Strassenverkehrsamt",,0.000011,121,0,1,1,0,6630,6630,18,0.10502,0.131866,0,0,0
8581757,"Münsterlingen, Nonnenpförtli",,0.00014,65,3,3,6,15549,14233,29782,18,0.108,0.146823,37233,0,0
8510288,"Troistorrents, Vers-Encier",,0.000056,103,1,1,2,620,620,1240,11,0.14966,0.216362,176,0,0
8510290,"Troistorrents, Lévaux",,0.000058,103,1,1,2,620,620,1240,10,0.168,0.243103,189,0,0
8510291,"Troistorrents, Les Neys",,0.00006,103,1,2,3,620,620,1240,9,0.192308,0.296984,200,0,0
8510292,"Troistorrents, village",,0.000037,103,1,2,3,389,778,1167,8,0.211111,0.312093,143,0,0
8579049,"Monthey, hôpital",,0.000062,103,1,2,3,620,620,1240,8,0.2,0.319983,68,0,0
8579053,"Troistorrents, gare",,0.000037,103,1,1,2,389,389,778,8,0.188406,0.267674,0,0,0
8510293,"Troistorrents, Collaire",,0.000052,103,2,1,3,620,620,1240,12,0.132353,0.209774,60,0,0
8510294,"Morgins, école",,0.000055,103,1,1,2,620,620,1240,11,0.144068,0.223065,65,0,0
8510295,"Morgins, le Corbeau",,0.000058,103,1,1,2,620,620,1240,10,0.158416,0.240352,68,0,0
8510305,"Balzers, Ramschwagweg",,0.000011,73,0,1,1,0,2787,2787,30,0.049845,0.056721,0,0,0
8510306,"Balzers, Pralawisch",,0.00002,73,1,1,2,2787,2787,5574,29,0.05234,0.059477,434,0,0
8510307,"Balzers, Oksaboda",,0.000028,73,1,1,2,2787,2787,5574,28,0.055103,0.062591,866,0,0
8510308,"Balzers, Palduinstrasse",,0.000035,73,1,1,2,2787,2787,5574,27,0.058182,0.066144,1296,0,0
8510309,"Balzers, St. Katrinabrunna",,0.00004,73,1,1,2,2787,2787,5574,26,0.061633,0.070246,1724,0,0
8510310,"Balzers, Wingerta",,0.000045,73,1,1,2,2787,2787,5574,25,0.065529,0.075049,2150,0,0
8510312,"Balzers, Stadel",,0.000049,73,1,1,2,2787,2787,5574,24,0.069961,0.080784,2574,0,0
8510313,"Balzers, Gnetsch",,0.000053,73,1,1,2,2787,2787,5574,23,0.075048,0.087813,2996,0,0
8510314,"Balzers, Gemeindezentrum",,0.000056,73,1,1,2,2787,2787,5574,22,0.080948,0.096804,3416,0,0
8510315,"Balzers, Schlossgarten",,0.000058,73,1,2,3,2787,2787,5574,21,0.087871,0.109417,3834,0,0
8510317,"Balzers, Unterm Stein",,0.000041,73,1,1,2,1392,1392,2784,21,0.087513,0.106396,424,0,0
8510316,"Balzers, Haus Gutenberg",,0.000036,73,1,1,2,1392,1392,2784,22,0.080645,0.095299,10,0,0
8510318,"Balzers, Mariahilf",,0.000071,73,2,2,4,2787,2787,5574,20,0.09568,0.122515,5076,0,0
8574398,"Triesen, Bächlegatter",,0.000022,73,1,2,3,8988,8988,17976,20,0.095958,0.123389,56941.935949,0,0
8574400,"Triesen, Säga",,0.000028,73,1,1,2,6100,6100,12200,20,0.095572,0.120426,423,0,0
8574402,"Balzers, Egerta",,0.000024,73,1,1,2,6399,6399,12798,24,0.070472,0.082794,0,0,0
8510342,"Solduno S. Martino, Stazione (bus)",,0.000011,101,0,1,1,0,428,428,32,0.090326,0.112512,0,0,0
8571137,"Brigerbad, Mittagsfluh",,0.000022,40,1,3,4,1157,1157,2314,11,0.205742,0.297315,70.457576,0,0
8510415,"Flums, Flumserei",,0.000023,124,1,1,2,318,502,820,16,0.101754,0.15674,21,0,0
8588838,"Renens VD, gare nord",,0.000059,5,3,4,7,23054,75739,98793,16,0.14505,0.191689,2616.472719,0,0
8510423,"Vallorbe, rue de Lausanne",,0.000034,35,3,1,4,1481,2771,4252,42,0.051102,0.074219,2462,0,0
8570318,"Yverdon-les-Bains, HEIG-VD",,0.000031,35,4,3,7,37442,36340,73782,21,0.118703,0.173521,900.42619,0,0
8577281,"Montcherand, Usine électrique",,0.000017,35,1,6,7,6130,6130,12260,9,0.256579,0.390517,311,0,0
8510426,"Vallorbe, Les Baraquettes",,0.000018,35,1,1,2,653,654,1307,43,0.048447,0.065696,36,0,0
8510427,"Vallorbe, Toscane",,0.000026,35,1,1,2,654,654,1308,42,0.050871,0.072188,1210,0,0
8510475,"Troistorrents, Bonnares",,0.00006,103,1,1,2,620,620,1240,9,0.176471,0.265979,69,0,0
8510490,"St-Martin VS, Le Baunou",,0.000011,39,0,2,2,0,187,187,22,0.100737,0.148149,0,0,0
8570901,"Euseigne, Ritzé",,0.000056,39,1,1,2,2469,2469,4938,23,0.0929,0.126868,1631,0,0
8570902,"Praz-Jean VS, village",,0.000063,39,2,2,4,2630,2630,5260,22,0.101582,0.149049,1660,0,0
8570932,"Suen, centre",,0.000038,39,1,1,2,1975,1975,3950,22,0.099903,0.141196,1526,0,0
8510525,"St-Sulpice VD, Castolin",,0.000014,5,1,1,2,17252,17254,34506,42,0.040337,0.047808,24,0,0
8510526,"St-Sulpice VD, En Champagny",,0.000023,5,1,1,2,17254,17254,34508,41,0.042001,0.05055,1339,0,0
8510527,"St-Sulpice VD, Ochettaz-Ormet",,0.00003,5,1,1,2,17254,17253,34507,40,0.043809,0.053799,2652,0,0
8510608,"Soral, douane",,0.000011,120,0,2,2,0,2422,2422,21,0.132318,0.154577,0,0,0
8587038,"Cartigny, village",,0.000021,120,1,1,2,17195,16516,33711,21,0.129459,0.147911,10,0,0
8587031,"Avully, village",,0.000029,120,2,3,5,22345,30413,52758,21,0.137182,0.163902,730.333333,0,0
8587040,"Chancy, village",,0.000029,120,2,2,4,25452,25465,50917,20,0.14847,0.177354,426.804401,0,0
8587055,"Dardagny, château",,0.000035,120,1,1,2,11073,13964,25037,21,0.117704,0.134315,1839,0,0
8587072,"Cartigny, Petite-Grave",,0.000033,120,2,2,4,18834,21917,40751,20,0.14847,0.177354,1066.890794,0,0
8510631,"Fribourg, Fonderie",,0.000017,126,1,1,2,9842,9078,18920,24,0.107182,0.136676,115,0,0
8510680,"Montana, Cocagne",,0.000016,39,1,1,2,741,741,1482,23,0.074013,0.100885,4,0,0
8510685,"Montana, Montagnette",,0.000025,39,1,1,2,741,741,1482,22,0.079485,0.113069,179,0,0
8579469,"Montana, Etoile",,0.0001,39,7,1,8,27867,27287,55154,22,0.079485,0.113069,1814.866667,0,0
8515994,Zug Fridbach,,0.000071,9,3,1,4,16792,16793,33585,2,0.666667,0.75,770,0,0
8515995,Cham Alpenblick,,0.00006,9,2,1,3,35069,35085,70154,3,0.5,0.583333,1540,0,0
8515996,Hünenberg Zythus,,0.000062,9,1,2,3,35085,35085,70170,2,0.75,0.833333,1158,0,0
8515997,Root D4,,0.000037,9,1,1,2,19799,19800,39599,2,0.666667,0.75,0,0,0
8516155,Lancy-Pont-Rouge,,0.000064,4,6,2,8,54318,54303,108621,3,0.5,0.633333,600,0,0
8516272,Genève-Champel,,0.000038,4,1,1,2,38628,38628,77256,3,0.444444,0.541667,0,0,0
8516187,Zug Schutzengel,,0.000069,9,2,1,3,35086,19799,54885,1,1,1,388,0,0
8516270,Arbon Seemoosriet,,0.000036,18,1,1,2,19588,19588,39176,1,1,1,642,0,0
8516273,Genève-Eaux-Vives,,0.000071,4,2,1,3,54303,38628,92931,2,0.6,0.666667,302,0,0
8516283,Genève-Sécheron,,0.000048,4,2,1,3,35953,35719,71672,1,1,1,80,0,0
8516450,Unterkulm Nord,,0.000079,9,1,1,2,34467,33093,67560,1,1,1,155,0,0
8517112,Walchwil Hörndli,,0.000071,9,1,1,2,16793,16793,33586,1,1,1,386,0,0
8517409,Freidorf,,0.000018,2,3,1,4,12057,12067,24124,25,0.073231,0.082152,384,0,0
8517410,Käppeli,,0.000026,2,1,1,2,12067,12067,24134,24,0.078776,0.088468,690,0,0
8517411,Rothausstrasse,,0.000033,2,1,1,2,12067,12057,24124,23,0.085251,0.096109,994,0,0
8517412,Schützenstrasse,,0.000039,2,1,1,2,12057,12067,24124,22,0.09291,0.105602,1296,0,0
8517413,Zum Park,,0.000044,2,1,1,2,12067,12067,24134,21,0.102112,0.117902,1596,0,0
8517414,Bahnhofstrasse,,0.000048,2,1,2,3,12067,19578,31645,20,0.113373,0.135342,1894,0,0
8583447,"Rheinfelden, Pappelnweg",,0.000039,2,2,1,3,7581,1309,8890,6,0.3,0.380556,492,0,0
8583448,"Rheinfelden, Weiherfeld",,0.000039,2,2,1,3,7393,1313,8706,6,0.3,0.380556,492,0,0
8517415,Gempenstrasse,,0.000031,2,1,1,2,12065,12067,24132,19,0.120599,0.141115,1902,0,0
8517416,Kästeli,,0.000038,2,1,1,2,12067,12067,24134,18,0.136712,0.165917,2196,0,0
8578351,Pratteln Bahnhof Süd,,0.000095,2,6,2,8,26029,26029,52058,12,0.172779,0.204682,8157.587671,0,0
8517485,Sur-le-Buis,,0.000081,4,3,1,4,8327,6813,15140,4,0.4,0.520833,608,0,0
8518100,St. Gallen Birnbäumen,,0.0001,18,3,1,4,27534,25332,52866,1,1,1,655,0,0
8518771,Biel/Bienne Bözingenfeld/Champs-de-Boujean,,0.000033,11,1,1,2,19169,19169,38338,1,1,1,375,0,0
8589325,Hochbergerstrasse,,0.00005,2,2,2,4,13834,19864,33698,10,0.20412,0.245045,453.898729,0,0
8589328,Holee,,0.000054,2,2,3,5,11412,11412,22824,9,0.225941,0.269095,278.601482,0,0
8589330,Im langen Loh,,0.000035,2,1,3,4,12086,12085,24171,10,0.198182,0.244798,355.750875,0,0
8589331,Inselstrasse,,0.000029,2,2,1,3,5867,5867,11734,10,0.195298,0.230398,295.757576,0,0
8530011,Les Coeudres-Est,,0.000076,11,1,1,2,8774,8775,17549,2,0.666667,0.75,852,0,0
8530012,Petit-Martel-Est,,0.000075,11,1,1,2,8775,8775,17550,1,1,1,427,0,0
8530064,Bex Pont-Neuf,,0.000056,4,2,1,3,7611,7407,15018,6,0.285714,0.408333,596,0,0
8530066,Grand-Moulin,,0.000058,4,1,1,2,7407,7407,14814,5,0.333333,0.456667,453,0,0
8530067,Les Salines,,0.000061,4,1,1,2,7407,7407,14814,4,0.4,0.520833,308,0,0
8530246,Foyer Dents-du-Midi,,0.000062,4,1,1,2,7407,7407,14814,3,0.5,0.611111,161,0,0
8577005,Wegmühlegässli,,0.000025,44,1,3,4,19073,19049,38122,16,0.186375,0.241074,10666.5,0,0
8579515,"Liebefeld, Steinhölzli",,0.000035,44,2,4,6,7583,7679,15262,9,0.215488,0.272659,9436.12619,0,0
8588989,Bärenplatz,,0.000151,44,12,10,22,100675,100153,200828,9,0.245955,0.361132,38126.939654,0,0
8589003,Thunplatz,,0.000092,44,4,4,8,49647,49737,99384,8,0.219917,0.302022,6321.019048,0,0
8589006,Wittigkofen,,0.00003,44,1,2,3,23343,23349,46692,13,0.160377,0.232936,0,0,0
8590005,Steigerhubel,,0.000093,44,5,2,7,47629,47650,95279,12,0.178571,0.256922,346.683333,0,0
8590006,Luisenstrasse,,0.000104,44,6,4,10,59836,58699,118535,12,0.183521,0.286801,850.305476,0,0
8590014,Fischermätteli,,0.0001,44,3,3,6,26490,25788,52278,11,0.185567,0.287293,146.5,0,0
8530303,Les Fumeaux,,0.000069,4,2,1,3,11532,10246,21778,1,1,1,153,0,0
8530335,Aigle-Hôpital,,0.000078,4,2,1,3,16008,15993,32001,6,0.285714,0.408333,312,0,0
8530355,Les Arnoux,,0.000077,4,1,1,2,15993,15821,31814,5,0.333333,0.456667,168,0,0
8530378,Les Neys,,0.000093,4,2,1,3,9248,9262,18510,3,0.5,0.611111,161,0,0
8530463,En Charnet,,0.000104,4,2,1,3,9400,9253,18653,1,1,1,154,0,0
8530473,"Zürich, Rigiblick",,0.000011,85,0,1,1,0,10079,10079,13,0.111463,0.122004,0,0,0
8530612,Realp DFB,,0.000026,28,1,1,2,144,144,288,2,0.666667,0.75,330,0,0
8530613,Tiefenbach DFB,,0.000033,28,1,1,2,144,144,288,1,1,1,166,0,0
8530708,"Neuchâtel, Evole",,0.000029,31,1,1,2,21346,21346,42692,6,0.285714,0.408333,10,0,0
8530709,"Neuchâtel, Champ-Bougin",,0.000035,31,1,1,2,21346,21346,42692,5,0.333333,0.456667,10,0,0
8530711,Colombier NE Allées Littorail,,0.000063,31,2,1,3,21440,21440,42880,3,0.5,0.611111,24,0,0
8530712,"Colombier NE, Les Chézards",,0.000065,31,1,1,2,21440,21440,42880,2,0.666667,0.75,18,0,0
8530713,"Boudry, Tuilière",,0.000066,31,1,1,2,21440,21440,42880,1,1,1,10,0,0
8530760,Aareschlucht West,,0.000063,11,1,1,2,12390,12390,24780,3,0.5,0.611111,2526,0,0
8530789,Bioggio Molinazzo,,0.00006,14,1,1,2,31021,31021,62042,1,1,1,10,0,0
8530799,Meiringen Alpbach,,0.000065,11,1,1,2,12390,12390,24780,2,0.666667,0.75,1686,0,0
8530800,Innertkirchen Unterwasser,,0.000066,11,1,1,2,12390,4650,17040,1,1,1,844,0,0
8587348,"Zürich, Bahnhofplatz/HB",,0.00006,85,9,3,12,245010,250008,495018,13,0.201159,0.235962,19422.446739,0.153079,0.243985
8591299,"Zürich, Paradeplatz",,0.000228,85,14,11,25,335585,335706,671291,7,0.333333,0.40754,29016.186641,0.090982,0.052647
8591314,"Zürich, Regensbergbrücke",,0.000074,85,3,5,8,115856,115863,231719,7,0.280702,0.334332,882.827164,0.001951,0.012258
8570415,"Chevroux, village",,0.000023,13,1,1,2,1601,1601,3202,5,0.318182,0.409524,0,0,0
8557022,"Gordola, Carcale",,0.000053,101,1,1,2,11569,11569,23138,33,0.089873,0.118103,3311,0,0
8573439,"Berzona (Verzasca), Rustici",,0.000071,101,1,1,2,8355,8355,16710,33,0.089873,0.118103,10408,0,0
8575173,"Riazzino, Scuole",,0.000067,108,1,2,3,18503,18503,37006,29,0.115197,0.148727,7061.6,0,0
8557023,"Sarnen, Seefeld Park/Spital",,0.000027,62,1,1,2,2590,2632,5222,20,0.079072,0.107512,132,0,0
8557025,"Valzeina, Kirche",,0.000011,75,0,1,1,0,1493,1493,9,0.208333,0.31623,0,0,0
8570417,"Montpreveyres, village",,0.000059,13,3,2,5,5104,4992,10096,25,0.085768,0.102326,11403.64016,0,0
8557029,"Bürgenstock, Residenzen",,0.000042,62,2,2,4,5481,3778,9259,15,0.132944,0.16225,820,0,0
8557030,"Bürgenstock, Waldhotel",,0.000029,62,1,2,3,2466,2388,4854,15,0.132812,0.162228,25,0,0
8572927,"Stansstad, Schützen",,0.000044,62,2,1,3,3811,3811,7622,15,0.131105,0.15469,897,0,0
8572931,"Stansstad, Seewli",,0.000044,62,1,2,3,4343,4343,8686,5,0.375,0.547222,198,0,0
8557039,"Freienstein, Dorf",,0.000018,107,1,1,2,7551,7552,15103,28,0.060759,0.067596,34,0.000004,0
8557040,"Rorbas, Bütbergstrasse",,0.000026,107,1,1,2,7552,7541,15093,27,0.064575,0.072251,583,0,0
8573437,"Trüllikon, Dorf",,0.000051,66,1,2,3,4728,4395,9123,7,0.197674,0.295938,605,0,0
8572494,"Döttingen, Bahnhof",,0.000082,57,4,4,8,15699,16512,32211,26,0.082098,0.101624,94619.516215,0.000002,0.000002
8570310,"Donneloye, croisée",,0.000044,35,2,4,6,5690,5690,11380,39,0.051968,0.074275,9502.997436,0,0
8557050,"Uetendorf, Ischlag",,0.000011,43,0,1,1,0,988,988,15,0.128743,0.183419,0,0,0
8557052,"Auressio, Ri del Vò",,0.000028,101,1,1,2,5370,5370,10740,34,0.07863,0.09615,978,0,0
8570530,"Cudrefin, place de la Tour",,0.000075,117,2,2,4,5638,5639,11277,25,0.123245,0.153537,80477.727316,0,0
8571245,"Ins, Dorf",,0.000064,117,5,2,7,9347,9348,18695,25,0.121157,0.149332,9206.333333,0,0
8571246,"Müntschemier, Dorf",,0.000038,117,1,1,2,31,31,62,25,0.121024,0.148267,0,0,0
8557056,"Grüsch, Danusa",,0.00002,75,1,1,2,1493,1388,2881,8,0.236842,0.35754,9,0,0
8557057,"Grüsch, Häri",,0.000028,75,1,2,3,1388,1414,2802,7,0.275862,0.449107,16,0,0
8573635,"Grüsch, Salätschis",,0.000023,75,1,1,2,1307,1360,2667,7,0.25,0.370408,0,0,0
8557062,"Finsterwald LU, Gründli",,0.000027,92,1,1,2,325,325,650,11,0.14486,0.194666,35,0,0
8557063,"Finsterwald LU, Rotbach",,0.000034,92,1,1,2,325,325,650,10,0.163934,0.218876,62,0,0
8557074,"Eschenbach LU, Lindenfeld",,0.000011,90,0,1,1,0,4324,4324,46,0.055997,0.07267,0,0,0
8570473,"Dompierre VD, village",,0.000033,13,1,3,4,6322,6322,12644,28,0.062835,0.082935,2015.2,0,0
8577622,"Cugy FR, gare",,0.000142,13,5,3,8,8337,7607,15944,7,0.304348,0.455442,2238.133333,0,0
8577650,"Chavannes-sur-Moudon, village",,0.000056,13,1,1,2,2263,2263,4526,7,0.272727,0.364683,36,0,0
8580466,"Romont FR, Pierre de Savoie",,0.000098,13,5,5,10,16604,16587,33191,7,0.372093,0.557887,2045.466234,0,0
8557083,"Puidoux, Grangeneuve",,0.000019,13,1,1,2,1750,2949,4699,23,0.09014,0.101756,996,0,0
8557085,"Puidoux, En Botonnet",,0.000027,13,1,1,2,2949,2949,5898,22,0.09888,0.113667,1515,0,0
8557086,"Puidoux, La Lôche",,0.000034,13,1,1,2,2949,2949,5898,21,0.10952,0.129653,2032,0,0
8557088,"Trient, village",,0.000032,39,1,3,4,1063,1063,2126,9,0.220096,0.294004,250.75,0,0
8570967,"La Fontaine, hameau",,0.000039,39,1,1,2,1147,1147,2294,13,0.148387,0.191632,158,0,0
8570968,"Le Cergneux, bif.",,0.000053,39,2,2,4,1807,1807,3614,12,0.170455,0.230548,247,0,0
8570981,"La Caffe, bif.",,0.000059,39,1,2,3,847,847,1694,8,0.226027,0.29531,231,0,0
8570982,"Martigny-Combe, Mayens-Basses",,0.000036,39,1,1,2,236,236,472,8,0.22069,0.273289,0,0,0
8573929,"Uzwil, Bahnhof",,0.000104,20,5,4,9,35935,35091,71026,23,0.074944,0.113613,10749.968467,0,0
8557094,"Marin-Epagnier,Champs-Montants",,0.000011,117,0,1,1,0,2605,2605,21,0.078682,0.103977,0,0,0
8557095,"Marin-Epagnier, Paul-Vouga",,0.00002,117,1,1,2,2605,2605,5210,20,0.084672,0.114042,116,0,0
8557097,"Affoltern a.A., Lindenmoos",,0.000014,115,1,1,2,3162,3162,6324,21,0.09628,0.105199,75.917112,0.000021,0
8570619,"Château-d'Oex, Le Petit-Pré",,0.000081,36,1,1,2,1005,777,1782,11,0.164557,0.256108,57.5,0,0
8570624,"Le Sépey, La Combaz",,0.000084,36,1,2,3,831,831,1662,6,0.333333,0.49375,50,0,0
8570629,"Leysin, En Crettaz",,0.000066,36,1,1,2,858,858,1716,4,0.4,0.520833,26,0,0
8557103,"St. Pelagiberg, Landhaus",,0.000016,121,1,1,2,804,1355,2159,4,0.380952,0.458333,8,0,0
8557104,"St. Pelagiberg, Rothen",,0.000024,121,1,3,4,1355,1182,2537,3,0.538462,0.666667,14,0,0
8578801,"Bischofszell, Stocken",,0.000037,121,1,1,2,3461,3461,6922,7,0.25,0.370408,28,0,0
8578804,Wilen (Gottshaus),,0.000056,121,1,1,2,3957,3957,7914,4,0.4,0.520833,28,0,0
8578807,"Wilen (Gottshaus), Mollishaus",,0.000067,121,1,1,2,4092,3253,7345,1,1,1,10,0,0
8557120,"Seigneux, village",,0.000029,13,2,1,3,1103,1103,2206,29,0.06406,0.075358,71,0,0
8557121,"Granges-sous-Trey, village",,0.000032,13,2,1,3,1104,1104,2208,30,0.062591,0.075622,68.5,0,0
8557130,"Henniez, village",,0.000036,13,1,2,3,1103,1103,2206,28,0.068323,0.082836,563,0,0
8557124,"Inwil, Nussbaum",,0.00002,90,1,1,2,4324,4324,8648,45,0.059178,0.078596,422,0,0
8557126,"Brienz BE, Lehriweg",,0.000025,114,3,1,4,941,970,1911,25,0.080706,0.116186,19,0,0
8557127,"Brienz BE, Wisplatz",,0.000032,114,1,1,2,970,969,1939,24,0.08642,0.123849,77,0,0
8557128,"Brienz BE, Dindlen",,0.000038,114,1,1,2,969,970,1939,23,0.093093,0.133535,133,0,0
8557131,"Payerne, Rives de la Broye",,0.000024,13,1,1,2,6274,6274,12548,26,0.073105,0.110941,159,0,0
8557132,"Payerne, Beaulieu",,0.000032,13,1,2,3,6274,6274,12548,25,0.077897,0.12725,225,0,0
8557135,"Payerne, Concorde",,0.000032,13,1,1,2,3195,3195,6390,25,0.076172,0.111282,78,0,0
8557134,"Payerne, Simplon",,0.000024,13,1,1,2,3195,3195,6390,26,0.071623,0.103202,16,0,0
8557137,"Payerne, Colline",,0.000033,13,1,1,2,3079,3079,6158,25,0.074583,0.103245,19,0,0
8570433,"Ropraz, village",,0.000043,13,1,2,3,1965,1965,3930,11,0.197802,0.317771,86,0,0
8570000,"Nyon, gare",,0.000079,125,4,9,13,44759,148745,193504,21,0.091658,0.15859,5321,0,0
8570029,"Burtigny, Le Battoir",,0.000054,125,1,1,2,3668,3668,7336,8,0.180723,0.22996,198,0,0
8579317,"Chavannes-de-Bogis, village",,0.000048,125,1,3,4,10479,10479,20958,21,0.078425,0.113135,2515,0,0
8579306,"Nyon, hôpital",,0.000027,125,1,3,4,28099,28099,56198,14,0.184211,0.318671,77.80303,0,0
8587577,"Coppet, gare",,0.000045,125,2,4,6,25873,30206,56079,19,0.089552,0.126738,6963.666667,0,0
8588660,"Nyon, Colovray",,0.00005,125,1,2,3,29296,29297,58593,10,0.203947,0.284665,155,0,0
8593874,"Nyon, centre ville",,0.000047,125,3,2,5,34994,34995,69989,6,0.293103,0.385294,199.80303,0,0
8570001,"Nyon, ch. Monastier",,0.000018,125,1,3,4,37580,37577,75157,7,0.285714,0.402381,342,0,0
8593873,"Nyon, Bel Automne",,0.000016,125,1,1,2,13537,13537,27074,7,0.25,0.347354,0,0,0
8570002,"Nyon, route de Signy",,0.000016,125,1,1,2,10287,10290,20577,4,0.388889,0.464286,140,0,0
8570005,"Signy, centre commercial",,0.000025,125,1,2,3,10290,10289,20579,3,0.545455,0.638889,126,0,0
8570007,"Gingins, ouest",,0.000029,125,1,1,2,10199,10184,20383,3,0.5,0.583333,4,0,0
8570006,"Chéserex, A l'Oche",,0.000021,125,1,1,2,10198,10199,20397,4,0.384615,0.483333,22,0,0
8570008,"Nyon, La Redoute",,0.000018,125,1,4,5,34559,34557,69116,10,0.206731,0.307447,517,0,0
8588670,"Prangins, La Banderolle",,0.000043,125,1,1,2,7985,8240,16225,6,0.235294,0.291667,260,0,0
8588671,"Prangins, Sadex",,0.000052,125,2,2,4,22172,22172,44344,5,0.292308,0.372807,406,0,0
8588675,"Prangins, gare",,0.000037,125,2,2,4,14021,14021,28042,7,0.253968,0.358929,155,0,0
8570009,"Duillier, croisée de Trélex",,0.000015,125,1,1,2,7046,7048,14094,11,0.138158,0.177962,140,0,0
8570010,"Coinsins, Mimorey",,0.000023,125,1,1,2,7048,7048,14096,10,0.156489,0.201326,161,0,0
8570015,"Begnins, La Cézille",,0.000045,125,1,1,2,7123,7123,14246,14,0.109145,0.169022,46,0,0
8570016,"Le Vaud, zoo",,0.000062,125,2,2,4,10791,10791,21582,13,0.119205,0.199092,192,0,0
8570014,"Begnins, scierie",,0.00004,125,2,1,3,7123,7123,14246,15,0.100796,0.15361,33,0,0
8570017,"St-George, Maison Neuve",,0.000049,125,2,1,3,7245,7120,14365,4,0.4,0.520833,76,0,0
8581113,"Begnins, Grange-Grèche",,0.000033,125,1,1,2,3668,3668,7336,4,0.4,0.520833,34,0,0
8570018,"St-George, Côte-Malherbe",,0.00003,32,1,1,2,4592,4593,9185,10,0.174497,0.223733,46,0,0
8570020,"Gimel, Côte Réviol",,0.000036,32,1,1,2,4593,4593,9186,9,0.203252,0.256587,48,0,0
8570025,"Begnins, Bellevue",,0.000037,125,1,1,2,3668,3668,7336,12,0.114865,0.158678,186,0,0
8570026,"Begnins, La Chataigneraie",,0.000042,125,1,1,2,3668,3668,7336,11,0.125954,0.169438,192,0,0
8570027,"Begnins, Bois-du-Four",,0.000047,125,1,1,2,3668,3668,7336,10,0.139738,0.183259,196,0,0
8570028,"Begnins, Les Clavières",,0.000051,125,1,1,2,3668,3668,7336,9,0.15736,0.202023,198,0,0
8570030,"Gland, gare nord",,0.000077,125,3,2,5,12756,12501,25257,7,0.213235,0.281527,452,0,0
8570031,"Gland, poste",,0.000043,125,1,1,2,4516,4514,9030,5,0.318182,0.409524,155,0,0
8570032,"Gland, Mont-Blanc/Dôle",,0.000048,125,1,1,2,4514,4515,9029,4,0.4,0.486111,128,0,0
8570033,"Vich, La Bichette",,0.000052,125,1,2,3,4515,4516,9031,3,0.555556,0.666667,99,0,0
8582794,"Burtigny, Les Oches",,0.00008,125,1,1,2,3668,3668,7336,2,0.666667,0.75,44,0,0
8570034,"Rolle, gare nord",,0.000073,32,4,6,10,14973,21872,36845,8,0.266667,0.357004,1199,0,0
8570125,"Saubraz, village",,0.00003,32,1,1,2,3759,3758,7517,7,0.234043,0.288312,0,0,0
8583433,"Gilly, église",,0.000096,32,2,3,5,5707,5158,10865,3,0.529412,0.62963,136,0,0
8570035,"Rolle, place des Tilleuls",,0.000021,32,1,3,4,6314,7193,13507,14,0.16,0.241585,357.666667,0,0
8570036,"Rolle, hôpital",,0.000017,32,1,1,2,4067,4067,8134,13,0.142012,0.198792,54.5,0,0
8570037,"Rolle, Bellefontaine",,0.000017,32,1,1,2,495,495,990,13,0.142012,0.198792,54.5,0,0
8570039,"Perroy, Couronnette",,0.00004,32,2,1,3,4562,4562,9124,12,0.158621,0.216237,125,0,0
8570040,"Perroy, village",,0.000045,32,1,1,2,4562,4562,9124,11,0.180328,0.24073,115,0,0
8570043,"Bougy-Villars, Dessus",,0.000021,32,1,1,2,2174,2174,4348,10,0.174497,0.223733,79,0,0
8570044,"Féchy, Cassivettes",,0.000029,32,1,1,2,2174,2174,4348,9,0.203252,0.256587,75,0,0
8579081,"Aubonne, Le Bornalet",,0.000059,32,1,3,4,11640,9559,21199,7,0.324324,0.493849,217,0,0
8579691,"Essertines-sur-Rolle,Le Pontet",,0.000054,32,1,1,2,3989,3869,7858,2,0.666667,0.75,14,0,0
8583424,"Mont-sur-Rolle, Jeune Suisse",,0.000092,32,3,1,4,6043,488,6531,1,1,1,19,0,0
8570050,"Lavigny, croisée de St-Livres",,0.000042,5,2,2,4,5831,5831,11662,20,0.076726,0.110992,287.5,0,0
8570051,"St-Livres, village",,0.000029,5,1,2,3,5617,5618,11235,20,0.076003,0.106621,19.5,0,0
8577604,"Etoy, gare",,0.000103,5,4,6,10,14968,15325,30293,10,0.235119,0.318138,1851.121989,0,0
8570055,"Rolle, La Pièce",,0.000017,32,1,1,2,2631,2631,5262,6,0.246753,0.308772,202.666667,0,0
8581672,"Dully, St-Bonnet",,0.000053,32,2,3,5,4486,4486,8972,6,0.289474,0.393939,146.916667,0,0
8581940,"Gland, Sous-les-Vignes",,0.000038,32,1,3,4,11730,11730,23460,5,0.327586,0.430702,53.666667,0,0
8570056,"Tartegnin, La Vissenche",,0.000021,32,1,1,2,5428,5158,10586,7,0.214876,0.26978,205.416667,0,0
8570059,"Bursins, village",,0.000029,32,1,2,3,5158,5431,10589,6,0.263158,0.346667,201.416667,0,0
8570061,"Dully, Sous-Dully",,0.000021,32,1,1,2,3653,3653,7306,8,0.2,0.257238,161.916667,0,0
8581930,"Gland, Mauverney",,0.000041,32,1,1,2,6856,6856,13712,6,0.241758,0.299242,88,0,0
8570063,"Cheseaux-sur-Lausanne, gare",,0.000045,5,4,3,7,16969,17095,34064,27,0.08485,0.10716,8958.247177,0,0
8570179,"Bottens, La Rustériaz",,0.000039,10,1,1,2,17921,17921,35842,19,0.116888,0.140521,7452.881651,0,0
8592032,"Lausanne, Dranse",,0.000026,10,2,3,5,49691,49716,99407,15,0.165069,0.214458,673.128167,0,0
8592034,"Lausanne, Druey-Collège",,0.000061,10,3,5,8,56025,56016,112041,14,0.188192,0.256928,1927.436045,0,0
8570064,"Cheseaux-sur-Lausanne, Pâquis",,0.000024,5,1,2,3,8632,9084,17716,27,0.081142,0.095493,8360,0,0
8570131,"Penthalaz, village",,0.000026,5,2,2,4,4712,4657,9369,27,0.077937,0.092539,88470,0,0
8570066,"Bournens, école",,0.000021,5,1,1,2,4963,4852,9815,31,0.062506,0.070624,605.166667,0,0
8570067,"Bournens, Au Mont",,0.000029,5,1,1,2,4852,4935,9787,30,0.066621,0.076584,1849.166667,0,0
8570071,"Echichens, Signal d'Echichens",,0.000027,5,1,1,2,5909,5872,11781,38,0.048142,0.063979,144,0,0
8570074,"Vaux-sur-Morges, village",,0.00002,5,1,1,2,4956,4991,9947,42,0.040342,0.04806,120,0,0
8570075,"Vaux-sur-Morges, Bugnon",,0.000028,5,1,2,3,4991,4991,9982,41,0.042006,0.051157,1419,0,0
8570076,"Clarmont, village",,0.000023,5,1,1,2,4800,4800,9600,41,0.041976,0.050437,0,0,0
8570077,"Reverolle, Chaniaz (collège)",,0.000042,5,2,1,3,4991,4991,9982,40,0.043782,0.05365,4011,0,0
8570078,"Reverolle, village",,0.000047,5,1,1,2,4991,4968,9959,39,0.045752,0.057568,5304,0,0
8570079,"Apples, La Mottaz",,0.000051,5,1,1,2,4968,4962,9930,38,0.047909,0.062586,6595,0,0
8570081,"Morges, Vogéaz",,0.000051,5,2,1,3,25477,44219,69696,38,0.047942,0.062918,27628,0,0
8570098,"Echichens, Haute-Pierre",,0.000033,5,1,3,4,22914,22950,45864,38,0.04416,0.058904,1801,0,0
8588875,"Echandens, centre",,0.00006,5,3,6,9,51169,51171,102340,16,0.142325,0.208499,6736,0,0
8589247,"Morges, poste",,0.000082,5,7,6,13,32411,32405,64816,10,0.24127,0.328786,2184.374659,0,0
8570089,"Morges, Pâquis",,0.000027,5,1,2,3,28711,28714,57425,36,0.050395,0.065482,0,0,0
8589249,"Morges, Riond-Bosson",,0.000052,5,1,3,4,35283,35281,70564,9,0.187713,0.250729,458.609091,0,0
8592263,"Morges, de Beausobre",,0.000065,5,2,6,8,36855,33305,70160,5,0.43662,0.525269,4109.625097,0,0
8592264,"Morges, Delay",,0.00005,5,3,1,4,18417,18411,36828,7,0.242105,0.291718,81.269697,0,0
8570085,"Denens, Chatagny",,0.000027,5,1,1,2,8224,8224,16448,11,0.133779,0.167471,174,0,0
8570086,"Villars-sous-Yens, village",,0.000033,5,1,1,2,8224,8221,16445,10,0.150579,0.183496,155,0,0
8570087,"Villars-sous-Yens, Le Moulin",,0.000039,5,1,1,2,8221,8206,16427,9,0.172727,0.205368,134,0,0
8570088,"Lavigny, hôpital",,0.000044,5,1,1,2,8206,8224,16430,8,0.203297,0.237291,111,0,0
8570091,"Echichens, Gravelines",,0.000043,5,1,4,5,40741,40738,81479,34,0.052902,0.070201,59080.916667,0,0
8570090,"Morges, Les Pétoleyres",,0.000038,5,2,1,3,40733,40741,81474,35,0.050282,0.062693,57863.916667,0,0
8588158,"St-Sulpice VD, centre",,0.000051,5,1,3,4,50287,50287,100574,19,0.146316,0.185456,7518.5,0,0
8588871,"Morges, St-Jean nord",,0.000038,5,2,3,5,34952,34948,69900,18,0.121307,0.178113,4054.055139,0,0
8570092,"Bremblens, bas du village",,0.00002,5,1,1,2,9221,9221,18442,34,0.053734,0.062553,59977,0,0
8570093,"Aclens, collège",,0.000028,5,1,2,3,9221,9221,18442,33,0.05674,0.068009,61175,0,0
8570094,"Gollion, village",,0.000023,5,1,1,2,7087,7087,14174,32,0.059593,0.06831,61856,0,0
8570095,"Allens, village",,0.00003,5,1,1,2,7087,7087,14174,31,0.063319,0.074089,63050,0,0
8570097,"Echichens, croisée",,0.000027,5,1,1,2,22949,22914,45863,39,0.042324,0.053222,580,0,0
8570099,"St-Saphorin-sur-Morges, Pavé",,0.00002,5,1,1,2,11464,11464,22928,38,0.044074,0.048224,2866,0,0
8570100,"St-Saphorin-sur-Morges,village",,0.000028,5,1,1,2,11464,11463,22927,37,0.04607,0.050578,4069,0,0
8570102,"Colombier VD, En Plan",,0.000035,5,1,1,2,11463,7421,18884,36,0.048256,0.053217,5270,0,0
8570103,"Cottens VD, La Caroline",,0.000041,5,1,1,2,7421,7421,14842,35,0.050663,0.056203,6469,0,0
8570104,"Cottens VD, Laiterie",,0.000045,5,1,1,2,7421,7421,14842,34,0.053324,0.059621,7666,0,0
8570105,"Cottens VD, La Tuilière",,0.000049,5,1,1,2,7421,7421,14842,33,0.056283,0.063595,8861,0,0
8570106,"Grancy, Les Pâles",,0.000053,5,1,1,2,7421,7421,14842,32,0.059593,0.06831,10054,0,0
8570107,"Grancy, collège",,0.000056,5,1,1,2,7421,7421,14842,31,0.063319,0.074089,11245,0,0
8570136,"Chavannes-le-Veyron, croisée",,0.000048,5,1,1,2,4963,4733,9696,5,0.310345,0.383333,139,0,0
8570142,"La Sarraz, gare",,0.000074,5,4,2,6,8648,8516,17164,9,0.217391,0.382897,245,0,0
8570112,"Montricher, Champet",,0.000044,33,3,3,6,7382,6447,13829,6,0.347826,0.55625,32,0,0
8570119,"Bière, gare",,0.000051,33,1,2,3,3387,3388,6775,1,1,1,10,0,0
8583297,"Montricher, Petit Faubourg",,0.000045,33,2,1,3,4011,4006,8017,1,1,1,0,0,0
8570113,"Mollens VD, Champou",,0.000023,33,1,1,2,3454,3389,6843,6,0.259259,0.37381,25,0,0
8570114,"Mollens VD, village",,0.000031,33,1,1,2,3389,3389,6778,5,0.3,0.413889,26,0,0
8570115,"Mollens VD, Forchy",,0.000037,33,1,1,2,3389,3389,6778,4,0.357143,0.466667,25,0,0
8570116,"Mollens VD, Les Chaux",,0.000042,33,1,1,2,3389,3389,6778,3,0.444444,0.541667,22,0,0
8570117,"Berolle, Les Molliettes",,0.000047,33,1,1,2,3389,3387,6776,2,0.6,0.666667,17,0,0
8579083,"Pizy, Le Courtillet",,0.000051,32,2,2,4,8346,8229,16575,8,0.25641,0.421786,120,0,0
8570130,"Penthalaz, poste",,0.00002,5,1,3,4,5026,5054,10080,28,0.075851,0.090335,0,0,0
8570132,"Penthaz, Rio",,0.000026,5,2,1,3,4943,4832,9775,10,0.156863,0.192467,0,0,0
8570133,"La Chaux (Cossonay), Ittens",,0.000033,5,2,1,3,4964,4963,9927,8,0.193548,0.278075,400,0,0
8570134,"La Chaux (Cossonay), village",,0.000039,5,1,1,2,4963,4963,9926,7,0.22,0.302381,315,0,0
8570135,"Chavannes-le-Veyron, St-Denis",,0.000044,5,1,1,2,4963,4963,9926,6,0.25641,0.335,228,0,0
8570137,"Cuarnens, Le Pont",,0.000065,5,2,1,3,4842,4842,9684,4,0.4,0.46875,786,0,0
8570138,"Cuarnens, Moulin-Dessus",,0.000066,5,1,3,4,4842,5072,9914,3,0.583333,0.690476,693,0,0
8583359,"La Sarraz, collège Guébettes",,0.000064,5,1,1,2,4346,4345,8691,4,0.4,0.520833,58,0,0
8570157,"La Coudre (L'Isle),bas village",,0.000042,5,1,1,2,3739,3742,7481,2,0.666667,0.75,4,0,0
8595611,"Dizy, village",,0.000082,5,1,1,2,4455,109,4564,2,0.666667,0.75,26,0,0
8570139,"Eclépens, gare",,0.000032,5,2,1,3,4223,4223,8446,12,0.158537,0.257939,28,0,0
8570140,"Eclépens, Cinq-Sous",,0.000038,5,1,1,2,4223,4223,8446,11,0.173913,0.279434,37,0,0
8570144,"La Sarraz, centre",,0.000055,5,2,1,3,4345,4345,8690,8,0.222222,0.339732,454,0,0
8570145,"La Sarraz, piscine",,0.000058,5,1,1,2,4345,3866,8211,7,0.25,0.370408,358,0,0
8570146,"Ferreyres, La Tine",,0.00006,5,1,1,2,3866,4346,8212,6,0.285714,0.408333,260,0,0
8570147,"Moiry VD, collège",,0.000062,5,1,1,2,4346,4346,8692,5,0.333333,0.456667,160,0,0
8570148,"Croy-Romainmôtier, gare",,0.000011,34,0,1,1,0,2159,2159,5,0.307692,0.389583,0,0,0
8570149,"Romainmôtier, église",,0.00002,34,1,1,2,2159,2159,4318,4,0.388889,0.464286,7,0,0
8570150,"Juriens, village",,0.000028,34,1,2,3,2159,2348,4507,3,0.545455,0.638889,12,0,0
8570152,"La Praz, La Scie",,0.00003,34,1,1,2,2159,2159,4318,3,0.5,0.583333,4,0,0
8570151,"Juriens, Le Cosson",,0.000023,34,1,1,2,2159,2159,4318,4,0.384615,0.483333,3,0,0
8570153,"La Praz, Maison de commune",,0.000049,34,2,2,4,2348,2429,4777,2,0.75,0.833333,15,0,0
8570155,"Mont-la-Ville, Le Battoir",,0.00003,5,1,1,2,3750,3751,7501,4,0.4,0.520833,204,0,0
8570156,"La Coudre (L'Isle), village",,0.000036,5,1,1,2,3751,3739,7490,3,0.5,0.611111,105,0,0
8570164,"Cugy VD, Le Moulin",,0.000018,10,1,1,2,17920,17919,35839,31,0.060183,0.066018,100,0,0
8570167,"Froideville, village",,0.000026,10,1,1,2,17919,17921,35840,30,0.063986,0.070727,1342,0,0
8570168,"Froideville, croisée",,0.000033,10,1,1,2,17921,17920,35841,29,0.068305,0.076271,2582,0,0
8570169,"Froideville, Laiterie",,0.000039,10,1,1,2,17920,17920,35840,28,0.073254,0.082926,3820,0,0
8570172,"Villars-Tiercelin, village",,0.00002,35,1,1,2,3833,7183,11016,29,0.070941,0.078811,4608.642335,0,0
8570173,"Peney-le-Jorat, Chalet Renards",,0.000028,35,1,1,2,7183,6950,14133,28,0.076296,0.085959,5809.642335,0,0
8570174,"Peney-le-Jorat, poste",,0.000035,35,1,1,2,6950,7182,14132,27,0.082532,0.094873,7008.642335,0,0
8570175,"Villars-Mendraz, Praz-Longet",,0.00004,35,1,2,3,7182,6950,14132,26,0.089884,0.106639,8205.642335,0,0
8570176,"Bretigny-sur-Morrens, croisée",,0.000044,10,1,1,2,17920,17843,35763,27,0.078981,0.091134,5056,0,0
8570180,"Echallens, Château",,0.000032,5,2,2,4,7904,7900,15804,26,0.084321,0.102597,98388.833333,0,0
8570184,"St-Barthélemy, Château",,0.000043,5,1,1,2,3783,3783,7566,26,0.084101,0.101208,3615,0,0
8570181,"Echallens, route de Cossonay",,0.000024,5,1,1,2,4003,3783,7786,29,0.067302,0.075865,297,0,0
8570182,"St-Barthélemy, Champ Cadet",,0.000032,5,1,1,2,3783,3783,7566,28,0.072098,0.0825,1405,0,0
8570183,"St-Barthélemy, village",,0.000038,5,1,1,2,3783,3783,7566,27,0.077636,0.090692,2511,0,0
8570186,"Oulens-sous-Echallens,Gd Salle",,0.000037,5,1,1,2,3669,3669,7338,31,0.059267,0.065439,624,0,0
8570187,"Oulens-sous-Echallens, collège",,0.000042,5,1,1,2,3669,3669,7338,30,0.062948,0.070073,1722,0,0
8570188,"Eclagnens, collège",,0.000047,35,1,1,2,3669,3669,7338,29,0.067121,0.075527,2818,0,0
8570189,"Goumoens-la-Ville, Eclagnens",,0.000051,35,1,1,2,3669,3669,7338,28,0.071891,0.082069,3912,0,0
8570190,"Goumoens-la-Ville, centre",,0.000054,35,1,1,2,3669,3669,7338,27,0.077395,0.090113,5004,0,0
8570192,"Penthéréaz, village",,0.00003,35,2,1,3,1944,2638,4582,27,0.079509,0.095235,96,0,0
8570196,"Corcelles-sur-Chav., Tuilerie",,0.00002,35,1,1,2,1495,1552,3047,27,0.07782,0.091112,39,0,0
8570201,"Goumoens-la-Ville, Tuilerie",,0.000057,35,1,1,2,3669,3669,7338,26,0.083817,0.100366,6094,0,0
8570203,"Echallens, place Emile Gardaz",,0.000056,35,3,1,4,8028,10118,18146,26,0.084387,0.101603,18440.358198,0,0
8570205,"Echallens, Les Trois-Sapins",,0.000036,35,1,1,2,7610,7915,15525,27,0.077956,0.091658,1024,0,0
8570206,"Poliez-le-Grand, Der. Le Chêne",,0.000041,35,1,1,2,7915,7847,15762,26,0.084478,0.102658,2172,0,0
8570208,"Poliez-le-Grand, La Sauvenière",,0.000021,35,1,1,2,3192,3192,6384,26,0.084216,0.10142,67,0,0
8570209,"Poliez-le-Grand, Bois-la-Croix",,0.000021,35,1,1,2,2372,2372,4744,26,0.083974,0.101017,268,0,0
8570219,"Chardonney, village",,0.000041,35,1,1,2,1494,1494,2988,26,0.083974,0.101017,1229,0,0
8570211,"Poliez-Pittet, Les Roches",,0.000033,35,2,1,3,4610,4526,9136,27,0.077721,0.091215,422,0,0
8570212,"Poliez-Pittet, village",,0.000039,35,1,2,3,4526,4526,9052,26,0.0842,0.102265,1559,0,0
8570216,"Villars-Tiercelin, Fontaines",,0.000034,35,1,1,2,1494,1494,2988,26,0.084078,0.101189,1204,0,0
8570215,"Dommartin, village",,0.000027,35,1,1,2,1410,1494,2904,27,0.077617,0.090675,71,0,0
8570218,"Montaubion, croisée",,0.000035,35,1,1,2,1494,1494,2988,27,0.077528,0.09054,102,0,0
8570221,"Peyres-Possens, café",,0.000038,35,1,1,2,2304,2304,4608,27,0.077395,0.090113,156,0,0
8570222,"Boulens, Moulin de l'Augine",,0.000043,35,1,1,2,2304,1725,4029,26,0.083817,0.100366,1276,0,0
8570224,"Croy, anc. Battoir",,0.000032,34,1,1,2,2159,2159,4318,1,1,1,6,0,0
8570300,"Villars-le-Terroir, pl. Eglise",,0.000037,35,1,1,2,5502,5174,10676,20,0.098921,0.145629,419.666667,0,0
8570351,"St-Cierges, La Tondiaz",,0.000048,35,1,1,2,3600,3600,7200,24,0.079992,0.095913,34230.614286,0,0
8570241,"Suscévaz, Les Vignes",,0.000018,35,1,1,2,4341,4233,8574,27,0.071884,0.087087,84,0,0
8570242,"Mathod, Moulin de Mathod",,0.000026,35,1,1,2,4233,4175,8408,26,0.07709,0.093831,275,0,0
8570244,"Valeyres-sous-Rances, rest.",,0.000053,35,2,1,3,4455,4455,8910,24,0.090248,0.112618,889,0,0
8570245,"Valeyres-sous-Rances, croisée",,0.000056,35,1,1,2,4455,4455,8910,23,0.098731,0.126459,1074,0,0
8570249,"Yverdon, rue des Uttins",,0.000102,35,3,1,4,9827,9827,19654,23,0.082277,0.095663,5859.333333,0,0
8570250,"Yverdon-les-Bains, Le Bey",,0.000098,35,1,1,2,9827,9827,19654,22,0.089434,0.106042,6235.333333,0,0
8570252,"Grandson, gare",,0.000094,35,1,1,2,9827,9827,19654,21,0.097978,0.119988,6609.333333,0,0
8570253,"Grandson, place du Château",,0.000091,35,1,3,4,9827,9827,19654,20,0.108353,0.141059,6981.333333,0,0
8570266,"Vaugondry, bif.",,0.000026,35,1,2,3,581,581,1162,20,0.12,0.162164,128.166667,0,0
8570265,"Villars-Burquin, Laiterie",,0.000037,35,1,2,3,950,950,1900,21,0.108978,0.143659,828,0,0
8570267,"Villars-Burquin, La Forge",,0.000038,35,2,1,3,890,890,1780,21,0.114922,0.157156,839.833333,0,0
8570270,"Ferrera, Abzw. Val digl Uors",,0.000038,109,1,1,2,2118,2118,4236,16,0.109756,0.195755,270,0,0
8570280,"Concise, Bas-du-Pavé",,0.000022,35,1,1,2,4023,4023,8046,23,0.075937,0.08756,400,0,0
8570281,"Concise, haut du village",,0.00003,35,1,1,2,4023,4022,8045,22,0.08196,0.095639,740,0,0
8570282,"Concise, Prise-Gaulaz",,0.000036,35,1,1,2,4022,4023,8045,21,0.089041,0.105926,1078,0,0
8570283,"Concise, Platet-Christine",,0.000042,35,1,1,2,4023,4023,8046,20,0.097485,0.119778,1414,0,0
8594016,"Yverdon, Collège de Fontenay",,0.00008,35,2,2,4,20077,20117,40194,7,0.264957,0.329339,7678.642857,0,0
8594023,"Yverdon, Léon-Jaquier sud",,0.000019,35,1,2,3,8103,8095,16198,7,0.25,0.328034,0,0,0
8594020,"Yverdon, Grands Champs",,0.000035,35,2,2,4,9167,9165,18332,6,0.292308,0.373684,1236.333333,0,0
8594029,"Yverdon, rue de Bullet",,0.000041,35,2,2,4,15661,15591,31252,5,0.352941,0.423148,795.452381,0,0
8579090,"Vallorbe, Trésit",,0.00007,35,3,1,4,5932,5990,11922,12,0.169903,0.226408,163,0,0
8570291,"Belmont-sur-Yverdon, Les Prés",,0.000014,35,1,1,2,2745,2745,5490,20,0.096189,0.135402,915.4,0,0
8570293,"Vuarrengel, En Chollet",,0.000014,35,1,1,2,5481,5161,10642,23,0.07978,0.116005,1049.666667,0,0
8570298,"Vuarrens, gar. du Gros-de-Vaud",,0.000023,35,1,1,2,5161,5174,10335,22,0.085202,0.123101,841.666667,0,0
8570299,"Villars-le-Terroir, B.-Croix",,0.00003,35,1,1,2,5174,5502,10676,21,0.091503,0.132363,631.666667,0,0
8570301,"Echallens, La Fontaine",,0.00007,35,2,2,4,7764,8119,15883,19,0.107784,0.16967,1189.5,0,0
8570303,"Pomy, croisée de Sermuz",,0.000017,35,1,1,2,2881,2881,5762,44,0.041563,0.05109,1282.833333,0,0
8570305,"Pailly, Le Rembloz",,0.000045,35,2,1,3,3912,3912,7824,42,0.045235,0.057997,3636.833333,0,0
8570307,"Bercher, gare",,0.000104,35,6,4,10,7326,4445,11771,40,0.049629,0.070186,8217.367094,0,0
8570395,"Bercher, Vieux-Collège",,0.000033,35,1,2,3,1811,1811,3622,16,0.142045,0.217631,35.333333,0,0
8570398,"Bioley-Magnoux, Moulin agr.",,0.000027,35,1,2,3,1402,1402,2804,16,0.137931,0.205866,114,0,0
8570308,"Pomy, collège",,0.000017,35,1,1,2,5112,5112,10224,38,0.053715,0.070327,18172.348291,0,0
8580462,"Bercher, village",,0.000079,35,3,3,6,1811,1811,3622,15,0.153846,0.243271,345.5,0,0
8580578,"Bercher, Vers l'Eglise",,0.000033,35,1,1,2,235,235,470,16,0.131579,0.178849,0,0,0
8570316,"Prahins, Les Ivuez",,0.000027,13,2,1,3,3243,3243,6486,38,0.052008,0.066688,8274.316667,0,0
8570374,"Granges-près-Marnand, poste",,0.00004,13,1,5,6,3438,3527,6965,27,0.074113,0.098753,8655.519625,0,0
8570397,"Ogens, village",,0.000056,35,3,3,6,2600,2600,5200,15,0.160656,0.258989,1812.551282,0,0
8580464,"Combremont-le-Grand, Crévy",,0.000062,13,2,2,4,5014,3924,8938,15,0.157377,0.240079,2950.633333,0,0
8581512,"St-Cierges, Transformateur",,0.000061,13,3,1,4,6371,5904,12275,15,0.148148,0.208874,2722.72619,0,0
8581514,"Thierrens, Le Planchy",,0.000053,13,1,1,2,1835,1835,3670,15,0.148148,0.208874,1106.72619,0,0
8581610,"Oppens, La Tuilière",,0.000082,35,4,1,5,2216,943,3159,15,0.148148,0.208874,154,0,0
8570392,"Chêne-Pâquier, La Cure",,0.000051,13,1,3,4,2304,2304,4608,17,0.140845,0.218582,243,0,0
8579739,"Yvonand, Les Vergers",,0.000067,13,3,4,7,2784,2784,5568,16,0.14121,0.235678,1266.866667,0,0
8582049,"Treytorrens (Payerne), église",,0.000052,13,2,2,4,1585,1585,3170,2,0.75,0.833333,3,0,0
8570322,"Gorgier-St-Aubin, gare",,0.000079,35,7,4,11,6079,6438,12517,18,0.118492,0.147567,47632.333333,0,0
8570326,"St-Aubin NE, Les Charrières",,0.000028,35,1,1,2,67,67,134,7,0.282051,0.379654,0,0,0
8570329,"Vernéaz, croisée",,0.00004,35,1,1,2,1132,1132,2264,7,0.282051,0.379654,22,0,0
8571846,Les Carrels,,0.000087,48,5,4,9,59354,59590,118944,16,0.138985,0.176459,34334.897619,0,0
8570325,"St-Aubin NE, hôpital",,0.000028,35,1,1,2,1132,1132,2264,9,0.203125,0.28428,878,0,0
8570327,Sauges-près-Saint-Aubin,,0.000034,35,1,1,2,1132,1132,2264,8,0.235294,0.319544,451,0,0
8570328,"Vaumarcus, gare",,0.000019,35,1,1,2,4704,4704,9408,20,0.114943,0.153073,28869.4,0,0
8570332,"Montalchez, La Comballaz",,0.000085,35,3,3,6,1676,1676,3352,6,0.357143,0.528333,4430,0,0
8570333,"Montalchez, centre du village",,0.000035,35,1,2,3,693,693,1386,6,0.333333,0.475926,0,0,0
8575841,"Vaumarcus, bas du village",,0.00005,35,2,3,5,1132,1132,2264,5,0.421053,0.597917,1557.5,0,0
8570334,"Essert-sous-Champvent, village",,0.000018,35,1,1,2,6255,6197,12452,22,0.098323,0.127127,44,0,0
8570335,Villars-sous-Champvent,,0.000026,35,1,1,2,6197,6193,12390,21,0.108403,0.145986,191,0,0
8570339,"Moudon, La Prairie",,0.000101,13,5,2,7,5370,6408,11778,36,0.056764,0.073323,58046.669481,0,0
8570340,"Moudon, av. de Bussy",,0.000054,13,1,2,3,4952,4952,9904,35,0.059489,0.078036,55874.469481,0,0
8570341,"Moudon, Le Vallon",,0.000034,13,1,1,2,3117,3116,6233,34,0.055086,0.063642,33000,0,0
8570342,"Moudon, Belflori",,0.00004,13,1,1,2,3116,3116,6232,33,0.058231,0.068139,33593,0,0
8570343,"Rossenges, croisée",,0.000045,13,1,1,2,3116,3116,6232,32,0.061761,0.073524,34184,0,0
8570344,"Hermenches, Moille-Robert",,0.000049,13,1,1,2,3116,3116,6232,31,0.065752,0.080164,34773,0,0
8570345,"Hermenches, village",,0.000052,13,1,1,2,3116,3116,6232,30,0.070299,0.088731,35360,0,0
8570348,"Sottens, croisée",,0.000033,35,1,1,2,3600,3833,7433,27,0.064911,0.07473,33846.614286,0,0
8570349,"Sottens, Radio",,0.000039,35,1,1,2,3833,3600,7433,26,0.069253,0.080366,33976.614286,0,0
8570350,"Chapelle-sur-Moudon, Mulles",,0.000044,35,1,1,2,3600,3600,7200,25,0.07423,0.087236,34104.614286,0,0
8570352,"Thierrens, La Rapaz",,0.00008,35,2,1,3,6144,5972,12116,23,0.086741,0.10755,62178.34591,0,0
8579669,"Poliez-Pittet, collège",,0.000073,13,2,3,5,5487,3347,8834,17,0.126582,0.204078,3841.992857,0,0
8579760,"Yverdon, Zone industrielle sud",,0.000071,35,2,2,4,8234,5481,13715,17,0.126582,0.197412,748.9,0,0
8579239,"Epalinges, Croisettes",,0.000067,13,4,6,10,21899,87888,109787,21,0.103121,0.140665,65367.227178,0,0
8580485,"Echallens, collège/parc",,0.000084,35,3,4,7,4866,4722,9588,16,0.14121,0.235678,3273.22619,0,0
8570354,"Neyruz-sur-Moudon,Les Rutannes",,0.000034,13,1,1,2,1835,1835,3670,23,0.093191,0.11153,23185.469481,0,0
8570356,"Moudon, Grange-Verney",,0.000054,13,1,1,2,1456,1456,2912,31,0.054432,0.060666,2513.2,0,0
8570357,"Bussy-sur-Moudon,Foulaz-Verney",,0.000057,13,1,1,2,1456,1456,2912,30,0.057456,0.064067,2757.2,0,0
8570358,"Bussy-sur-Moudon, village",,0.000059,13,1,1,2,1456,1379,2835,29,0.060844,0.067958,2999.2,0,0
8570359,"Bussy-sur-Moudon, collège",,0.000061,13,1,1,2,1379,1379,2758,28,0.064663,0.072464,3239.2,0,0
8570360,"Bussy-sur-Moudon, La Cauderie",,0.000063,13,1,1,2,1379,1379,2758,27,0.069002,0.077756,3477.2,0,0
8570361,"Oulens-sur-Lucens, La Crausaz",,0.000064,13,1,1,2,1379,1379,2758,26,0.073975,0.084085,3713.2,0,0
8570362,"Oulens-sur-Lucens, village",,0.000066,13,1,1,2,1379,1379,2758,25,0.079732,0.091838,3947.2,0,0
8570363,"Villars-le-Comte, Le Chalet",,0.000067,13,1,1,2,1379,1379,2758,24,0.086475,0.101668,4179.2,0,0
8570364,"Villars-le-Comte, poste",,0.000068,13,1,1,2,1379,1379,2758,23,0.09448,0.114832,4409.2,0,0
8570379,"Praratoud, Laiterie",,0.000039,13,1,1,2,1109,1109,2218,23,0.09448,0.114832,4138.886291,0,0
8570370,"Denezy, collège",,0.000016,13,1,1,2,2461,2461,4922,26,0.070255,0.098306,26,0,0
8570371,"Thierrens, Carron",,0.000024,13,1,1,2,2461,2461,4922,25,0.074583,0.103245,89,0,0
8570400,"Payerne, Les Sorbiers",,0.000093,13,1,1,2,6390,3195,9585,22,0.09194,0.125578,898.666667,0,0
8570403,"Fétigny, Grange-des-Bois",,0.000111,13,1,2,3,4077,4077,8154,19,0.121107,0.186381,1387.666667,0,0
8577620,"Combremont-le-Grand, église",,0.000089,13,5,2,7,7393,7054,14447,8,0.258065,0.375074,476,0,0
8577621,"Montet (Broye), Petit Montet",,0.000049,13,1,2,3,5407,5370,10777,8,0.25,0.366746,4.5,0,0
8570376,"Villeneuve FR, Champs Abessaz",,0.000018,13,1,1,2,1037,1109,2146,26,0.073975,0.084085,3418.886291,0,0
8570377,"Surpierre, poste",,0.000026,13,1,1,2,1109,1109,2218,25,0.079732,0.091838,3660.886291,0,0
8570378,"Surpierre, école",,0.000033,13,1,1,2,1109,1109,2218,24,0.086475,0.101668,3900.886291,0,0
8570405,"Combremont-le-Grand, Le Garage",,0.000093,13,1,1,2,5014,5014,10028,17,0.136273,0.187021,2253,0,0
8570385,"Yvonand, dessus-du-village",,0.000031,13,3,1,4,2548,2548,5096,21,0.100097,0.128077,8634.828571,0,0
8570386,"Yvonand, Sur Priales",,0.000037,13,1,1,2,2548,2548,5096,20,0.110151,0.143934,8454.828571,0,0
8570389,"Champtauroz, église",,0.000062,13,2,1,3,5799,5799,11598,19,0.127714,0.175534,7769.828571,0,0
8570391,"Chêne-Pâquier, En Braye",,0.000047,13,2,1,3,2304,2304,4608,18,0.125,0.174329,466,0,0
8579735,"Gossens, La Cernia",,0.000044,35,2,1,3,1758,727,2485,16,0.135838,0.192515,37.333333,0,0
8570399,"Payerne, croisée de Cugy",,0.000097,13,4,1,5,9469,6390,15859,23,0.085253,0.116395,849.666667,0,0
8570401,"Fétigny, Les Sapelettes",,0.000126,13,3,1,4,4075,4077,8152,21,0.099861,0.137809,1885.666667,0,0
8570402,"Fétigny, Vers la Croix",,0.000118,13,1,1,2,4077,4077,8154,20,0.109399,0.155507,1637.666667,0,0
8570404,"Sassel, Chapalettaz",,0.000097,13,4,1,5,5014,5014,10028,18,0.121479,0.160542,2520,0,0
8570412,"Vallon, Musée romain",,0.000028,13,2,1,3,4423,8817,13240,32,0.072974,0.090793,11029.341359,0,0
8577641,Ressudens,,0.000026,126,2,1,3,4249,4394,8643,14,0.144482,0.165489,185.333333,0,0
8570416,"Chevroux, port",,0.000057,13,3,1,4,3143,3066,6209,4,0.4,0.486111,73,0,0
8577638,"Forel FR, Les Planches",,0.000053,13,1,1,2,6195,6195,12390,4,0.4,0.486111,1232,0,0
8570423,"Ferlens VD, Champ des Oches",,0.000049,13,1,3,4,6265,6265,12530,21,0.106378,0.137326,2163.866667,0,0
8570418,"Camorino, Centro Scolastico",,0.000019,108,1,1,2,17728,17728,35456,61,0.051057,0.083186,9175.833333,0,0
8570420,"Servion, poste/croisée",,0.000068,13,2,2,4,10082,10082,20164,24,0.086719,0.09992,10467.9,0,0
8570421,"Servion, Mannessivaz",,0.00004,13,1,1,2,6265,6265,12530,23,0.088076,0.104303,1373.866667,0,0
8570422,"Ferlens VD, Le Moulin",,0.000045,13,1,1,2,6265,6265,12530,22,0.096355,0.117582,1769.866667,0,0
8579237,"Lausanne, Ours",,0.000013,10,1,2,3,95635,97981,193616,19,0.113264,0.139484,192,0,0
8579249,"Pully, Monts-de-Pully",,0.000039,10,1,1,2,5847,5847,11694,10,0.169492,0.207738,475.933333,0,0
8570430,"Corcelles-le-Jorat, Le Torel",,0.000025,13,1,1,2,1965,1965,3930,14,0.139073,0.20905,125,0,0
8570431,"Corcelles-le-Jorat, village",,0.000032,13,1,1,2,1965,1965,3930,13,0.153846,0.228233,114,0,0
8570432,"Corcelles-le-Jt, Champ-la-Dame",,0.000038,13,1,1,2,1965,1965,3930,12,0.172727,0.257688,101,0,0
8587929,"Lausanne, Chalet-à-Gobet",,0.000141,13,3,4,7,55059,54335,109394,11,0.253731,0.379996,16495.10409,0,0
8588154,"Syens, Clos du Château",,0.00006,13,1,1,2,773,699,1472,11,0.181818,0.263742,147.266667,0,0
8570437,"Vuibroye, Champacot",,0.00004,13,1,1,2,3817,3656,7473,22,0.101497,0.117025,9945.033333,0,0
8570444,La Rogivue,,0.00004,13,1,3,4,3327,3187,6514,14,0.159004,0.215854,455.5,0,0
8570445,"La Rougève, village",,0.000022,13,1,3,4,1520,1520,3040,13,0.169772,0.231678,152,0,0
8570566,"Puidoux, Cité-de-Sully",,0.000053,13,1,1,2,3184,3184,6368,16,0.117284,0.199087,118,0,0
8570569,"Puidoux, village",,0.000067,13,1,1,2,2949,2949,5898,13,0.148148,0.248758,145,0,0
8579800,"Oron-la-Ville, gare routière",,0.000146,13,6,6,12,7553,5824,13377,12,0.194444,0.281226,22204.780952,0,0
8579251,"Forel (Lavaux), Cornes de Cerf",,0.000028,13,2,1,3,1555,1555,3110,12,0.16129,0.264288,34.833333,0,0
8582199,"Les Thioleyres, village",,0.000097,13,3,2,5,3217,3217,6434,12,0.163043,0.297621,448.333333,0,0
8570441,"Ecoteaux, Platta-Pierraz",,0.00002,13,1,1,2,3202,3327,6529,17,0.110682,0.135953,809.5,0,0
8570442,"Ecoteaux, laiterie",,0.000028,13,1,1,2,3327,3327,6654,16,0.12301,0.151824,693.5,0,0
8570443,"Maracon, bif.",,0.000034,13,1,1,2,3327,3327,6654,15,0.138614,0.174963,575.5,0,0
8570461,"Essertes, collège",,0.000051,13,1,1,2,3656,3817,7473,13,0.164557,0.210439,234,0,0
8579737,"Palézieux-Village, collège",,0.000055,13,1,1,2,277,277,554,13,0.164557,0.210439,1605.882937,0,0
8579741,"Bussigny-sur-Oron, collège",,0.000022,13,1,1,2,1044,1088,2132,13,0.164557,0.210439,0,0,0
8570450,Chesalles-sur-Oron,,0.000035,13,2,1,3,2417,2461,4878,24,0.080526,0.089315,1443,0,0
8570451,"Bussigny-sur-Oron, croisée",,0.000041,13,1,1,2,2461,2433,4894,23,0.087399,0.097795,1719,0,0
8570452,"St-Martin FR, village",,0.000045,13,1,1,2,2433,2389,4822,22,0.095574,0.10854,1993,0,0
8570453,"Fiaugères, En Saubaz",,0.000049,13,1,2,3,2389,2433,4822,21,0.105457,0.123136,2265,0,0
8570455,"Crêt-près-Semsales, Bremudens",,0.000049,13,2,1,3,5122,5122,10244,21,0.105092,0.120551,537.928571,0,0
8570456,"La Verrerie, village",,0.000074,13,2,1,3,7169,7169,14338,20,0.117191,0.138688,3138.928571,0,0
8577678,"Pont (Veveyse), village",,0.000065,13,1,1,2,5670,5670,11340,19,0.119858,0.137965,3170.071429,0,0
8570458,"Vuibroye, village",,0.000037,13,3,1,4,3626,3656,7282,16,0.113445,0.138099,618,0,0
8570459,"Châtillens, collège",,0.000043,13,1,1,2,3656,3656,7312,15,0.126382,0.153712,492,0,0
8570460,"Châtillens, Le Péleret",,0.000047,13,1,1,2,3656,3656,7312,14,0.142857,0.175755,364,0,0
8570476,"Villarzel, Le Cachet",,0.000067,13,1,1,2,3427,3427,6854,25,0.074241,0.086136,5636.369336,0,0
8577667,Chapelle (Glâne),,0.000024,13,1,1,2,335,335,670,22,0.088696,0.097925,0,0,0
8577674,"Bouloz, En Praz Vert",,0.000022,13,1,1,2,923,923,1846,22,0.088696,0.097925,84,0,0
8577679,"Oron-le-Châtel, La Chavanne",,0.000098,13,2,2,4,8238,8131,16369,18,0.135844,0.16298,6038,0,0
8577661,"Gillarens, bif. rte cantonale",,0.000055,13,1,2,3,11020,11026,22046,7,0.289474,0.425108,55,0,0
8577695,"Mossel, bif.",,0.000024,13,1,1,2,335,335,670,7,0.234043,0.314502,0,0,0
8577698,"Ursy, La Scie",,0.000084,13,1,3,4,12036,6158,18194,4,0.470588,0.614583,920.462771,0,0
8570467,"Billens, hôpital",,0.000025,13,2,3,5,7047,7155,14202,31,0.053461,0.071709,2621.866667,0,0
8577686,"Romont FR, Grand Rue",,0.000024,13,1,1,2,14063,14063,28126,8,0.283333,0.370658,0,0,0
8577694,"Prez-vers-Siviriez, Chaussets",,0.000044,13,1,1,2,1898,1898,3796,8,0.283333,0.370658,214,0,0
8577790,"Avry-sur-Matran, centre com.",,0.000048,126,4,6,10,28844,26031,54875,11,0.169954,0.231484,14097.391295,0,0
8573021,"Rhäzüns, Dorfplatz",,0.000045,109,1,1,2,8175,8175,16350,25,0.113233,0.143756,1351.333333,0,0
8574545,"Rodels, Dorf",,0.00003,109,1,1,2,1544,1544,3088,27,0.104371,0.128539,788,0,0
8574555,"Rothenbrunnen, Bahnhof",,0.000013,109,1,1,2,367,367,734,27,0.104371,0.128539,0,0,0
8570470,"Prévonloup, café",,0.000018,13,1,1,2,6322,6322,12644,30,0.05605,0.067394,2141.2,0,0
8570471,"Prévonloup, poste",,0.000026,13,1,1,2,6322,6322,12644,29,0.059245,0.073322,2079.2,0,0
8570474,"Cerniaz VD, La Croisée",,0.000064,13,3,1,4,3427,3427,6854,27,0.064915,0.073528,5802.369336,0,0
8570475,"Villarzel, Planche-Perte",,0.000066,13,1,1,2,3427,3427,6854,26,0.069261,0.079083,5720.369336,0,0
8582048,"Payerne, gymnase",,0.000072,13,1,2,3,2682,2682,5364,1,1,1,10,0,0
8570478,"Châtonnaye, Champ-des-Forches",,0.000071,13,3,1,4,3786,3786,7572,6,0.259259,0.37381,2575,0,0
8570479,"Châtonnaye, Les Beauregard",,0.000071,13,1,1,2,3786,3786,7572,5,0.3,0.413889,2066,0,0
8570480,"Trey, Les Folosses",,0.000071,13,1,1,2,3786,3786,7572,4,0.357143,0.466667,1555,0,0
8570481,"Trey, village",,0.000071,13,1,1,2,3786,2682,6468,3,0.444444,0.541667,1042,0,0
8570482,"Trey, Planche-à-Failly",,0.000072,13,1,1,2,2682,2682,5364,2,0.6,0.666667,527,0,0
8570484,"Romont FR, Les Rochettes-PAA",,0.000034,13,1,1,2,953,953,1906,23,0.085411,0.097585,6558.95267,0,0
8570488,"Prez-vers-Noréaz, Médecin",,0.000061,126,3,1,4,5271,5251,10522,21,0.095436,0.11023,6715.645151,0,0
8570489,"Prez-vers-Noréaz, scierie",,0.000062,126,1,1,2,5251,5251,10502,20,0.10525,0.124832,6605.645151,0,0
8575838,"Villarimboud, village",,0.000034,13,1,3,4,2391,2391,4782,18,0.138472,0.169802,20428.555507,0,0
8589170,"Villars-sur-Glâne, église",,0.000047,126,1,2,3,17825,17825,35650,2,0.666667,0.75,5965.956349,0,0
8589174,"Grolley, gare",,0.000045,126,2,1,3,5431,5412,10843,2,0.6,0.666667,24,0,0
8570493,"Villaz-St-Pierre, gare",,0.000059,13,4,3,7,8837,9130,17967,20,0.110536,0.131202,25985.99757,0,0
8570495,"Villaz-St-Pierre, bif.",,0.000028,13,1,1,2,3456,3396,6852,24,0.081017,0.103162,0,0,0
8570494,"Villaz-St-Pierre, Le Renaillé",,0.000028,13,1,1,2,2391,2391,4782,19,0.121899,0.142099,20560.555507,0,0
8570497,"Massonnens, Mottex",,0.000029,13,2,1,3,5918,5896,11814,19,0.118892,0.135627,43099.021627,0,0
8570498,"Massonnens, village",,0.000036,13,1,1,2,5896,5896,11792,18,0.134596,0.158386,42990.021627,0,0
8570499,"Cottens FR, gare",,0.000044,13,2,1,3,2242,2242,4484,17,0.083992,0.106127,216.5,0,0
8570500,"Autigny, En Verdau",,0.000048,13,1,1,2,2242,2242,4484,16,0.090615,0.113007,273.5,0,0
8570501,"Autigny, Le Bas",,0.000052,13,1,1,2,2242,2242,4484,15,0.098458,0.121508,328.5,0,0
8570502,"Estavayer-le-Gx,Les Planchette",,0.000055,13,1,1,2,2242,2242,4484,14,0.107895,0.132426,381.5,0,0
8570503,"Estavayer-le-Gibloux, école",,0.000058,13,1,1,2,2242,2242,4484,13,0.119469,0.147421,432.5,0,0
8570504,"Villarsel-le-Gibloux, village",,0.00006,13,1,2,3,2242,2242,4484,12,0.134003,0.171798,481.5,0,0
8577775,"Ecuvillens, église",,0.000057,13,4,4,8,18643,18685,37328,17,0.130522,0.184894,4413.218615,0,0
8580714,"Farvagny-le-Grand, CO Gibloux",,0.000075,13,4,3,7,4238,4180,8418,11,0.15251,0.201789,1659.674603,0,0
8573794,"Siebnen-Wangen, Bahnhof",,0.000149,67,7,5,12,29101,29151,58252,20,0.109489,0.153884,6620,0,0
8570506,"Balm b. Meiringen, Ey",,0.000011,114,0,1,1,0,2851,2851,38,0.053701,0.082706,0,0,0
8570507,"Cerniat FR, L'Adde",,0.000031,13,1,1,2,1527,1527,3054,20,0.079127,0.114218,467,0,0
8570508,"Cerniat FR, Les Riaux",,0.000037,13,1,1,2,1527,1527,3054,19,0.084444,0.121258,402,0,0
8570509,"La Valsainte, anc. poste",,0.000043,13,1,1,2,1527,1527,3054,18,0.090615,0.131229,335,0,0
8570510,"La Valsainte, Couvent",,0.000047,13,1,2,3,1527,1527,3054,17,0.097865,0.149938,266,0,0
8577753,"Crésuz, village",,0.000058,13,1,1,2,9919,9919,19838,17,0.097173,0.133271,5552,0,0
8577755,"Charmey (Gruyère), Le Chêne",,0.000079,13,1,2,3,11367,11404,22771,15,0.115974,0.16814,4686,0,0
8570519,"Constantine, collège",,0.000023,126,2,1,3,1103,1103,2206,31,0.07179,0.080003,0,0,0
8570522,"Vallamand-Dessous, village",,0.000048,126,1,3,4,4771,4771,9542,29,0.08361,0.097348,2521.5,0,0
8579745,"Salavaux, Cotterd",,0.000038,126,1,1,2,1103,1103,2206,7,0.25,0.344805,22,0,0
8579746,"Cudrefin, camping",,0.000061,117,2,2,4,5639,5639,11278,9,0.204506,0.238462,3080.666667,0,0
8579799,"Avenches, Collège Sous-Ville",,0.000016,126,1,1,2,1201,151,1352,7,0.25,0.344805,0,0,0
8583514,"Avenches, Bibracte",,0.000016,126,1,2,3,2814,2814,5628,6,0.3,0.415278,75.5,0,0
8570515,"Avenches, Haras Fédéral",,0.000016,117,1,1,2,2700,2700,5400,29,0.082877,0.092298,73121.227316,0,0
8570517,"Villars-le-Grand, village",,0.000025,117,1,1,2,2700,2700,5400,28,0.090254,0.101893,73772.227316,0,0
8570521,"Salavaux, poste",,0.000043,126,3,1,4,4771,4771,9542,30,0.077247,0.087369,1867.5,0,0
8570523,"Vallamand-Dessus, pl. village",,0.000024,117,1,1,2,2939,2939,5878,28,0.090254,0.101893,2678.5,0,0
8570524,"Bellerive VD, village",,0.000024,126,1,1,2,1103,1103,2206,9,0.188406,0.272833,308,0,0
8570525,"Montmagny, croisée",,0.000032,126,1,1,2,1103,1103,2206,8,0.214286,0.300893,166,0,0
8570526,"Chabrey, village",,0.000032,117,1,1,2,2700,2700,5400,27,0.099085,0.114095,74421.227316,0,0
8570527,Champmartin,,0.000038,117,1,1,2,2700,2700,5400,26,0.109845,0.130311,75068.227316,0,0
8570529,"Cudrefin, Vers-chez-Jacot",,0.000038,117,1,1,2,2939,2938,5877,26,0.109845,0.130311,3970.5,0,0
8570528,"Montet (Vully), village",,0.000032,117,1,1,2,2939,2939,5878,27,0.099085,0.114095,3325.5,0,0
8571595,"Innertkirchen, Winkel",,0.00003,114,1,1,2,266,266,532,32,0.055121,0.071763,1257,0,0
8595461,"Galmiz, Käserei",,0.00006,126,3,2,5,3068,1520,4588,2,0.75,0.833333,3493.333333,0,0
8570535,Luggiwil,,0.000024,126,2,2,4,8650,9339,17989,14,0.109432,0.129472,867.333333,0,0
8570536,"Düdingen, Schiffenen",,0.000021,126,1,1,2,4227,4227,8454,13,0.117463,0.132893,497.333333,0,0
8570537,"Düdingen, Staumauer/Camping",,0.000029,126,1,1,2,4227,4227,8454,12,0.132209,0.15061,628.333333,0,0
8570538,Kleinbösingen,,0.000035,126,1,1,2,4227,4227,8454,11,0.151329,0.176384,757.333333,0,0
8570544,"Ulmiz FR, Ausserdorf",,0.00002,126,1,1,2,3466,3466,6932,13,0.123308,0.142924,164,0,0
8570549,"Kerzers, Abzw. Gurzelen",,0.000039,126,3,1,4,3066,3068,6134,25,0.111575,0.137478,6347.333333,0,0
8593300,"Muntelier, Expodrom",,0.000036,126,1,1,2,31,31,62,3,0.5,0.583333,84.666667,0,0
8570551,Bundtels,,0.000021,126,1,1,2,5112,5112,10224,16,0.0938,0.107782,515,0,0
8570552,"Bösingen, Litzistorf",,0.000029,126,1,1,2,5112,5112,10224,15,0.102924,0.118579,673,0,0
8581331,"Ueberstorf, Hinterdorf",,0.000056,126,1,2,3,5110,418,5528,10,0.175241,0.204394,432,0,0
8570560,"Epesses, Crêt-Dessus",,0.00002,13,1,1,2,3306,3306,6612,22,0.084175,0.156231,1216,0,0
8570561,"Epesses, village",,0.000028,13,1,1,2,3306,3306,6612,21,0.088235,0.161577,1038,0,0
8570562,"Epesses, Chapotannaz",,0.000034,13,1,1,2,3306,3306,6612,20,0.092742,0.167435,858,0,0
8570563,"Chexbres, Bellevue",,0.00004,13,1,1,2,3306,3306,6612,19,0.097778,0.173916,676,0,0
8570564,"Chexbres-Village, gare",,0.000045,13,1,1,2,3306,3184,6490,18,0.103448,0.181173,492,0,0
8570565,"Chexbres, Les Pergolas",,0.000049,13,1,1,2,3184,3184,6368,17,0.10989,0.189438,306,0,0
8570567,"Puidoux, gare",,0.000064,13,2,1,3,3552,2949,6501,15,0.125874,0.210801,531,0,0
8570568,"Puidoux, Logis du Pont",,0.000066,13,1,1,2,2949,2949,5898,14,0.136,0.226028,339,0,0
8570581,"Villeneuve VD, gare",,0.000051,103,2,1,3,7584,7584,15168,18,0.101402,0.129389,380,0,0
8570582,"Noville, Pré des Fourches",,0.000054,103,1,2,3,7584,7584,15168,17,0.111645,0.147886,463,0,0
8570583,"Rennaz, centre commercial",,0.000034,103,1,1,2,2709,2709,5418,17,0.110577,0.138624,0,0,0
8570584,"Rennaz, hôpital",,0.000063,103,2,1,3,7584,7584,15168,16,0.122973,0.1573,623,0,0
8570588,"Noville, Crebelley",,0.000038,103,1,1,2,4875,4875,9750,14,0.133475,0.166301,467,0,0
8570589,"Chessel, Grand-Bois",,0.000043,103,1,1,2,4875,4875,9750,13,0.151589,0.191519,514,0,0
8570601,"Aigle, place du Marché",,0.000053,103,1,1,2,2709,2709,5418,8,0.227273,0.298036,626,0,0
8579061,"Monthey, gare CFF",,0.00012,103,4,5,9,5899,5951,11850,7,0.363636,0.493452,862,0,0
8570596,"Miex, Plan-du-Chêne",,0.000024,103,1,1,2,1147,1147,2294,6,0.285714,0.408333,126,0,0
8570598,"Miex, Membran",,0.000031,103,1,1,2,1147,1147,2294,5,0.333333,0.456667,110,0,0
8570599,"Miex, village",,0.000037,103,1,1,2,1147,1147,2294,4,0.4,0.520833,92,0,0
8570600,"Aigle, gare",,0.000148,103,5,3,8,6243,6243,12486,9,0.211268,0.288342,1426,0,0
8570607,"Ollon VD, gare",,0.000053,103,1,2,3,2059,2059,4118,7,0.25,0.370408,490,0,0
8570608,"Ollon VD, Le Moulin",,0.000033,103,1,1,2,325,325,650,6,0.285714,0.408333,216,0,0
8570609,Plan-d'Essert,,0.000039,103,1,1,2,325,325,650,5,0.333333,0.456667,185,0,0
8570610,"Ollon VD, Crettaz-Tavez",,0.000044,103,1,1,2,325,325,650,4,0.4,0.520833,152,0,0
8570611,"Panex, En Meer",,0.000048,103,1,1,2,325,325,650,3,0.5,0.611111,117,0,0
8570612,"Panex, Au Pomey rouge",,0.000052,103,1,1,2,325,323,648,2,0.666667,0.75,80,0,0
8570613,"Panex, La Croisée",,0.000055,103,1,1,2,323,325,648,1,1,1,41,0,0
8570616,"Vionnaz, croisée d'Illarsaz",,0.000053,103,1,1,2,1475,1475,2950,5,0.333333,0.420833,250,0,0
8580655,"Torgon, Les Foyards",,0.000062,103,1,2,3,1469,1469,2938,2,0.75,0.833333,15,0,0
8570618,"Château-d'Oex, gare",,0.000083,36,4,1,5,1006,1005,2011,12,0.150538,0.240791,66.5,0,0
8570620,"La Comballaz, Les Voëttes",,0.000095,36,2,1,3,831,831,1662,10,0.181818,0.274636,114,0,0
8570621,"La Comballaz, Le Pilet",,0.000092,36,1,1,2,831,831,1662,9,0.203704,0.298088,101,0,0
8570622,"Le Sépey, Aux Caudreys",,0.000089,36,1,1,2,831,831,1662,8,0.232558,0.330119,86,0,0
8570623,"Le Sépey, La Mosse",,0.000086,36,1,1,2,831,831,1662,7,0.272727,0.380688,69,0,0
8570631,"Leysin, télécabine Berneuse",,0.000081,36,1,1,2,932,694,1626,2,0.666667,0.75,52,0,0
8570626,"Cergnat, église",,0.000062,36,2,1,3,858,858,1716,7,0.25,0.370408,101,0,0
8570627,"Cergnat, Les Noisetiers",,0.000063,36,1,1,2,858,858,1716,6,0.285714,0.408333,78,0,0
8570628,"Cergnat, Pied de Crettaz",,0.000065,36,1,1,2,858,858,1716,5,0.333333,0.456667,53,0,0
8570630,"Leysin, place de la Tour d'Aï",,0.000082,36,2,1,3,932,932,1864,3,0.5,0.611111,83,0,0
8570649,"Les Plans-sur-Bex, Le Chamois",,0.000039,103,1,1,2,352,352,704,1,1,1,3,0,0
8579033,"Monthey-Ville, gare",,0.000104,103,5,3,8,6122,6163,12285,9,0.255474,0.349909,913,0,0
8579047,"Les Giettes, Cheseaux",,0.000064,103,1,1,2,545,545,1090,8,0.274725,0.336714,200,0,0
8579050,"Troistorrents, rte des Neyres",,0.000045,103,2,2,4,1133,1087,2220,8,0.284091,0.366714,47,0,0
8570639,"Bex, rte d'Aigle",,0.00003,103,1,1,2,519,519,1038,8,0.222222,0.339732,208,0,0
8570640,"Bex, Le Chavalet",,0.000037,103,1,1,2,519,519,1038,7,0.25,0.370408,189,0,0
8570641,"Bex, bif. Salaz",,0.000042,103,1,1,2,519,519,1038,6,0.285714,0.408333,168,0,0
8570642,"Bex, Les Dévens",,0.000047,103,1,1,2,519,519,1038,5,0.333333,0.456667,145,0,0
8570643,"Bex, Les Luisances",,0.000051,103,1,1,2,519,519,1038,4,0.4,0.520833,120,0,0
8570644,"Bex, Le Chêne",,0.000054,103,1,1,2,519,519,1038,3,0.5,0.611111,93,0,0
8570645,"Fenalet-sur-Bex, village",,0.000057,103,1,1,2,519,519,1038,2,0.666667,0.75,64,0,0
8570646,Le Bévieux,,0.000017,103,1,1,2,352,352,704,4,0.4,0.520833,81,0,0
8570647,"Bex, route des Monts bif.",,0.000026,103,1,1,2,352,352,704,3,0.5,0.611111,57,0,0
8570648,"Bex, Les Véneresses",,0.000033,103,1,1,2,352,352,704,2,0.666667,0.75,31,0,0
8570650,"St-Maurice VS, gare",,0.00002,37,1,3,4,1024,3846,4870,16,0.151899,0.304058,24,0,0
8570664,"St-Maurice VS, Terreaux",,0.000017,37,1,1,2,1107,1197,2304,4,0.333333,0.416667,0,0,0
8570651,"Massongex, les Palluds",,0.000017,37,1,1,2,1067,1024,2091,15,0.125,0.221215,30,0,0
8570652,"Massongex, gare",,0.000025,37,1,1,2,1024,1024,2048,14,0.133333,0.232254,42,0,0
8570653,"Massongex, Fontany",,0.000032,37,1,1,2,1024,1024,2048,13,0.142857,0.244626,52,0,0
8570654,"Massongex, Le Moulin",,0.000038,37,1,1,2,1024,1024,2048,12,0.153846,0.258601,60,0,0
8570655,"Daviaz, La Vorpillière",,0.000043,37,1,1,2,1024,1024,2048,11,0.166667,0.274534,66,0,0
8570656,"Daviaz, Vers-chez-Combe",,0.000048,37,1,1,2,1024,1024,2048,10,0.181818,0.292897,70,0,0
8570658,"Daviaz, village",,0.000052,37,1,1,2,1024,1066,2090,9,0.2,0.31433,72,0,0
8570659,"Vérossaz, Les Bassex",,0.000055,37,1,1,2,1066,1066,2132,8,0.222222,0.339732,72,0,0
8570660,"Vérossaz, Les Haussex",,0.000057,37,1,1,2,1066,1066,2132,7,0.25,0.370408,70,0,0
8570661,"Vérossaz, Chavanne",,0.00006,37,1,1,2,1066,1066,2132,6,0.285714,0.408333,66,0,0
8570662,"Vérossaz, La Doey village",,0.000062,37,1,1,2,1066,1066,2132,5,0.333333,0.456667,60,0,0
8570663,"Vérossaz, La Doey place",,0.000063,37,1,1,2,1066,1066,2132,4,0.4,0.520833,52,0,0
8570666,"Lavey-Village, centre",,0.000031,37,2,1,3,2869,2847,5716,3,0.428571,0.5,18,0,0
8570667,"Lavey-Village, Prés Râpets",,0.000037,37,1,2,3,2847,2847,5694,2,0.625,0.7,20,0,0
8570668,"Lavey-les-Bains, place",,0.000027,37,1,1,2,2289,2409,4698,2,0.571429,0.625,0,0,0
8570669,"Lavey-les-Bains, Et. Thermal",,0.000049,37,2,3,5,2967,2369,5336,1,1,1,18,0,0
8579685,"St-Maurice VS, Clinique St-Amé",,0.000025,37,1,1,2,472,460,932,2,0.666667,0.75,0,0,0
8580651,"Lavey, Front Bastionné",,0.000046,37,2,1,3,2277,1212,3489,1,1,1,1,0,0
8570696,"Sion, Corbassière",,0.000035,39,3,1,4,10041,9902,19943,24,0.084466,0.106434,359,0,0
8570697,"Pont-de-la-Morge, Mont d'Or",,0.00004,39,1,2,3,9902,9902,19804,23,0.091729,0.12029,494,0,0
8570699,"Conthey, bif. Conthey-Plan",,0.000035,39,1,1,2,9237,9237,18474,23,0.090813,0.112925,171,0,0
8570698,"Pont-de-la-Morge, centre",,0.000028,39,1,1,2,9712,9237,18949,24,0.083698,0.102827,40,0,0
8570700,"Vétroz, Champs-y-Zou",,0.000058,39,2,1,3,9427,9902,19329,22,0.099299,0.126369,887,0,0
8571003,"Fully, Stade de Charnot",,0.000069,39,2,3,5,7295,7297,14592,21,0.109128,0.160346,1137.666667,0,0
8571006,Châtaignier,,0.000042,39,1,1,2,7107,7107,14214,21,0.10605,0.140006,312,0,0
8573907,"Ardon, Arnica",,0.000059,39,3,4,7,10329,9898,20227,16,0.1625,0.224885,3307.719048,0,0
8579392,"Chamoson, Palud",,0.000041,39,2,3,5,7361,7765,15126,17,0.152253,0.21144,857.5,0,0
8580818,"Sion, Clinique",,0.000208,39,7,9,16,27915,27107,55022,17,0.164659,0.26118,10615.190476,0,0
8570703,Magnot,,0.000028,39,1,1,2,10453,9978,20431,19,0.130367,0.171263,2025.5,0,0
8571002,"Fully, La Forêt",,0.000062,39,1,1,2,7259,7259,14518,22,0.098949,0.132925,800,0,0
8570721,"Premploz, village",,0.00002,38,1,1,2,2241,2241,4482,4,0.4,0.520833,4,0,0
8570722,"Daillon, la Vella",,0.000028,38,1,1,2,2241,2241,4482,3,0.5,0.611111,6,0,0
8570723,"Daillon, la Chapelle",,0.000035,38,1,1,2,2241,2241,4482,2,0.666667,0.75,6,0,0
8570733,"Sion, école d'infirmières",,0.000015,39,1,1,2,109,109,218,34,0.051103,0.062695,0,0,0
8570788,"Botyre (Ayent), bif. Blignou",,0.000045,39,1,1,2,3872,3872,7744,22,0.097407,0.125488,4103,0,0
8570789,"Botyre (Ayent), Le Creux",,0.000053,39,2,3,5,4964,5175,10139,21,0.107531,0.149232,4684.458333,0,0
8570790,"St-Romain (Ayent), centre",,0.000026,39,1,1,2,928,950,1878,21,0.121479,0.157302,0,0,0
8570786,"Grimisuat, Home les Crêtes",,0.000137,39,3,4,7,6128,5016,11144,24,0.094604,0.140501,7050,0,0
8579485,"Lens, centre d'art",,0.000067,39,2,4,6,9689,9450,19139,17,0.146182,0.204987,6750.166667,0,0
8579508,"Sion, Place du Midi",,0.000138,39,6,7,13,32135,32135,64270,14,0.198413,0.291836,11094.452381,0,0
8579877,"Grimisuat, Rte de Savièse",,0.000076,39,2,2,4,1418,1198,2616,18,0.143349,0.199928,314,0,0
8580671,"La Place (Ayent), Rougenan",,0.000067,39,1,1,2,1016,570,1586,18,0.142365,0.193476,1364,0,0
8580674,"Arbaz, Pré-du-Loup",,0.000043,39,1,2,3,996,394,1390,18,0.142693,0.198853,3,0,0
8580814,"Sion, Planta",,0.000128,39,8,2,10,15620,15185,30805,16,0.162092,0.222531,6755.952381,0,0
8570734,"Sion, Mont d'Orge",,0.000028,39,2,1,3,1046,1046,2092,33,0.053681,0.066128,439,0,0
8570735,"Savièse, La Muraz",,0.000034,39,1,1,2,1046,1046,2092,32,0.056541,0.070174,705,0,0
8570736,"Savièse, Crettaz-di-Railles",,0.00004,39,1,1,2,1046,1046,2092,31,0.059734,0.075082,969,0,0
8570738,"Savièse, Etang de la Tzena",,0.000055,39,2,2,4,1128,1131,2259,29,0.067378,0.090551,1797.25,0,0
8570741,"Savièse, Zampelet",,0.00004,39,1,1,2,1336,1336,2672,29,0.0668,0.085345,314.25,0,0
8570740,"Savièse, Pradoumaye",,0.000034,39,2,1,3,1260,1336,2596,30,0.062813,0.078569,60.25,0,0
8570744,"Savièse, Zambotte",,0.000036,39,2,1,3,59,59,118,17,0.107143,0.19479,84,0,0
8570756,"Tripon, bisse du Torrent-Neuf",,0.000042,39,1,1,2,59,59,118,16,0.113333,0.203068,94,0,0
8570757,Coppet (Conthey),,0.000046,39,1,1,2,59,59,118,15,0.120301,0.212197,102,0,0
8570758,Plan-Cernet,,0.00005,39,1,1,2,59,59,118,14,0.128205,0.222326,108,0,0
8570759,Grand-Zour,,0.000054,39,1,1,2,59,59,118,13,0.137255,0.233646,112,0,0
8570760,"Savièse, Roua",,0.000056,39,1,1,2,59,59,118,12,0.147727,0.246401,114,0,0
8570761,"Savièse, Vouagno",,0.000059,39,1,1,2,59,59,118,11,0.16,0.260916,114,0,0
8570762,"Savièse, Dilogne",,0.000061,39,1,1,2,59,59,118,10,0.174603,0.277633,112,0,0
8570763,"Savièse, Visse",,0.000063,39,1,1,2,59,59,118,9,0.192308,0.297183,108,0,0
8570764,"Savièse, Sur-le-Scex",,0.000064,39,1,1,2,59,59,118,8,0.214286,0.320503,102,0,0
8570765,"Savièse, Plan-d'Agy",,0.000065,39,1,1,2,59,59,118,7,0.242424,0.349107,94,0,0
8570767,"Sanetsch, hôtel",,0.000076,39,2,1,3,118,118,236,5,0.333333,0.436111,114,0,0
8570768,"Savièse, Tsanfleuron",,0.000076,39,1,1,2,118,118,236,4,0.416667,0.516667,100,0,0
8570769,"Savièse, Senin",,0.000075,39,1,2,3,118,59,177,3,0.571429,0.708333,84,0,0
8570771,"Sion, Pont-sur-la-Sionne",,0.000039,39,1,1,2,3952,3952,7904,29,0.065134,0.079762,200,0,0
8570772,"Grimisuat, Les Places",,0.000044,39,1,1,2,3952,3952,7904,28,0.069431,0.086013,438,0,0
8570773,Champlan,,0.000048,39,1,1,2,3952,3952,7904,27,0.074352,0.093779,674,0,0
8570774,Les Combes-sur-Sion,,0.000052,39,1,1,2,3952,3952,7904,26,0.080045,0.103826,908,0,0
8570775,"Grimisuat, anc. poste",,0.000055,39,1,1,2,3952,3952,7904,25,0.086705,0.117756,1140,0,0
8570780,"Arbaz, Planèje",,0.000081,39,2,2,4,2219,2176,4395,25,0.087458,0.122895,4710,0,0
8570784,"Arbaz, café du Lac",,0.000053,39,1,1,2,1940,1940,3880,25,0.086705,0.117756,570,0,0
8570776,"Grimisuat, Zoudâne",,0.000072,39,3,1,4,2094,2176,4270,27,0.075316,0.097709,3758,0,0
8570777,"Grimisuat, Zegeard-Valan",,0.000072,39,1,2,3,2176,2176,4352,26,0.081172,0.11092,3999,0,0
8570779,"Arbaz, Onna",,0.000046,39,1,1,2,2139,2139,4278,26,0.080681,0.106497,289,0,0
8570778,"Arbaz, bif. Blignou",,0.000042,39,1,1,2,2096,2139,4235,27,0.074897,0.09551,52,0,0
8570781,"Arbaz, Prozerbou",,0.000045,39,1,1,2,1940,1940,3880,27,0.074352,0.093779,110,0,0
8570782,"Arbaz, Barra",,0.000049,39,1,1,2,1940,1940,3880,26,0.080045,0.103826,341,0,0
8575519,"Anzère, télécabine",,0.00004,39,1,2,3,725,996,1721,19,0.127127,0.169786,64,0,0
8570787,"Blignou (Ayent), Promanson",,0.00004,39,1,1,2,3872,3872,7744,23,0.089052,0.110417,3889,0,0
8570807,"Luc (Ayent), centre",,0.000026,39,1,2,3,4085,4085,8170,22,0.072666,0.091574,2161.458333,0,0
8582582,"Icogne, Les Vernasses",,0.000056,39,3,2,5,3943,3872,7815,1,1,1,192.5,0,0
8582583,"Grimisuat, Les Fermes",,0.000054,39,2,1,3,1995,1926,3921,1,1,1,81.875,0,0
8570808,"Icogne, Prasserin",,0.000022,39,1,1,2,3872,3872,7744,21,0.077796,0.09414,2277,0,0
8570809,"Icogne, village",,0.00003,39,1,1,2,3872,3980,7852,20,0.083919,0.103035,2400,0,0
8570825,"Lens, Oasis",,0.00004,39,1,1,2,1378,1378,2756,15,0.121127,0.170332,86,0,0
8570812,"Lens, Les Rosiers",,0.000022,39,1,1,2,4111,4111,8222,17,0.094008,0.107453,2885,0,0
8570813,"Lens, La Trionnaz",,0.00003,39,1,1,2,4111,4109,8220,16,0.103193,0.118033,2993,0,0
8570816,"Crans-s.-S., Essampilles",,0.00005,39,2,1,3,8736,8736,17472,14,0.1285,0.15004,3217,0,0
8579484,"Lens, bif.",,0.000067,39,1,2,3,8785,8785,17570,18,0.131776,0.170889,5733,0,0
8570823,"Granges VS, Pissiour",,0.000027,39,2,1,3,1378,1378,2756,17,0.101351,0.142618,146,0,0
8570824,"Lens, Vaas-d'en-Bas",,0.000034,39,1,1,2,1378,1378,2756,16,0.110276,0.154054,117,0,0
8570826,"Flanthey, Chelin",,0.000056,39,2,2,4,1453,1453,2906,14,0.134615,0.199348,562,0,0
8580235,"Flanthey, rte de Valençon",,0.000035,39,1,2,3,1378,1378,2756,13,0.151292,0.225465,225,0,0
8570829,"Sion, Molignon",,0.000022,39,1,1,2,1092,1092,2184,28,0.062155,0.079159,759,0,0
8570830,"Signèse (Ayent), Plan Signèse",,0.00003,39,1,1,2,1092,1092,2184,27,0.065783,0.083108,824,0,0
8570831,"Signèse (Ayent), Les Granges",,0.000036,39,1,1,2,1092,1092,2184,26,0.06989,0.087751,887,0,0
8570832,"Signèse (Ayent), chapelle",,0.000042,39,1,1,2,1092,1092,2184,25,0.074576,0.093365,948,0,0
8570833,"Argnou (Ayent), Les Frisses",,0.000046,39,1,1,2,1092,1092,2184,24,0.079976,0.100542,1007,0,0
8570834,"Argnou (Ayent), centre",,0.00005,39,1,2,3,1092,1092,2184,23,0.086264,0.111516,1064,0,0
8580224,"Botyre (Ayent), La Croisée",,0.000032,39,1,2,3,930,950,1880,22,0.093614,0.120334,522,0,0
8570835,"Sion, Ateliers St-Hubert",,0.000027,39,2,1,3,1232,1232,2464,10,0.153846,0.230357,602,0,0
8570837,"Sion, Les Iles Est",,0.000085,39,2,1,3,7064,7064,14128,8,0.191781,0.267517,652,0,0
8570838,"Sion, Tennis Iles",,0.000083,39,1,1,2,7064,7064,14128,7,0.220339,0.296337,618,0,0
8570839,"Sion, Camping des Iles",,0.000082,39,1,1,2,7064,7064,14128,6,0.26087,0.341667,582,0,0
8570841,"Aproz, rte de Coor",,0.000045,39,1,1,2,1198,1198,2396,6,0.25,0.331667,204,0,0
8570842,"Aproz, bif. Bieudron",,0.000049,39,1,1,2,1198,1198,2396,5,0.3,0.377778,162,0,0
8570843,"Fey (Nendaz), Moralla",,0.000053,39,1,1,2,1198,1198,2396,4,0.380952,0.458333,118,0,0
8570848,Condémines,,0.000076,39,1,2,3,499,499,998,2,0.75,0.833333,159,0,0
8570846,"Fey (Nendaz), Les Tsejas",,0.000077,39,4,1,5,499,499,998,4,0.384615,0.483333,265,0,0
8570847,"Fey (Nendaz), Les Bans",,0.000076,39,1,1,2,499,499,998,3,0.5,0.583333,213,0,0
8581400,"Sion, Pénitencier",,0.000071,39,1,1,2,1232,440,1672,1,1,1,6,0,0
8570850,"Haldenstein, Usserdorfstrasse",,0.000011,109,0,1,1,0,15005,15005,27,0.077101,0.089173,0,0,0
8570851,"Sion, Les Fournaises",,0.000017,39,1,1,2,4085,4085,8170,25,0.084633,0.100552,796,0,0
8570852,"Salins, Le Parfait",,0.000025,39,1,1,2,4085,4085,8170,24,0.092032,0.110533,976,0,0
8570853,"Salins, Turin",,0.000032,39,1,1,2,4085,4085,8170,23,0.100892,0.123631,1154,0,0
8570854,"Salins, La Courtaz",,0.000038,39,1,1,2,4085,4085,8170,22,0.111691,0.142084,1330,0,0
8570874,"Clèbes (Nendaz), village",,0.000042,39,3,1,4,1083,1083,2166,21,0.122425,0.157843,19.166667,0,0
8570856,"Baar (Nendaz), village",,0.00002,39,1,1,2,1087,1087,2174,24,0.09087,0.108249,121,0,0
8570857,"Brignon (Nendaz), village",,0.000028,39,1,1,2,1087,1087,2174,23,0.099481,0.120323,291,0,0
8570876,"Salins, Pravidondaz",,0.000033,39,2,1,3,2998,2998,5996,27,0.071478,0.08438,329,0,0
8570877,"Salins, Misériez",,0.000039,39,1,1,2,2998,2998,5996,26,0.076607,0.090304,487,0,0
8570878,"Salins, village",,0.000044,39,1,1,2,2998,2998,5996,25,0.082558,0.09744,643,0,0
8570879,"Les Agettes,s Crettaz-à-l'Oeil",,0.000048,39,1,1,2,2998,2998,5996,24,0.089546,0.106228,797,0,0
8570880,"Les Agettes, Stade US",,0.000052,39,1,1,2,2998,2998,5996,23,0.097868,0.117382,949,0,0
8570881,"Les Agettes, Crettaz-à-l'Oeil",,0.000055,39,1,1,2,2998,2998,5996,22,0.107948,0.132153,1099,0,0
8570882,La Vernaz VS,,0.000058,39,1,1,2,2998,2998,5996,21,0.120409,0.153095,1247,0,0
8570885,"Les Agettes, village",,0.000039,39,2,1,3,2563,2507,5070,22,0.106717,0.129591,168,0,0
8570886,"Les Agettes, Les Crêtes",,0.000044,39,1,1,2,2507,2507,5014,21,0.11886,0.148991,308,0,0
8570890,"Sion, Stand de tir",,0.000035,39,1,2,3,9026,9026,18052,18,0.134783,0.171604,3064,0,0
8576587,"Chamoson, poste",,0.000031,39,1,2,3,7765,7765,15530,16,0.15783,0.203399,128,0,0
8570891,"Bramois, La Crettaz",,0.000026,39,1,1,2,7020,7020,14040,23,0.087302,0.11058,2995,0,0
8570893,"Vex, Sindy",,0.000033,39,1,1,2,7020,7020,14040,22,0.094928,0.122715,3023,0,0
8570894,"Vex, poste",,0.000039,39,1,2,3,7020,7020,14040,21,0.104083,0.141861,3049,0,0
8577418,"Evolène, La Fauchère",,0.000059,39,1,1,2,2469,2469,4938,21,0.104712,0.13807,708,0,0
8570895,"Vex, Le Villard",,0.000027,39,1,1,2,2469,2469,4938,29,0.06193,0.081028,1529,0,0
8570896,"Euseigne, Les Grangettes",,0.000034,39,1,1,2,2469,2469,4938,28,0.065507,0.085233,1551,0,0
8570897,"Euseigne, Pont de Sauterot",,0.00004,39,1,1,2,2469,2469,4938,27,0.069551,0.090205,1571,0,0
8570898,"Euseigne, Pyramides d'Euseigne",,0.000045,39,1,1,2,2469,2469,4938,26,0.074161,0.09621,1589,0,0
8570899,"Euseigne, bif. Mâche",,0.000049,39,1,1,2,2469,2469,4938,25,0.079466,0.103675,1605,0,0
8570900,La Luette,,0.000053,39,1,1,2,2469,2469,4938,24,0.085635,0.11336,1619,0,0
8570903,"Evolène, La Villettaz",,0.000038,39,1,1,2,2469,2469,4938,27,0.067259,0.088366,798,0,0
8570904,"Evolène, Les Flantzes",,0.000043,39,1,1,2,2469,2469,4938,26,0.071429,0.092971,788,0,0
8570905,"Evolène, Route de Lannaz",,0.000047,39,1,1,2,2469,2469,4938,25,0.07619,0.098418,776,0,0
8570906,La Tour,,0.000051,39,1,1,2,2469,2469,4938,24,0.081681,0.104989,762,0,0
8570907,"Les Haudères, Molignon",,0.000054,39,1,1,2,2469,2468,4937,23,0.088083,0.113132,746,0,0
8570908,"Les Haudères, Praz do Lauc",,0.000057,39,1,1,2,2468,2469,4937,22,0.095644,0.123624,728,0,0
8570909,"Les Haudères, Pralovin",,0.000023,39,1,1,2,1349,1347,2696,9,0.2,0.31433,54,0,0
8570910,"Les Haudères, Farquèses",,0.00003,39,1,1,2,1347,1349,2696,8,0.222222,0.339732,56,0,0
8570911,"Les Haudères, La Coutaz",,0.000037,39,1,1,2,1349,1349,2698,7,0.25,0.370408,56,0,0
8570912,"Arolla, La Gouille",,0.000042,39,1,1,2,1349,1349,2698,6,0.285714,0.408333,54,0,0
8570913,"Arolla, Satarma",,0.000047,39,1,1,2,1349,1349,2698,5,0.333333,0.456667,50,0,0
8570914,"Arolla, Pramousse",,0.00005,39,1,1,2,1349,1349,2698,4,0.4,0.520833,44,0,0
8570915,"Arolla, La Monta",,0.000054,39,1,1,2,1349,1349,2698,3,0.5,0.611111,36,0,0
8570916,"Arolla, Magine",,0.000057,39,1,1,2,1349,1349,2698,2,0.666667,0.75,26,0,0
8570918,"La Sage, Taillau",,0.000048,39,2,2,4,3659,3303,6962,3,0.555556,0.666667,40,0,0
8570920,"La Sage, Borza",,0.000038,39,1,1,2,2974,1140,4114,3,0.5,0.611111,3,0,0
8570919,"La Sage, Plan de la Sage",,0.000031,39,1,1,2,2964,2974,5938,4,0.4,0.520833,9,0,0
8570921,"La Sage, Col-de-la-Forclaz",,0.000063,39,2,1,3,1479,179,1658,2,0.666667,0.75,22,0,0
8570922,"La Sage, Sépey",,0.000065,39,1,1,2,179,179,358,1,1,1,12,0,0
8570926,"Nax, Creux-de-Nax",,0.000032,39,1,1,2,2006,2006,4012,23,0.090909,0.116178,2478,0,0
8570927,"Nax, Erbioz",,0.000038,39,1,1,2,2006,2006,4012,22,0.099115,0.128482,2486,0,0
8581101,"Suen, Les Grands Praz",,0.000059,39,1,3,4,1975,1975,3950,20,0.11125,0.16274,273.833333,0,0
8581565,"Eison, La Crettaz",,0.000055,39,2,2,4,1853,1800,3653,20,0.109296,0.151155,265.166667,0,0
8581781,"Nax, La Crettaz",,0.000041,39,1,2,3,2222,2103,4325,20,0.110127,0.154987,257,0,0
8570930,"Mase, village",,0.000025,39,1,1,2,1975,1975,3950,24,0.084677,0.112758,1536,0,0
8570931,"Mase, La Fougère",,0.000032,39,1,1,2,1975,1975,3950,23,0.09163,0.124285,1532,0,0
8570933,"St-Martin VS, poste",,0.000075,39,3,3,6,2162,2564,4726,21,0.109914,0.172185,2478,0,0
8570934,"St-Martin VS, centre",,0.000032,39,1,4,5,2124,2244,4368,21,0.109189,0.17389,248,0,0
8570936,"Eison, village",,0.000033,39,2,2,4,1855,1800,3655,21,0.107726,0.160568,102.833333,0,0
8574193,"Eison, Proveric",,0.00004,39,2,3,5,1855,1800,3655,21,0.103911,0.157666,355.166667,0,0
8570935,"Trogne, centre",,0.000018,39,1,1,2,1719,1774,3493,22,0.098135,0.13567,0,0,0
8574113,"St-Martin VS, église",,0.000053,39,3,3,6,1966,2021,3987,20,0.117788,0.176536,1843.333333,0,0
8570937,"Vernamiège, bif.",,0.000028,39,2,3,5,2222,4097,6319,22,0.09375,0.144078,344,0,0
8570938,"Vernamiège, village",,0.000019,39,1,1,2,1397,2103,3500,22,0.092037,0.121165,0,0,0
8579422,"Granges VS, Crêtelongue",,0.00003,39,1,1,2,7184,7184,14368,18,0.12,0.147742,255,0,0
8579408,Daillet,,0.000041,39,1,1,2,1649,1649,3298,12,0.175439,0.264387,80,0,0
8579426,"Grône, Croix du Pont",,0.000052,39,2,2,4,7567,7564,15131,17,0.135307,0.174654,1598,0,0
8588515,"Granges VS, Grand Canal",,0.000156,39,3,2,5,10042,8664,18706,12,0.169565,0.255242,7150.833333,0,0
8570947,"Sierre, Glarey",,0.000053,39,3,2,5,16733,24622,41355,21,0.091722,0.148343,3689.966667,0,0
8579474,"Sierre, Beau-Site",,0.000026,39,2,2,4,12931,12931,25862,19,0.082251,0.115294,1459.5,0,0
8570949,"Grimentz, télécabine",,0.000089,39,3,4,7,3159,3159,6318,3,0.5625,0.685185,126,0,0
8570954,"Zinal, Le Bouillet",,0.000036,39,1,1,2,302,302,604,4,0.4,0.520833,4,0,0
8581942,"Moiry VS, glacier",,0.000061,39,2,1,3,414,414,828,3,0.5,0.611111,6,0,0
8582215,"Grimentz, Les Fioz",,0.000042,39,1,1,2,2468,56,2524,3,0.5,0.611111,6,0,0
8570953,"Ayer, Les Morasses",,0.00003,39,1,1,2,302,302,604,5,0.333333,0.456667,15,0,0
8570955,"St-Luc, Zattelet",,0.000018,39,1,1,2,2468,2336,4804,8,0.222222,0.339732,40,0,0
8570956,"St-Luc, Beausite",,0.000026,39,1,1,2,2336,2336,4672,7,0.25,0.370408,42,0,0
8570957,"St-Luc, Bella Tola",,0.000033,39,1,1,2,2336,2394,4730,6,0.285714,0.408333,42,0,0
8570958,"St-Luc, La Forêt",,0.000039,39,1,1,2,2394,2336,4730,5,0.333333,0.456667,40,0,0
8570959,"Chandolin, télésiège",,0.000044,39,1,1,2,2336,2395,4731,4,0.4,0.520833,36,0,0
8570960,"Martigny-Ville, poste",,0.000017,39,1,2,3,2429,2429,4858,17,0.117773,0.173252,45,0,0
8570964,Le Brocard,,0.000018,39,1,1,2,1147,1147,2294,16,0.10793,0.142398,38,0,0
8570965,Les Rappes VS,,0.000026,39,1,1,2,1147,1147,2294,15,0.118519,0.153938,80,0,0
8570966,"Martigny-Combe,Pied-du-Château",,0.000033,39,1,1,2,1147,1147,2294,14,0.131653,0.169345,120,0,0
8570969,"Le Fays, bif.",,0.000043,39,2,1,3,847,847,1694,12,0.1673,0.21306,48,0,0
8570970,"Ravoire, bif. La Forclaz",,0.00007,39,2,2,4,1994,1994,3988,11,0.196347,0.263558,363,0,0
8570974,"Ravoire, Le Feylet",,0.000053,39,1,1,2,1146,1147,2293,11,0.186603,0.23717,117,0,0
8570971,"Ravoire, Planojean",,0.000041,39,1,1,2,1147,1147,2294,14,0.126506,0.163485,48,0,0
8570972,"Ravoire, Cretex",,0.000045,39,1,1,2,1147,1147,2294,13,0.141379,0.179635,73,0,0
8570973,"Ravoire, hôtel",,0.00005,39,1,1,2,1147,1146,2293,12,0.160643,0.202283,96,0,0
8570975,"Martigny-Croix, croisée",,0.000086,39,2,2,4,1994,1994,3988,10,0.223529,0.302391,478,0,0
8570983,"Trient, Le Peuty",,0.000076,39,3,3,6,1063,1063,2126,7,0.274336,0.365668,427.75,0,0
8570988,"La Caffe, hameau",,0.000053,39,2,1,3,236,236,472,7,0.254902,0.317399,46.666667,0,0
8570993,Chemin-Dessus,,0.000044,39,1,1,2,1282,1282,2564,7,0.254902,0.317399,130,0,0
8570977,"Martigny-Combe, sur-le-Scex",,0.000047,39,1,1,2,847,847,1694,12,0.128472,0.167774,183,0,0
8570978,Sommet-des-Vignes,,0.000051,39,1,1,2,847,847,1694,11,0.143426,0.183104,198,0,0
8570979,"Martigny-Combe, cont. Chanton",,0.000054,39,1,1,2,847,847,1694,10,0.162791,0.204286,211,0,0
8570980,"Martigny-Combe, Drapeau Suisse",,0.000057,39,1,1,2,847,847,1694,9,0.188889,0.236333,222,0,0
8570987,"Le Châtelard VS, Frontière",,0.000048,39,1,2,3,396,396,792,8,0.241071,0.321076,81,0,0
8570984,"Trient, rte de Litroz",,0.000032,39,1,1,2,396,396,792,11,0.150754,0.196484,84,0,0
8570985,Tête-Noire,,0.000038,39,1,1,2,396,396,792,10,0.171598,0.219321,85,0,0
8570986,"Le Châtelard VS, village",,0.000044,39,1,1,2,396,396,792,9,0.2,0.25445,84,0,0
8580543,"Martigny-Bourg, Pl. St-Michel",,0.000151,39,4,5,9,3276,3276,6552,6,0.328947,0.457333,821.416667,0,0
8570989,Chemin-Dessous,,0.000018,39,1,1,2,1282,1282,2564,11,0.138889,0.183574,50,0,0
8570990,"Chemin, Ecotteaux bif.",,0.000026,39,1,1,2,1282,1282,2564,10,0.155914,0.200246,73,0,0
8570991,"Chemin, contour du Botzaz",,0.000033,39,1,1,2,1282,1282,2564,9,0.178344,0.223285,94,0,0
8570992,"Chemin, Trois Limites",,0.000039,39,1,1,2,1282,1282,2564,8,0.209302,0.257848,113,0,0
8570997,"Martigny, Portes du Rhône",,0.000048,39,4,1,5,7661,7259,14920,27,0.067845,0.08445,235,0,0
8570998,Les Prises VS,,0.000051,39,1,1,2,7259,7259,14518,26,0.072342,0.090069,352,0,0
8570999,"Branson, La Colombière",,0.000055,39,1,1,2,7259,7259,14518,25,0.077508,0.096915,467,0,0
8571000,"Fully, Londzet",,0.000057,39,1,1,2,7259,7259,14518,24,0.083505,0.105518,580,0,0
8571001,"Fully, Le Carroz",,0.00006,39,1,1,2,7259,7259,14518,23,0.090551,0.116833,691,0,0
8571007,"Saxé, garage Gay",,0.000083,39,3,3,6,7215,7623,14838,20,0.117871,0.169477,2351.833333,0,0
8581192,"Conthey, centre commercial",,0.000083,39,1,4,5,9901,8816,18717,8,0.282051,0.434957,3206.009524,0,0
8581380,"Fully, Le Chenil",,0.000041,39,2,3,5,7033,7003,14036,8,0.265823,0.396145,351.05,0,0
8581446,"Leytron, Sommet du Village",,0.000052,39,3,2,5,7769,7765,15534,8,0.266667,0.382619,877.683333,0,0
8571004,"Fully, Creppier",,0.00003,39,1,1,2,7100,7107,14207,23,0.088466,0.110291,108,0,0
8571005,"Fully, Verdan",,0.000037,39,1,1,2,7107,7107,14214,22,0.096437,0.122567,211,0,0
8571009,La Sarvaz,,0.00004,39,1,1,2,7003,7003,14006,20,0.110789,0.139137,153,0,0
8571008,Grand-Blettay,,0.000035,39,1,1,2,7003,7003,14006,21,0.100326,0.123044,58,0,0
8571011,"Saillon, le Canal",,0.00004,39,1,1,2,7531,7538,15069,19,0.113109,0.143732,61,0,0
8582221,"Chamoson, cimetière",,0.000063,39,2,4,6,7412,7291,14703,7,0.315789,0.485317,619.866667,0,0
8582725,"Leytron, Pré d'Enclon",,0.000069,39,1,3,4,2553,305,2858,1,1,1,111,0,0
8584736,"Leytron, rte de Saillon",,0.000151,39,5,2,7,7162,915,8077,2,0.75,0.833333,594,0,0
8586431,"Leytron, route Romaine",,0.00003,39,1,1,2,145,145,290,2,0.666667,0.75,0,0,0
8571020,"Haldenstein, Schulhaus",,0.00002,109,1,1,2,15005,15103,30108,26,0.083403,0.09836,600,0,0
8571041,"Visp, Hohlegasse",,0.000022,40,3,1,4,2700,4594,7294,21,0.090909,0.108775,537,0,0
8571042,"Visp, Schlüsselacker",,0.00003,40,1,1,2,4594,4598,9192,20,0.09927,0.119078,654,0,0
8571043,"Visp, Untere Albe",,0.000036,40,1,1,2,4598,4598,9196,19,0.1094,0.132827,769,0,0
8571046,"Zeneggen, Klettergarten",,0.000032,40,2,1,3,2395,2406,4801,18,0.116683,0.140182,191,0,0
8571048,"Zeneggen, Kirche",,0.000046,40,2,1,3,2479,2624,5103,16,0.149497,0.190397,503,0,0
8580828,"Zeneggen, Wicherried",,0.000046,40,1,1,2,2177,2175,4352,3,0.5,0.611111,115,0,0
8581313,"Zeneggen, Schönegg",,0.000061,40,1,1,2,2176,2176,4352,1,1,1,3,0,0
8581315,"Bürchen, Hasel",,0.000033,40,1,1,2,3408,3408,6816,1,1,1,0,0,0
8571050,"Zeneggen, Alt Zeneggen",,0.000019,40,1,1,2,218,218,436,20,0.096296,0.115159,133,0,0
8571051,"Zeneggen, Mittlere Hellela",,0.000027,40,1,1,2,218,218,436,19,0.105647,0.125998,222,0,0
8571052,"Zeneggen, Saal",,0.000034,40,1,1,2,218,218,436,18,0.117108,0.14008,309,0,0
8571053,"Zeneggen, Obere Hellela",,0.00004,40,1,1,2,218,218,436,17,0.131488,0.159293,394,0,0
8571054,"Bürchen, Bethania",,0.000045,40,1,1,2,218,218,436,16,0.150066,0.187647,477,0,0
8571066,"Bürchen, Lischweide",,0.000032,40,1,1,2,1016,1016,2032,16,0.150066,0.187647,165,0,0
8571055,"Visp, Ried",,0.000029,40,1,1,2,3529,3529,7058,17,0.132905,0.162064,781,0,0
8571056,"Bürchen, Albenwald",,0.000035,40,1,2,3,3529,3523,7052,16,0.15204,0.194849,881,0,0
8571061,"Bürchen, Ibri",,0.000048,40,1,1,2,3408,3408,6816,16,0.148615,0.183755,472,0,0
8571057,"Bürchen, Obscha",,0.000026,40,1,1,2,3402,3408,6810,20,0.095611,0.113708,100,0,0
8571058,"Bürchen, Ackermatte",,0.000033,40,1,1,2,3408,3408,6816,19,0.104853,0.124336,196,0,0
8571059,"Bürchen, Zum Oberhüs",,0.000039,40,1,1,2,3408,3408,6816,18,0.116167,0.13808,290,0,0
8571060,"Bürchen, Schigarten",,0.000044,40,1,1,2,3408,3408,6816,17,0.13034,0.156689,382,0,0
8571063,"Bürchen, Ronalp",,0.000039,40,1,1,2,3140,3155,6295,17,0.13137,0.158137,243,0,0
8571064,"Bürchen, Bürchnerhof",,0.000044,40,1,1,2,3155,3159,6314,16,0.149935,0.185626,327,0,0
8571068,"Bürchen, Diebjen",,0.000032,40,1,1,2,1016,1016,2032,18,0.115505,0.137835,135,0,0
8571069,"Bürchen, Eischmatten",,0.000038,40,1,1,2,1016,1016,2032,17,0.129412,0.155692,200,0,0
8571070,"Bürchen, Bürchneralp",,0.000044,40,1,1,2,1016,1016,2032,16,0.147297,0.18123,263,0,0
8579562,"Niedergesteln, Gesch",,0.000046,40,1,2,3,10031,10031,20062,5,0.333333,0.398611,273,0,0
8579565,"Raron, Kanalstrasse",,0.000038,40,2,4,6,10876,10876,21752,4,0.415094,0.507576,118.75,0,0
8579557,"Steg VS, Hallenbad",,0.00003,40,1,1,2,9339,10036,19375,7,0.235294,0.280697,60,0,0
8571080,"Baltschieder, Hof",,0.000055,40,1,3,4,6054,6054,12108,9,0.259259,0.440164,641,0,0
8571089,"Ausserberg, Dorf",,0.00006,40,1,2,3,4206,4212,8418,3,0.555556,0.666667,40,0,0
8571076,"Visp, Kleegärten",,0.000038,40,2,1,3,5997,6054,12051,13,0.15,0.225351,845,0,0
8571077,"Visp, Fassji",,0.000043,40,1,1,2,6054,6054,12108,12,0.166667,0.245287,797,0,0
8571078,"Baltschieder, Kumme",,0.000048,40,1,1,2,6054,6054,12108,11,0.188235,0.274159,747,0,0
8571079,"Baltschieder, Dorf",,0.000051,40,1,1,2,6054,6054,12108,10,0.217391,0.323042,695,0,0
8581723,"Visp, Kulturzentrum La Poste",,0.000074,40,3,2,5,2721,2693,5414,3,0.571429,0.708333,274,0,0
8571081,"Ausserberg, Chronufluo",,0.000026,40,1,1,2,4212,4212,8424,11,0.152941,0.248538,560,0,0
8571082,"Ausserberg, Abzw. St. German",,0.000033,40,1,1,2,4212,4212,8424,10,0.166667,0.263757,502,0,0
8571083,"Ausserberg, Giblätt",,0.000039,40,1,1,2,4212,4212,8424,9,0.183333,0.28153,442,0,0
8571084,"Ausserberg, Brandenhütten",,0.000044,40,1,1,2,4212,4212,8424,8,0.204082,0.302738,380,0,0
8571085,"Ausserberg, Hohtenn",,0.000048,40,1,1,2,4212,4212,8424,7,0.230769,0.328836,316,0,0
8571086,"Ausserberg, Bahnhof",,0.000052,40,1,1,2,4212,4212,8424,6,0.266667,0.3625,250,0,0
8571087,"Ausserberg, Stapfa",,0.000055,40,1,1,2,4212,4212,8424,5,0.318182,0.409524,182,0,0
8571088,"Ausserberg, Distern",,0.000058,40,1,1,2,4212,4206,8418,4,0.4,0.486111,112,0,0
8571108,"Stalden VS, Weng",,0.000044,40,1,1,2,3142,3142,6284,19,0.09607,0.171792,110,0,0
8571109,"Stalden VS, Merjen",,0.000048,40,1,1,2,3142,3142,6284,18,0.101449,0.178394,125,0,0
8571110,"Stalden VS, Grossacker",,0.000052,40,1,1,2,3142,3142,6284,17,0.107527,0.18569,138,0,0
8571111,"Stalden VS, Mühlebach",,0.000055,40,1,1,2,3142,3142,6284,16,0.114458,0.193829,149,0,0
8571112,"Stalden VS, Walchgraben",,0.000057,40,1,1,2,3142,3142,6284,15,0.122449,0.203019,158,0,0
8571113,"Törbel, Oberbrunnen",,0.00006,40,1,1,2,3142,3142,6284,14,0.131783,0.213561,165,0,0
8571114,"Törbel, Bachtoli",,0.000062,40,1,1,2,3142,3142,6284,13,0.142857,0.225916,170,0,0
8571115,"Törbel, Unterflüh",,0.000063,40,1,1,2,3142,3142,6284,12,0.15625,0.240849,173,0,0
8571116,"Törbel, Burgen",,0.000065,40,1,1,2,3142,3142,6284,11,0.17284,0.259753,174,0,0
8571117,"Törbel, Halmern",,0.000066,40,1,1,2,3142,3116,6258,10,0.19403,0.285562,173,0,0
8571118,"Törbel, Oberdorf",,0.000067,40,1,1,2,3116,3140,6256,9,0.222222,0.326025,170,0,0
8571127,"Törbel, Treichelboden",,0.000064,40,1,1,2,581,509,1090,3,0.5,0.611111,27,0,0
8571120,"Törbel, Furenmatten",,0.000046,40,2,1,3,581,581,1162,10,0.181818,0.292897,132,0,0
8571121,"Törbel, Abzw. Zeneggen",,0.00005,40,1,1,2,581,581,1162,9,0.2,0.31433,123,0,0
8571122,"Törbel, Bina",,0.000053,40,1,1,2,581,581,1162,8,0.222222,0.339732,112,0,0
8571123,"Törbel, Site",,0.000056,40,1,1,2,581,581,1162,7,0.25,0.370408,99,0,0
8571124,"Törbel, Zen Springen",,0.000059,40,1,1,2,581,581,1162,6,0.285714,0.408333,84,0,0
8571125,"Törbel, Eischbiel",,0.000061,40,1,1,2,581,581,1162,5,0.333333,0.456667,67,0,0
8571126,"Z'Nivu, Skilift",,0.000062,40,1,1,2,581,581,1162,4,0.4,0.520833,48,0,0
8571130,"Steg VS, Zanellahaus",,0.000023,40,1,2,3,5536,5536,11072,8,0.232877,0.298634,136,0,0
8579555,"Gampel, Zentrum",,0.000028,40,1,2,3,13922,13922,27844,8,0.26087,0.340357,35.666667,0,0
8571131,"Steg VS, Sand",,0.000021,40,1,1,2,2052,2749,4801,11,0.177419,0.224953,71,0,0
8571139,"Glis, Gliserallee",,0.000039,40,3,4,7,13283,13394,26677,10,0.233333,0.335903,1022.587879,0,0
8571136,"Lalden, Dorf",,0.000025,40,2,2,4,1264,1278,2542,12,0.181818,0.261564,108.457576,0,0
8578656,"Glis, Holowistutz",,0.000106,40,3,3,6,11869,8033,19902,4,0.47619,0.591667,1929.666667,0,0
8580417,"Gamsen, Gewerbez. Olympica",,0.00005,40,2,2,4,3528,3528,7056,3,0.545455,0.638889,123,0,0
8571140,"Eyholz, Ritikapelle",,0.000029,40,2,2,4,3666,3666,7332,10,0.224719,0.302698,691.266667,0,0
8580753,"Eyholz, Einkaufszentren Riti",,0.000082,40,4,3,7,4154,4154,8308,3,0.625,0.766667,868.333333,0,0
8580960,"Gamsen, Landmauer",,0.000055,40,2,3,5,4149,4111,8260,2,0.8,0.875,61.666667,0,0
8571181,"Simplon Dorf, Alte Kaserne",,0.000097,40,2,3,5,1665,1620,3285,10,0.236994,0.335153,7771,0,0
8571188,"Ried-Brig, Lingwurm",,0.000038,40,1,2,3,1449,1494,2943,10,0.224719,0.302698,420,0,0
8571190,"Ried-Brig, Altersheim",,0.000034,40,1,1,2,124,124,248,10,0.217143,0.279156,38,0,0
8578544,"Brig, Viktoriastrasse",,0.000019,40,1,1,2,4670,4664,9334,10,0.217143,0.279156,0,0,0
8571157,"Gamsen, Crazy Palace",,0.000038,40,3,1,4,4149,4149,8298,10,0.213115,0.270716,130.5,0,0
8578551,"Glis, Altersheim",,0.000033,40,1,1,2,9334,9334,18668,9,0.234899,0.293243,0,0,0
8578555,"Glis, Romantica",,0.000064,40,4,2,6,7811,7811,15622,9,0.246479,0.318243,1538,0,0
8571162,"Naters, Rottubrigga",,0.000014,40,1,2,3,17748,17748,35496,14,0.136792,0.229858,609,0,0
8571163,"Naters, Marktplatz",,0.000017,40,1,1,2,8913,8913,17826,17,0.107143,0.181537,242,0,0
8571170,"Naters, Bine",,0.000017,40,1,1,2,8835,8835,17670,13,0.136752,0.22046,352,0,0
8571173,"Eisten, Ganterbrücke",,0.000062,40,1,1,2,1615,1615,3230,18,0.091248,0.12626,1701,0,0
8571174,"Berisal, Brände",,0.000063,40,1,1,2,1615,1615,3230,17,0.098361,0.133211,1548,0,0
8571175,"Berisal, Eggen",,0.000065,40,1,1,2,1615,1615,3230,16,0.106818,0.141638,1393,0,0
8571176,"Rothwald, Ganterwald",,0.000066,40,1,1,2,1615,1615,3230,15,0.117048,0.152123,1236,0,0
8571177,"Simplon Pass, Simplonblick",,0.000067,40,1,1,2,1615,1615,3230,14,0.129683,0.165616,1077,0,0
8571178,"Simplon Dorf, Niwen",,0.000068,40,1,1,2,1615,1615,3230,13,0.145695,0.183785,916,0,0
8571179,"Simplon Dorf, Maschihüs",,0.000068,40,1,1,2,1615,1615,3230,12,0.166667,0.209895,753,0,0
8580965,"Simplon Dorf, Blatt",,0.000049,40,2,1,3,1614,1615,3229,3,0.5,0.583333,189.5,0,0
8571189,"Ried-Brig, Brei",,0.000027,40,1,1,2,124,124,248,11,0.182243,0.227809,211,0,0
8571193,"Saas-Grund, Altersheim",,0.000045,41,3,1,4,5297,5327,10624,6,0.243243,0.335185,19,0,0
8571194,"Saas-Grund, Zenlauinen",,0.000049,41,1,1,2,5327,5327,10654,5,0.285714,0.372917,21,0,0
8571196,"Saas-Almagell, Alpien",,0.000062,41,2,1,3,5357,5332,10689,3,0.461538,0.527778,34,0,0
8571198,"Saas-Almagell, Waldegg",,0.000035,41,2,2,4,1597,1597,3194,3,0.571429,0.708333,21,0,0
8571199,"Saas-Almagell, Eienalp",,0.000026,41,1,1,2,1567,1597,3164,3,0.5,0.611111,0,0,0
8581061,"Saas-Almagell, Sportplatz",,0.000065,41,3,1,4,2640,2277,4917,2,0.666667,0.75,9,0,0
8571211,"Hermrigen, Friedhof",,0.000028,44,1,1,2,4820,4820,9640,30,0.067498,0.072657,270,0,0
8571207,"Bellmund, Dorf",,0.000018,87,1,1,2,5974,6549,12523,32,0.057972,0.062924,140,0,0
8571208,"Bellmund, Stöckleren",,0.000026,87,1,1,2,6549,6549,13098,31,0.06146,0.066928,902,0,0
8571209,"Bellmund, Bodenacher",,0.000033,87,1,1,2,6549,6549,13098,30,0.0654,0.071669,1662,0,0
8571212,"Hermrigen, Dorf",,0.000042,44,2,1,3,4942,4942,9884,29,0.072289,0.078014,1824,0,0
8571213,"Bühl bei Aarberg, Dorf",,0.000046,44,1,1,2,4942,4942,9884,28,0.077821,0.084328,2576,0,0
8571214,"Bühl bei Aarberg, Höll",,0.00005,44,1,1,2,4942,4942,9884,27,0.084278,0.091897,3326,0,0
8571215,"Bühl bei Aarberg, Römerhof",,0.000054,44,1,1,2,4942,4942,9884,26,0.091914,0.101157,4074,0,0
8571216,"Kappelen, Oberdorf",,0.000057,44,1,1,2,4942,4942,9884,25,0.101085,0.112801,4820,0,0
8571217,"Kappelen, Kirche",,0.000059,44,1,1,2,4942,4942,9884,24,0.112305,0.128004,5564,0,0
8571349,"Murzelen, Sandbühl",,0.000044,44,1,1,2,7369,7369,14738,26,0.10271,0.120647,3640,0,0
8571221,"Bellmund, Kornfeld",,0.00005,87,3,1,4,3565,3565,7130,28,0.074159,0.080608,3861,0,0
8571222,"Bellmund, Jäissbergweg",,0.000054,87,1,1,2,3565,3565,7130,27,0.079986,0.087422,4524,0,0
8571223,"Jens, Herrenwald",,0.000056,87,1,1,2,3565,3565,7130,26,0.086818,0.095698,5185,0,0
8571224,"Jens, Hungerberg",,0.000059,87,1,1,2,3565,3565,7130,25,0.094937,0.106046,5844,0,0
8571225,"Jens, Dorfplatz",,0.000061,87,1,2,3,3565,3565,7130,24,0.104746,0.119729,6501,0,0
8576434,"Worben, Bad",,0.000061,87,1,2,3,16236,16236,32472,23,0.115711,0.13368,3894,0,0
8571226,"Jens, Kürze",,0.000037,87,1,1,2,1851,1851,3702,26,0.089748,0.103923,1525.5,0,0
8571227,"Merzligen, Holzmattweg",,0.000042,87,1,1,2,1851,1851,3702,25,0.098457,0.117364,2178.5,0,0
8571241,"Haldenstein, Rheinbrücke",,0.000026,109,1,1,2,15574,15308,30882,23,0.097725,0.119459,1048.514286,0,0
8571259,"Seedorf BE, Aspi",,0.000033,44,1,1,2,4307,4307,8614,24,0.104462,0.117183,63,0,0
8571264,"Gstaad, Bahnhof",,0.000075,42,4,4,8,8657,11409,20066,15,0.152263,0.243566,592,0,0
8577048,"Feutersoey, Bühl",,0.000086,42,2,3,5,3683,3683,7366,9,0.27551,0.385641,405,0,0
8579261,"Saanen, Bahnhof",,0.000051,42,2,2,4,3008,3102,6110,9,0.232143,0.321993,75,0,0
8579265,"Schönried, Bahnhof",,0.000039,42,1,2,3,2561,2561,5122,9,0.224299,0.314104,50,0,0
8579266,"Saanenmöser, Bahnhof",,0.000027,42,1,1,2,425,425,850,9,0.216981,0.284282,0,0,0
8571266,"Grund b. Gstaad, Moosfang",,0.000027,42,1,1,2,3645,3683,7328,16,0.105263,0.143317,135,0,0
8571267,"Grund b. Gstaad,Moosfangbrücke",,0.000034,42,1,1,2,3683,3683,7366,15,0.114846,0.152796,167,0,0
8571268,"Grund b. Gstaad, Lädeli",,0.00004,42,1,1,2,3683,3683,7366,14,0.126582,0.164763,197,0,0
8571269,"Grund b. Gstaad, Post",,0.000044,42,1,1,2,3683,3683,7366,13,0.141304,0.180495,225,0,0
8571270,"Grund b. Gstaad, Klösterli",,0.000049,42,1,1,2,3683,3683,7366,12,0.160338,0.202392,251,0,0
8571271,"Grund b. Gstaad, Grundbrücke",,0.000052,42,1,1,2,3683,3683,7366,11,0.18593,0.23578,275,0,0
8571272,"Gsteig b. Gstaad, Saali",,0.000055,42,1,2,3,3683,3683,7366,10,0.222222,0.297399,297,0,0
8571280,"Les Diablerets, Les Rochers",,0.00006,42,1,1,2,1970,1970,3940,10,0.222222,0.285303,196,0,0
8571273,"Gsteig b. Gstaad, Heitibrücke",,0.000034,42,1,1,2,1970,1970,3940,17,0.1,0.14584,112,0,0
8571274,"Gsteig b. Gstaad, Gründ",,0.00004,42,1,1,2,1970,1970,3940,16,0.107937,0.153463,130,0,0
8571275,"Gsteig b. Gstaad, Höhe",,0.000045,42,1,1,2,1970,1970,3940,15,0.117438,0.162662,146,0,0
8571276,"Reusch, Talstation",,0.000049,42,1,1,2,1970,1970,3940,14,0.129032,0.174083,160,0,0
8571277,"Les Diablerets, La Marche",,0.000053,42,1,1,2,1970,1970,3940,13,0.143519,0.188798,172,0,0
8571278,"Les Diablerets, Les Preises",,0.000056,42,1,1,2,1970,1970,3940,12,0.162162,0.208731,182,0,0
8571279,"Les Diablerets, Les Parchets",,0.000058,42,1,1,2,1970,1970,3940,11,0.187097,0.237754,190,0,0
8571282,"Gstaad, Krambrücke",,0.000027,42,1,2,3,5000,5000,10000,18,0.109223,0.178312,270,0,0
8571283,"Gstaad, Badweidli",,0.000022,42,1,1,2,2785,2785,5570,17,0.102273,0.161256,135,0,0
8571284,"Gstaad, Trom",,0.00003,42,1,1,2,2785,2785,5570,16,0.109705,0.168797,151,0,0
8571285,"Gstaad, Tromsäge",,0.000036,42,1,1,2,2785,2785,5570,15,0.118483,0.177666,165,0,0
8571286,"Lauenen b. Gstaad, Rebwerk",,0.000042,42,1,1,2,2785,2785,5570,14,0.129032,0.188377,177,0,0
8571287,"Lauenen b. Gstaad, Enge",,0.000046,42,1,1,2,2785,2785,5570,13,0.141975,0.201776,187,0,0
8571288,"Lauenen b. Gstaad, Bruch",,0.00005,42,1,1,2,2785,2785,5570,12,0.158273,0.219374,195,0,0
8571289,"Lauenen b. Gstaad, Stalden",,0.000054,42,1,1,2,2785,2785,5570,11,0.179487,0.244201,201,0,0
8571290,"Lauenen b. Gstaad, Geltenhorn",,0.000056,42,1,1,2,2785,2785,5570,10,0.208333,0.283591,205,0,0
8571291,"Lauenen b. Gstaad, Rohrbrücke",,0.000059,42,1,2,3,2785,2785,5570,9,0.25,0.363805,207,0,0
8571295,"Lauenen b. Gstaad,Under Tungel",,0.00005,42,1,1,2,1021,1021,2042,9,0.227273,0.321931,45,0,0
8579277,"Gstaad, Eggli",,0.000048,42,3,2,5,3655,3683,7338,9,0.246377,0.372292,100,0,0
8580540,"Turbach, Fängli",,0.000095,42,3,1,4,2010,2215,4225,9,0.227273,0.321931,240,0,0
8581098,"Saanenmöser, Birkheimweg",,0.000049,42,1,2,3,425,425,850,9,0.241935,0.377487,15,0,0
8571292,"Lauenen b. Gstaad, Unterschüpf",,0.000036,42,1,1,2,1021,1021,2042,12,0.153846,0.225928,57,0,0
8571293,"Lauenen b. Gstaad, Fängli",,0.000041,42,1,1,2,1021,1021,2042,11,0.171717,0.245777,55,0,0
8571294,"Lauenen b. Gstaad, Bochte",,0.000046,42,1,1,2,1021,1021,2042,10,0.195122,0.274281,51,0,0
8571296,"Gstaad, Bissenbrücke",,0.000022,42,1,1,2,2215,2215,4430,18,0.101974,0.156087,160,0,0
8571297,"Gstaad, Bissen Schulhaus",,0.00003,42,1,1,2,2215,2215,4430,17,0.10989,0.164957,180,0,0
8571298,"Gstaad, Bissen Litzi",,0.000036,42,1,1,2,2215,2215,4430,16,0.119342,0.17606,198,0,0
8571299,"Gstaad, Wasserngratbahn",,0.000042,42,1,1,2,2215,2215,4430,15,0.130841,0.190674,214,0,0
8571300,"Scheidbach, Bissen",,0.000046,42,1,1,2,2215,2215,4430,14,0.145161,0.211435,228,0,0
8571301,"Scheidbach, Mürni",,0.00005,42,1,1,2,2215,2215,4430,13,0.163522,0.245115,240,0,0
8571302,"Turbach, Eigenmatte",,0.000054,42,1,3,4,2215,3200,5415,12,0.18797,0.319335,250,0,0
8571303,"Turbach, Rotengraben",,0.000026,42,1,2,3,620,742,1362,12,0.181818,0.290974,0,0,0
8571305,"Turbach, Egg",,0.000027,42,1,1,2,899,1226,2125,12,0.166667,0.235608,3,0,0
8571304,"Turbach, Höhe",,0.000037,42,2,2,4,2333,2211,4544,11,0.201754,0.308473,141,0,0
8580060,"Gstaad, Staldenmatte",,0.000062,42,1,3,4,2215,2215,4430,10,0.224719,0.361091,128,0,0
8580239,"Turbach, Pfündli",,0.000028,42,1,2,3,742,742,1484,11,0.186275,0.298853,3,0,0
8571311,"Unterseen, Scheidgasse",,0.000029,43,1,1,2,3961,3961,7922,7,0.223301,0.274741,0,0,0
8576641,"Matten b. I., Jungfraublick",,0.000027,43,1,3,4,7779,7779,15558,6,0.31746,0.415833,240.133333,0,0
8576889,"Unterseen, Fussweg Spital",,0.000069,43,2,3,5,4388,3239,7627,5,0.351852,0.450877,639.666667,0,0
8571684,"Chur, Florentini",,0.000025,109,1,1,2,38036,37757,75793,29,0.074601,0.089298,593,0,0
8571710,"Chur, Altes Gaswerk",,0.000034,109,1,1,2,38200,38284,76484,26,0.090076,0.11875,1949.5,0,0
8581044,"Chur, Bahnhofplatz",,0.000323,109,22,21,43,200377,200370,400747,22,0.185701,0.320596,304873.295166,0,0
8594403,"Chur, Arlibonstrasse",,0.000024,109,1,1,2,3402,3402,6804,6,0.282895,0.31938,0,0,0
8571314,"Beatenberg, Wydi",,0.000059,43,2,1,3,4827,4827,9654,8,0.194175,0.251905,165,0,0
8571315,"Beatenberg, Firnelicht",,0.000061,43,1,1,2,4827,4827,9654,7,0.228916,0.292231,137,0,0
8571316,"Beatenberg, Hubel",,0.000063,43,1,2,3,4827,4823,9650,6,0.28125,0.373148,107,0,0
8580533,"Unterseen, Stedtlizentrum",,0.000189,43,5,5,10,21933,21317,43250,4,0.457143,0.583333,1845.466667,0,0
8571317,"Habkern, Gruebi",,0.000034,43,1,1,2,3221,3221,6442,5,0.326923,0.386275,34,0,0
8578908,"Unterseen, Seestrasse",,0.000056,43,3,1,4,6067,7216,13283,5,0.326923,0.386275,516.133333,0,0
8579807,"Unterseen, Ruchenbühl",,0.000037,43,1,1,2,4657,4661,9318,5,0.326923,0.386275,42,0,0
8580532,"Unterseen, Stadthausplatz",,0.000059,43,1,1,2,6445,6445,12890,5,0.326923,0.386275,989,0,0
8576381,"Interlaken, Sonnenhof",,0.000036,43,3,3,6,11006,10984,21990,14,0.156593,0.251167,903.257143,0,0
8571319,"Lauterbrunnen, Ey",,0.000027,43,1,1,2,7076,7076,14152,5,0.333333,0.456667,100,0,0
8571320,"Lauterbrunnen, Heliport",,0.000033,43,1,1,2,7076,7076,14152,4,0.4,0.520833,84,0,0
8571321,"Stechelberg, Sandbach",,0.000039,43,1,1,2,7076,7076,14152,3,0.5,0.611111,66,0,0
8571322,"Stechelberg, Stegmatte",,0.000044,43,1,1,2,7076,7075,14151,2,0.666667,0.75,46,0,0
8571325,"Wilderswil, Ried",,0.000027,43,1,1,2,1176,1176,2352,7,0.235294,0.34494,153,0,0
8571326,"Wilderswil, Boden",,0.000033,43,1,1,2,1176,1176,2352,6,0.269231,0.378571,109,0,0
8571327,"Wilderswil, Stutz",,0.000039,43,1,1,2,1176,1174,2350,5,0.315789,0.422222,63,0,0
8571328,"Saxeten, Schulhaus",,0.000044,43,1,1,2,1174,1176,2350,4,0.384615,0.483333,15,0,0
8571355,"Kappelenring, West",,0.000033,44,2,2,4,13010,13010,26020,14,0.148256,0.239807,870.5,0,0
8576997,Markuskirche,,0.00003,44,2,4,6,14648,14708,29356,22,0.110799,0.170443,12219.75,0,0
8580237,"Hinterkappelen, Bernstrasse",,0.000146,44,6,5,11,26495,26494,52989,14,0.14939,0.28701,4066.207143,0,0
8580405,"Hinterkappelen, Aumatt",,0.000047,44,1,1,2,13275,13275,26550,14,0.135802,0.209776,44,0,0
8580406,"Aarberg, Schwimmbad",,0.000046,44,2,2,4,7206,7084,14290,14,0.137072,0.228715,24.333333,0,0
8590127,Zentrum Paul Klee,,0.000062,44,1,1,2,10287,9761,20048,2,0.666667,0.75,122,0,0
8571344,"Bethlehem b. Bern, Kirche",,0.000037,44,2,2,4,50101,50075,100176,25,0.120118,0.151232,8040.833333,0,0
8571354,"Kappelenring, Nord",,0.000018,44,1,1,2,6485,6485,12970,15,0.131313,0.192366,0,0,0
8571356,"Kappelenring, Ost",,0.000025,44,1,1,2,6525,6525,13050,15,0.132275,0.210394,12,0,0
8579748,"Bern, Obergericht",,0.000172,44,7,4,11,38555,38901,77456,23,0.116659,0.161365,14994.657143,0,0
8580219,Oberwohlen BE,,0.000051,44,1,1,2,5950,5950,11900,15,0.132275,0.210394,50,0,0
8571347,Illiswil,,0.000033,44,1,1,2,7368,7369,14737,28,0.085423,0.095931,3866,0,0
8571348,"Murzelen, Dorf",,0.000039,44,1,1,2,7369,7369,14738,27,0.093266,0.106578,3754,0,0
8571352,"Innerberg BE, Frieswilfeld",,0.000028,44,1,1,2,7206,7206,14412,26,0.102503,0.120026,803,0,0
8571358,"Bern, Mittelstrasse",,0.000145,44,10,4,14,50208,50208,100416,24,0.127548,0.161103,52922.485714,0,0
8571360,Halenbrücke,,0.000042,44,1,2,3,22760,22760,45520,27,0.07457,0.086915,1660,0,0
8571369,"Säriswil, Wendeplatz",,0.000048,44,1,1,2,8369,8369,16738,24,0.104826,0.133629,1060,0,0
8571379,"Meikirch, Feld",,0.000045,44,1,2,3,6543,6543,13086,24,0.093301,0.110714,1495,0,0
8578074,"Frienisberg, Elemoos",,0.000077,44,2,2,4,4321,4888,9209,23,0.114323,0.14997,1114.166667,0,0
8571362,Oberdettigen,,0.000035,44,1,1,2,8369,8369,16738,25,0.078525,0.093649,928,0,0
8571361,Thalmatt,,0.000029,44,1,1,2,8369,8369,16738,26,0.072908,0.084644,1084,0,0
8571365,"Uettligen, Schüpfenried",,0.000025,44,1,1,2,8369,8369,16738,28,0.074764,0.087944,3340,0,0
8571366,"Möriswil, Abzw.",,0.000032,44,1,1,2,8369,8369,16738,27,0.080505,0.095374,2773,0,0
8571367,"Säriswil, Birchi",,0.000038,44,1,1,2,8369,8369,16738,26,0.087226,0.104659,2204,0,0
8571368,"Säriswil, Schulhaus",,0.000043,44,1,1,2,8369,8369,16738,25,0.095204,0.116749,1633,0,0
8571371,"Herrenschwanden, Mööslimatt",,0.000059,44,2,2,4,18972,18972,37944,29,0.073181,0.082814,35941,0,0
8571375,"Ortschwaben, Schützenrain",,0.000053,44,3,1,4,11332,11332,22664,27,0.0804,0.089111,29213.583333,0,0
8571376,"Ortschwaben, Aetzikofen Abzw.",,0.000056,44,1,2,3,11332,11331,22663,26,0.087296,0.09855,29034.583333,0,0
8571377,"Meikirch, Gassacker",,0.000035,44,1,1,2,6542,6543,13085,26,0.07884,0.088767,1863,0,0
8571378,"Meikirch, Käserei",,0.00004,44,1,1,2,6543,6543,13086,25,0.085458,0.098031,1680,0,0
8571380,"Winterswil, Abzw.",,0.000054,44,2,1,3,4888,4888,9776,25,0.094299,0.104444,27374.583333,0,0
8571381,"Saurenhorn, Abzw.",,0.000057,44,1,1,2,4888,4888,9776,24,0.103958,0.116924,27185.583333,0,0
8571382,"Baggwil, Graben",,0.000059,44,1,1,2,4888,4888,9776,23,0.115842,0.133498,26994.583333,0,0
8576437,"Lyss, Bahnhof",,0.000283,87,11,6,17,32241,30269,62510,21,0.149793,0.190936,61433.102381,0,0
8571385,"Kirchlindach, Jetzikofenstr.",,0.000066,44,3,1,4,11225,11225,22450,30,0.07668,0.084818,7299.916667,0,0
8571386,"Kirchlindach, Friedhof",,0.000067,44,1,1,2,11225,11225,22450,29,0.082916,0.092467,7089.916667,0,0
8571389,"Zollikofen, Schäferei",,0.000074,44,2,1,3,11335,11335,22670,27,0.099068,0.113844,6739.916667,0,0
8571390,"Zollikofen, Blindenschule",,0.000074,44,1,1,2,11335,11335,22670,26,0.109786,0.129673,6523.916667,0,0
8576973,Mätteli,,0.000044,44,1,2,3,6024,4508,10532,22,0.069416,0.084972,247.833333,0,0
8589266,Thomasweg,,0.000014,44,1,2,3,6828,7002,13830,12,0.177536,0.254682,0,0,0
8590015,Hasler,,0.000067,44,4,2,6,26139,24249,50388,10,0.2,0.289974,2213.314286,0,0
8580407,"Kehrsatz, Zimmerwaldstr/Talstr",,0.00004,44,1,2,3,6062,6062,12124,12,0.166168,0.205789,1128,0,0
8580567,"Wabern, Eichholz",,0.000048,44,5,3,8,15689,15728,31417,11,0.19573,0.252508,37833.116667,0,0
8571397,"Kehrsatz, Rössli",,0.000028,44,2,1,3,6062,6062,12124,16,0.089389,0.106068,8198,0,0
8571398,"Kehrsatz, Bahnhof",,0.000035,44,1,2,3,6062,6062,12124,15,0.097458,0.118064,7507,0,0
8571399,"Kühlewil, Heim",,0.000026,44,1,1,2,5198,5198,10396,15,0.09682,0.111627,0,0,0
8571400,"Englisberg, Eichholzacker",,0.000048,44,2,1,3,6062,6062,12124,14,0.106416,0.122131,6119,0,0
8571401,"Bütschel, Gschneit",,0.000022,44,1,1,2,4322,4322,8644,31,0.072119,0.080063,255.75,0,0
8571404,"Rüeggisberg, Mättiwil",,0.000031,44,1,1,2,7098,7098,14196,28,0.091463,0.104531,2367,0,0
8571405,"Rüeggisberg, Tromwil",,0.000037,44,1,1,2,7098,7098,14196,27,0.100518,0.11792,2944,0,0
8571424,"Niedermuhlern, Bachmühle",,0.000055,44,1,2,3,4702,4702,9404,11,0.152761,0.179464,1430.459524,0,0
8571408,"Zimmerwald, Kirche",,0.000051,44,1,1,2,6062,6062,12124,13,0.118214,0.135709,5422,0,0
8571412,Hessstrasse,,0.000014,44,1,1,2,14022,14343,28365,27,0.098363,0.112511,10473,0,0
8571414,"Köniz, Zentrum",,0.000051,44,3,1,4,19045,19298,38343,25,0.122041,0.149392,14883.657143,0,0
8589991,Monbijou,,0.000051,44,5,4,9,36929,36886,73815,7,0.3,0.408095,18350.392857,0,0
8590050,Schosshaldenfriedhof,,0.000047,44,1,2,3,15491,14463,29954,4,0.4,0.520833,2756,0,0
8590052,Ostermundigen Rüti,,0.000037,44,1,1,2,11684,11036,22720,4,0.352941,0.444444,6,0,0
8590054,Dübystrasse,,0.000083,44,1,2,3,14342,14343,28685,2,0.666667,0.75,4900.571429,0,0
8571416,"Zimmerwald, Budelkehr",,0.000055,44,1,1,2,6062,6062,12124,12,0.133069,0.154252,4723,0,0
8571421,"Oberscherli, Leimen",,0.000056,44,2,4,6,13650,6798,20448,12,0.14359,0.182637,5759.459524,0,0
8571417,"Schliern, Muhlernstrasse",,0.000022,44,1,1,2,4702,4702,9404,16,0.093204,0.108362,8399,0,0
8571422,"Niedermuhlern, Käserei",,0.000069,44,2,2,4,7760,8431,16191,11,0.152348,0.182741,4542.166667,0,0
8579867,"Oberscherli, Abzweigung",,0.000023,44,1,1,2,1711,1711,3422,5,0.333333,0.456667,0,0,0
8571423,"Oberbalm, Bach",,0.000052,44,2,1,3,4047,4702,8749,12,0.133401,0.15285,2151.459524,0,0
8571425,"Bütschel, Abzw.",,0.000043,44,2,2,4,4322,4200,8522,10,0.17867,0.213455,1217.792857,0,0
8571429,"Toffen, Breitlohn",,0.000035,44,2,1,3,4686,4686,9372,14,0.109983,0.128325,459.7,0,0
8571703,"Riggisberg, Otzenbach",,0.000097,126,1,3,4,6452,6441,12893,10,0.183704,0.225109,3476.865873,0,0
8571705,"Thurnen, Bahnhof",,0.000065,44,1,2,3,3460,487,3947,10,0.183432,0.221077,2120.865873,0,0
8571432,"Rüti b. R'berg, Laas",,0.000049,126,1,1,2,443,501,944,21,0.064081,0.077375,2532,0,0
8571433,Oberer Gurnigel,,0.000052,126,1,1,2,501,501,1002,20,0.068018,0.081175,2605,0,0
8571434,"Gurnigel, Stierenhütte",,0.000055,126,1,1,2,501,501,1002,19,0.072499,0.08554,2676,0,0
8571443,"Frauenkappelen, Hübeli",,0.000024,44,1,2,3,7906,7906,15812,12,0.153473,0.190377,180,0,0
8571444,"Frauenkappelen, Chrummacher",,0.000021,44,1,2,3,7660,7660,15320,12,0.155116,0.19255,26,0,0
8571456,"Mühleberg, Dorf",,0.000073,44,3,3,6,9849,9849,19698,12,0.158813,0.20867,673,0,0
8581023,Leimere b. Mühleberg,,0.000031,44,1,1,2,5451,5451,10902,12,0.149635,0.178321,328,0,0
8571445,"Frauenkappelen, Längägerten",,0.00002,44,1,1,2,7172,7172,14344,14,0.122691,0.148295,34,0,0
8571447,Heggidorn,,0.000028,44,1,1,2,7172,7172,14344,13,0.138346,0.17039,122,0,0
8571451,"Gümmenen, Stutz",,0.000038,44,1,2,3,2677,2677,5354,13,0.13964,0.179311,290,0,0
8571455,"Mühleberg, Dällenbach",,0.000027,44,1,1,2,1336,1336,2672,13,0.138346,0.17039,0,0,0
8571448,"Allenlüften, Dorf",,0.000016,44,1,1,2,2677,2677,5354,16,0.100946,0.122775,14,0,0
8571449,Mauss,,0.000024,44,1,1,2,2677,2677,5354,15,0.111111,0.135058,108,0,0
8571450,Trüllern bei Mühleberg,,0.000031,44,1,1,2,2677,2677,5354,14,0.123684,0.152037,200,0,0
8571460,Oberei b. Mühleberg,,0.000047,44,1,2,3,5778,5778,11556,13,0.135725,0.172711,273,0,0
8571457,"Mühleberg, Säge",,0.000032,44,1,1,2,5778,5778,11556,16,0.099119,0.121287,48,0,0
8571458,Buttenried,,0.000038,44,1,1,2,5778,5778,11556,15,0.108802,0.13262,125,0,0
8571459,"Fuchsenried, Mühlebergwerk",,0.000043,44,1,1,2,5778,5778,11556,14,0.120713,0.14809,200,0,0
8571461,"Büetigen, Ausserdorf",,0.000032,87,1,1,2,957,957,1914,24,0.103727,0.116203,2192,0,0
8571462,"Diessbach bei Büren, Friedhof",,0.000038,87,1,1,2,957,957,1914,23,0.115555,0.132353,2841,0,0
8571464,"Ammerzwil BE, Unterdorf",,0.000023,44,1,1,2,1024,1024,2048,24,0.104307,0.11717,313,0,0
8571465,"Grossaffoltern, Reuenberg",,0.00003,44,1,1,2,1024,1024,2048,23,0.116279,0.133809,947,0,0
8571480,"Lohn-Lüterkofen, Bahnhof",,0.000017,87,1,2,3,4836,4879,9715,31,0.062939,0.082399,28,0,0
8571481,"Lüterkofen, Dorf",,0.000018,87,1,1,2,2394,2394,4788,30,0.065097,0.077445,234,0,0
8571482,"Ichertswil, alte Post",,0.000026,87,1,1,2,2394,2394,4788,29,0.069319,0.082341,454,0,0
8571483,"Tscheppach, Post",,0.000033,87,1,1,2,2394,2394,4788,28,0.074148,0.088144,672,0,0
8571484,"Hessigkofen, Post",,0.000039,87,1,1,2,2394,2394,4788,27,0.079726,0.095165,888,0,0
8571485,"Bibern SO, Post",,0.000044,87,1,1,2,2394,2394,4788,26,0.086241,0.103907,1102,0,0
8571487,"Küttigkofen, Bismarck",,0.000018,87,1,1,2,2485,2485,4970,32,0.058068,0.069608,21,0,0
8571489,"Küttigkofen, Schulhaus",,0.000026,87,1,1,2,2485,2485,4970,31,0.061375,0.073249,243,0,0
8571491,"Buchegg, Post",,0.000033,87,1,1,2,2485,2485,4970,30,0.065097,0.077445,463,0,0
8571492,"Brügglen SO, alte Post",,0.000039,87,1,1,2,2485,2485,4970,29,0.069319,0.082341,681,0,0
8571493,"Brügglen SO,Ochsenbeinschmiede",,0.000044,87,1,1,2,2485,2485,4970,28,0.074148,0.088144,897,0,0
8571494,"Mühledorf SO, Sternen",,0.000048,87,1,1,2,2485,2485,4970,27,0.079726,0.095165,1111,0,0
8571496,"Aetigkofen, Dorf",,0.000052,87,1,1,2,2485,2485,4970,26,0.086241,0.103907,1323,0,0
8571498,"Gächliwil, Wendeplatz",,0.000105,87,3,2,5,5121,5121,10242,24,0.10322,0.132002,3706,0,0
8571503,"Biezwil, Ausserdorf",,0.000064,87,2,2,4,5094,4967,10061,23,0.113636,0.147274,463,0,0
8571504,"Schnottwil, Oberdorf",,0.000038,87,1,4,5,4784,3675,8459,22,0.127457,0.174806,649.5,0,0
8571501,"Lüterswil, Dorf",,0.000055,87,1,2,3,5045,5044,10089,24,0.102892,0.13069,69,0,0
8571502,"Biezwil, Dorf",,0.000034,87,1,1,2,4968,5018,9986,24,0.102467,0.126665,0,0,0
8581034,"Küttigkofen, Dorf",,0.000088,87,1,2,3,2485,2485,4970,22,0.126416,0.167021,4014.5,0,0
8581120,"Schnottwil, Schulhaus",,0.000096,87,3,5,8,2591,1975,4566,21,0.143831,0.205504,8659.966667,0,0
8581590,"Buchegg, Blumenhaus",,0.000065,87,2,2,4,2485,2485,4970,1,1,1,480.5,0,0
8571508,"Bätterkinden, Bahnhof",,0.000032,87,2,1,3,536,536,1072,24,0.10376,0.116407,651.104762,0,0
8571509,"Limpach, Vorimholz",,0.000038,87,1,1,2,536,536,1072,23,0.115596,0.132736,1266.104762,0,0
8571513,"Jegenstorf, Bahnhof",,0.000046,87,2,1,3,1550,1550,3100,10,0.179104,0.272652,228,0,0
8571514,"Jegenstorf, Risere",,0.00005,87,1,1,2,1550,1550,3100,9,0.2,0.295058,201,0,0
8571515,"Iffwil, Spritzenhaus",,0.000053,87,1,1,2,1550,1550,3100,8,0.227273,0.325119,172,0,0
8571516,"Iffwil, Moosgasse",,0.000056,87,1,1,2,1550,1550,3100,7,0.264706,0.371429,141,0,0
8571517,"Etzelkofen, Oberdorf",,0.000059,87,1,2,3,1550,1550,3100,6,0.32,0.472917,108,0,0
8571520,"Messen, Eichholz",,0.000036,87,1,1,2,323,323,646,6,0.291667,0.397619,0,0,0
8571523,"Vinelz, Flachsern",,0.000035,117,2,1,3,3441,3441,6882,4,0.416667,0.516667,177,0,0
8576654,"Lüscherz, Riedmatte",,0.000037,117,1,1,2,3812,3812,7624,4,0.416667,0.516667,14,0,0
8571524,"Erlach, Gostel",,0.000035,117,2,2,4,4404,4404,8808,3,0.571429,0.708333,711,0,0
8580366,"Erlach, Oberstufenschule",,0.000072,117,2,2,4,7253,3441,10694,3,0.571429,0.708333,18,0,0
8578906,"Gampelen, Dorf",,0.000035,117,2,1,3,1229,1229,2458,3,0.5,0.611111,1197,0,0
8580368,"Tschugg, Klinik",,0.000057,117,2,1,3,4534,4534,9068,3,0.5,0.611111,0,0,0
8576660,"Le Landeron, Vieille-Ville",,0.000033,117,1,2,3,3193,325,3518,17,0.095182,0.139183,1653,0,0
8571529,"Rüegsauschachen, Zentrum",,0.000025,45,1,2,3,7023,7023,14046,14,0.127341,0.197912,714,0,0
8571530,"Rüegsau, Weghaus",,0.000021,45,1,1,2,6874,6874,13748,14,0.12406,0.173607,0,0,0
8571531,"Rüegsbach, Bachhaus",,0.00004,45,2,1,3,7023,7023,14046,13,0.137339,0.191729,736,0,0
8571532,Vorderrinderbach,,0.000045,45,1,2,3,7023,7023,14046,12,0.154229,0.225436,744,0,0
8571533,"Rüegsbach, Britternneumatt",,0.00003,45,1,1,2,6874,6874,13748,12,0.15,0.199618,0,0,0
8571535,"Affoltern i.E., Bannholz",,0.000055,45,2,1,3,7023,7023,14046,11,0.170588,0.226192,754,0,0
8571537,"Affoltern-Weier, Bahnhof",,0.000056,45,2,3,5,15156,15537,30693,9,0.236842,0.335994,854,0,0
8588629,"Dürrenroth, Gärbihof",,0.000044,45,1,1,2,8825,8825,17650,7,0.25,0.370408,154,0,0
8571538,"Grünenmatt, Bahnhof",,0.00002,45,1,1,2,3740,3740,7480,18,0.099585,0.167404,24,0,0
8571539,"Grünenmatt, Ramisberg",,0.000028,45,1,1,2,3740,3740,7480,17,0.105991,0.174476,46,0,0
8571540,"Heimisbach, Furlimatt",,0.000035,45,1,1,2,3740,3740,7480,16,0.113402,0.182549,66,0,0
8571541,"Heimisbach, Steckshaus",,0.00004,45,1,1,2,3740,3740,7480,15,0.122093,0.191951,84,0,0
8571542,"Heimisbach, Wagnershaus",,0.000045,45,1,1,2,3740,3740,7480,14,0.13245,0.203193,100,0,0
8571543,"Heimisbach, Sternen",,0.000049,45,1,1,2,3740,3740,7480,13,0.145038,0.217146,114,0,0
8571544,"Heimisbach, Krummholzbad",,0.000053,45,1,1,2,3740,3740,7480,12,0.160714,0.23543,126,0,0
8571545,"Heimisbach, Thal",,0.000056,45,1,1,2,3740,3410,7150,11,0.180851,0.261533,136,0,0
8571575,"Huttwil, Bahnhof",,0.000089,45,3,5,8,22453,22689,45142,11,0.230769,0.414419,749,0,0
8576689,"Wasen i.E., Bahnhof",,0.000035,45,1,1,2,9093,9093,18186,11,0.180851,0.261533,51,0,0
8571567,"Huttwil, Fiechtenstrasse",,0.000038,45,1,1,2,5861,5861,11722,13,0.167742,0.238812,34,0,0
8576508,"Eriswil, Thanweg",,0.000033,45,1,1,2,7767,7767,15534,3,0.444444,0.541667,4,0,0
8587249,"Eriswil, Gässli",,0.000057,45,1,2,3,7920,2738,10658,1,1,1,6,0,0
8571578,"Hasliberg Hohfluh, Dorf",,0.000055,114,2,1,3,4043,4046,8089,22,0.102007,0.150783,83,0,0
8576736,"Hofstetten b. Brienz, Kritz",,0.000095,114,1,4,5,5530,5528,11058,18,0.141643,0.280087,378,0,0
8571581,"Meiringen, Bahnhof",,0.000085,114,4,3,7,6281,6280,12561,36,0.05952,0.107564,2084,0,0
8571584,Mettli,,0.000022,114,1,2,3,1104,1104,2208,16,0.124717,0.184293,55,0,0
8571585,"Geissholz, Hori",,0.000022,114,1,3,4,2060,2060,4120,16,0.132035,0.20633,193,0,0
8571592,"Meiringen, Gesundheitszentrum",,0.000051,114,3,2,5,4131,4131,8262,15,0.133995,0.195989,505,0,0
8571582,"Willigen, Dorf",,0.000035,114,1,1,2,3429,3430,6859,35,0.059319,0.090961,1099,0,0
8571583,Lammi,,0.000041,114,1,3,4,3430,3430,6860,34,0.062728,0.106277,1267,0,0
8571591,Broch,,0.000048,114,1,1,2,1194,1194,2388,12,0.140496,0.225798,85,0,0
8580375,"Meien, Dörfli",,0.000052,93,1,1,2,254,131,385,12,0.140496,0.225798,1564,0,0
8571586,Schwendiwald,,0.000017,114,1,1,2,1194,1194,2388,17,0.099548,0.174173,120,0,0
8571587,Zwirgi,,0.000026,114,1,1,2,1194,1194,2388,16,0.105528,0.18143,117,0,0
8571588,Bühl-Oberzwirgi,,0.000033,114,1,1,2,1194,1194,2388,15,0.11236,0.189675,112,0,0
8571589,Gschwandtenmaad,,0.000039,114,1,1,2,1194,1194,2388,14,0.120253,0.199266,105,0,0
8571590,"Rosenlaui, Gletscherschlucht",,0.000044,114,1,1,2,1194,1194,2388,13,0.129496,0.210849,96,0,0
8571593,"Balm b. Meiringen, Dorf",,0.000057,114,2,1,3,2851,2851,5702,18,0.117333,0.180601,936,0,0
8571594,"Aareschlucht, Ost",,0.000022,114,1,1,2,266,266,532,33,0.052593,0.069161,1139,0,0
8571596,"Innertkirchen, Eggi",,0.000061,114,2,1,3,2723,2737,5460,31,0.057923,0.074688,1653,0,0
8571597,"Innertkirchen, Wiler",,0.000062,114,1,1,2,2737,2737,5474,30,0.061045,0.078004,1767,0,0
8571598,"Innertkirchen, Hinterflieli",,0.000064,114,1,1,2,2737,2723,5460,29,0.064546,0.081801,1879,0,0
8571599,"Innertkirchen, Mühletal",,0.000065,114,1,1,2,2723,2737,5460,28,0.0685,0.086196,1989,0,0
8571600,"Gadmen, Hopflauenen",,0.000066,114,1,1,2,2737,2737,5474,27,0.073001,0.091355,2097,0,0
8571601,"Nessental, Schwendi",,0.000067,114,1,1,2,2737,2737,5474,26,0.07817,0.09751,2203,0,0
8571602,"Nessental, Marmorsäge",,0.000068,114,1,1,2,2737,2589,5326,25,0.084171,0.105017,2307,0,0
8571603,"Nessental, Triftbahn",,0.000069,114,1,1,2,2589,2589,5178,24,0.091221,0.114454,2409,0,0
8571604,"Gadmen, Schwendibrücke",,0.000069,114,1,1,2,2589,2589,5178,23,0.099623,0.12693,2509,0,0
8571605,"Gadmen, Fuhren",,0.00007,114,1,2,3,2589,2589,5178,22,0.109807,0.145628,2607,0,0
8581371,"Meiringen,Alpbach Sportanlagen",,0.000141,114,1,2,3,3430,2236,5666,10,0.170455,0.295529,2088,0,0
8571606,"Gadmen, Saageli",,0.000041,114,1,1,2,266,266,532,21,0.121951,0.160947,2691,0,0
8571608,"Innertkirchen, Innere Urweid",,0.000032,114,1,1,2,1890,1890,3780,3,0.444444,0.541667,28,0,0
8571609,"Guttannen, Bänzlaui",,0.000038,114,1,1,2,1890,1890,3780,2,0.6,0.666667,23,0,0
8571612,"Guttannen, Breitwald",,0.000035,114,2,1,3,1329,1234,2563,1,1,1,2,0,0
8571631,Belp Riedli,,0.00002,100,1,1,2,6427,6427,12854,7,0.239766,0.284611,41,0,0
8576100,"Worb SBB, Bahnhof",,0.000019,100,1,4,5,7812,7814,15626,7,0.26087,0.348363,204,0,0
8577026,"Rubigen, Bahnhof",,0.000021,100,2,4,6,8595,8602,17197,6,0.285714,0.374561,201,0,0
8578955,Walke,,0.000027,100,1,1,2,3728,3728,7456,8,0.191781,0.265646,14,0,0
8578967,Zwischengiesse,,0.00005,100,1,1,2,7460,7460,14920,5,0.323529,0.4,44,0,0
8571621,"Münsingen, Aeschistrasse",,0.000019,100,1,1,2,7032,7066,14098,15,0.153061,0.216758,244,0,0
8571623,"Wichtrach, Dorfplatz",,0.000052,100,3,3,6,9383,9401,18784,13,0.20438,0.337981,382.5,0,0
8571624,"Wichtrach, Käserei",,0.000026,100,1,2,3,4637,4637,9274,13,0.198529,0.313462,0,0,0
8571629,"Mühledorf, Rüsch",,0.00004,100,3,3,6,4231,4231,8462,13,0.19469,0.361976,60.166667,0,0
8571625,"Wichtrach, Bahnhof",,0.000037,100,2,1,3,6826,6825,13651,14,0.172185,0.263247,75,0,0
8571627,"Gerzensee, Waldegg",,0.000023,100,1,1,2,5005,5025,10030,14,0.167832,0.264351,19,0,0
8571630,"Gelterfingen, Schulhaus",,0.000022,100,1,2,3,1801,1796,3597,6,0.333333,0.49375,5.833333,0,0
8576610,"Oberdiessbach, Kastanienpark",,0.000038,100,1,3,4,3235,3235,6470,10,0.235294,0.407019,454,0,0
8581071,"Kaufdorf, Bahnhof",,0.000041,100,2,2,4,1796,901,2697,5,0.375,0.547222,10.5,0,0
8580568,"Kirchdorf BE, Dorfstrasse",,0.000048,100,3,2,5,3478,3458,6936,6,0.318182,0.492857,29,0,0
8571632,Belp Bahnhof,,0.000036,100,2,5,7,9515,27907,37422,6,0.307692,0.39875,428,0,0
8578944,Münsingen Finkenweg,,0.000045,100,1,3,4,9400,9400,18800,6,0.285714,0.375,124,0,0
8588264,Belp Holiebi,,0.00006,100,1,1,2,5406,5406,10812,6,0.294118,0.36,1324,0,0
8587776,Bern Flughafen,,0.000048,100,4,3,7,14549,14419,28968,5,0.311688,0.402778,29594,0,0
8588265,Belp Käsereistrasse,,0.000068,100,2,3,5,11833,11831,23664,5,0.388889,0.502381,188,0,0
8571633,"Chur, Erlöserkirche",,0.000016,109,1,1,2,38030,38036,76066,30,0.069531,0.081612,14,0,0
8571635,"Oey-Diemtigen, Bahnhof",,0.000062,46,1,1,2,1435,1435,2870,12,0.144231,0.232941,150,0,0
8571636,"Oey, Marktplatz",,0.000063,46,1,1,2,1435,1435,2870,11,0.157303,0.248642,154,0,0
8571637,"Horboden, Chollerenbrücke",,0.000065,46,1,1,2,1435,1435,2870,10,0.173333,0.269109,156,0,0
8571639,"Schwenden i. D., Weid",,0.000066,46,1,1,2,1435,1435,2870,9,0.193548,0.299735,156,0,0
8571640,"Schwenden i.D.,altes Schulhaus",,0.000067,46,1,2,3,1435,1435,2870,8,0.22,0.366126,154,0,0
8571641,"Schwenden i. D., Winteregg",,0.000039,46,1,2,3,1030,1296,2326,7,0.25,0.395952,67.5,0,0
8571643,"Diemtigen, Talweid",,0.000056,46,2,1,3,1568,1302,2870,7,0.230769,0.328836,67.5,0,0
8571648,"Vorderfultigen, Abzw. Egg",,0.00005,44,3,1,4,2521,2521,5042,2,0.666667,0.75,172,0,0
8571649,"Vorderfultigen, Kuhweid",,0.000053,44,1,1,2,2521,2521,5042,1,1,1,87,0,0
8571651,"Burgistein, Elbschen",,0.000026,44,1,1,2,2179,1647,3826,22,0.102187,0.122676,16946,0,0
8571652,"Burgistein, Badersmaad",,0.000033,43,1,1,2,1647,1647,3294,21,0.11332,0.139807,17100,0,0
8576790,"Wattenwil, Lischen",,0.000045,43,1,1,2,1857,1857,3714,20,0.104822,0.161138,50,0,0
8571655,"Wattenwil, Hof",,0.00003,43,1,1,2,1618,1662,3280,2,0.666667,0.75,198,0,0
8571656,"Wattenwil, Alpenblick",,0.000037,43,1,1,2,1662,1662,3324,1,1,1,100,0,0
8571658,"Rüti b. R'berg, Unterplötsch",,0.000058,126,1,1,2,501,501,1002,18,0.077645,0.09061,2745,0,0
8571659,"Rüti b. R'berg, Plötsch",,0.00006,126,1,1,2,501,501,1002,17,0.083616,0.096574,2812,0,0
8571665,"Schwarzenburg, Schloss",,0.000068,126,2,1,3,2485,2605,5090,15,0.098983,0.112368,2944,0,0
8571666,"Schwarzenburg, Brüllen",,0.000069,126,1,1,2,2605,2605,5210,14,0.109105,0.123176,3004,0,0
8571667,"Schwarzenburg, Waldgasse",,0.000069,126,1,1,2,2605,2605,5210,13,0.121622,0.137077,3062,0,0
8571668,"Riedstätt, ob dem Wald",,0.00007,126,1,1,2,2605,2605,5210,12,0.1375,0.155774,3118,0,0
8571670,"Guggisberg, Kalchstätten",,0.000075,126,2,3,5,3072,3435,6507,10,0.186755,0.228186,3366,0,0
8571672,"Riffenmatt, Giebel",,0.000038,126,1,3,4,2451,2451,4902,11,0.161816,0.197063,776,0,0
8571679,"Riffenmatt, Schwendi",,0.000064,126,2,2,4,2224,2224,4448,10,0.184358,0.220629,1034,0,0
8577859,"Schwarzenburg, Freiburgstrasse",,0.000046,126,1,1,2,3431,3431,6862,10,0.180597,0.211406,9196.333333,0,0
8571671,"Guggisberg, Sand",,0.000032,126,1,1,2,2451,2451,4902,12,0.14014,0.162524,728,0,0
8571678,"Riffenmatt, Neuenmatt",,0.00005,126,1,1,2,1984,1984,3968,11,0.156655,0.179521,665,0,0
8571673,"Schwarzenburg, Milkenstrasse",,0.000022,126,1,1,2,1984,1984,3968,16,0.090255,0.103847,465,0,0
8571674,"Milken, Hofland",,0.000029,126,1,1,2,1984,1984,3968,15,0.09849,0.112292,509,0,0
8571675,"Milken, Zumholz",,0.000036,126,1,1,2,1984,1984,3968,14,0.108453,0.122778,551,0,0
8571676,"Milken, Dorf",,0.000041,126,1,1,2,1984,1984,3968,13,0.120751,0.136192,591,0,0
8571677,"Milken, Steinern",,0.000046,126,1,1,2,1984,1984,3968,12,0.136317,0.15408,629,0,0
8571686,"Kalchstätten, Eigen",,0.00007,126,3,1,4,1331,1331,2662,11,0.158596,0.184215,630,0,0
8571688,"Hirschmatt (Guggisberg),Schule",,0.000031,126,1,1,2,830,830,1660,7,0.25,0.355357,306,0,0
8571689,"Hirschmatt (Guggisberg), Fall",,0.000037,126,1,1,2,830,830,1660,6,0.291667,0.397619,211,0,0
8571690,"Hirschmatt (Guggisberg), Allme",,0.000043,126,1,1,2,830,830,1660,5,0.352941,0.463889,114,0,0
8571691,"Schwarzenburg, Thunstrasse",,0.000039,44,1,1,2,5466,5466,10932,19,0.072668,0.087278,860,0,0
8571692,"Mamishaus, Hostatt",,0.000044,44,1,1,2,5466,5466,10932,18,0.077778,0.092332,917,0,0
8571693,"Mamishaus, Abzw. Borbezried",,0.000049,44,1,1,2,5466,5466,10932,17,0.083703,0.09829,972,0,0
8571694,"Mamishaus, Wengerli",,0.000052,44,1,1,2,5466,5466,10932,16,0.090657,0.105437,1025,0,0
8571695,"Rüschegg Gambach, Bärenwart",,0.000055,44,1,1,2,5466,5466,10932,15,0.098935,0.114196,1076,0,0
8571696,"Rüschegg Heubach, Längenboden",,0.000058,44,1,1,2,5466,5466,10932,14,0.108953,0.12526,1125,0,0
8571697,"Rüschegg Graben, Rütiplötsch",,0.00006,44,1,1,2,5466,5466,10932,13,0.121327,0.139932,1172,0,0
8571702,"Helgisried, Lauimatt",,0.000102,126,4,1,5,6452,6452,12904,11,0.15625,0.181191,3452.865873,0,0
8581382,"Rüschegg Gambach, Linde",,0.000032,126,1,1,2,2736,2736,5472,1,1,1,0,0,0
8582068,"Toffen, Gemeindeverwaltung",,0.000081,44,1,1,2,2343,497,2840,1,1,1,2,0,0
8571704,"Mühlethurnen, Adler",,0.000064,44,3,1,4,3459,3460,6919,11,0.156055,0.179857,2113.865873,0,0
8571709,"Chur, Sardona",,0.000027,109,1,1,2,38298,38200,76498,27,0.082762,0.103711,1376.5,0,0
8571711,"Steffisburg, Erlen",,0.000027,43,1,1,2,690,690,1380,31,0.055952,0.06626,319,0,0
8571712,"Steffisburg, Schwandenbad",,0.000034,43,1,1,2,690,690,1380,30,0.059016,0.06945,524,0,0
8571713,"Steffisburg, Fuchsloch",,0.00004,43,1,1,2,690,690,1380,29,0.06245,0.073077,727,0,0
8571714,"Schwendibach, Stutz",,0.000045,43,1,1,2,690,690,1380,28,0.066324,0.07724,928,0,0
8571715,"Schwendibach, Käserei",,0.000049,43,1,1,2,690,690,1380,27,0.070729,0.082072,1127,0,0
8571716,"Homberg, Hüttacker",,0.000052,43,1,1,2,690,690,1380,26,0.075783,0.087753,1324,0,0
8571717,"Homberg, Dreiligasse",,0.000056,43,1,1,2,690,690,1380,25,0.08164,0.09454,1519,0,0
8571718,"Homberg, Käserei",,0.000058,43,1,1,2,690,690,1380,24,0.088509,0.102809,1712,0,0
8571719,"Homberg, Kreuz",,0.00006,43,1,1,2,690,690,1380,23,0.096678,0.113144,1903,0,0
8571720,"Buchen, Schulhaus",,0.000062,43,1,1,2,690,690,1380,22,0.106554,0.126518,2092,0,0
8571721,"Buchen, Schmiedsegg",,0.000064,43,1,1,2,690,690,1380,21,0.118734,0.144745,2279,0,0
8576581,"Steffisburg, Bösbach",,0.000048,43,1,1,2,7735,7735,15470,16,0.109969,0.137859,1210,0,0
8571723,"Worb Dorf, Bahnhof",,0.000036,100,3,4,7,6350,20400,26750,14,0.174419,0.25115,744,0,0
8571724,"Worb, Toggenburg",,0.000019,100,1,2,3,5922,5922,11844,13,0.135,0.219445,195,0,0
8571725,"Worb, Bleiche",,0.000027,100,2,1,3,4445,4445,8890,13,0.130653,0.189424,195,0,0
8571734,"Boll-Utzigen, Vorderer Rain",,0.000017,47,1,1,2,7437,7434,14871,3,0.5,0.611111,2256,0,0
8571735,"Boll-Utzigen, Rain",,0.000025,47,1,1,2,7434,7437,14871,2,0.666667,0.75,1506,0,0
8571736,"Utzigen, Aebnit",,0.000032,47,1,1,2,7437,7437,14874,1,1,1,754,0,0
8571742,"Worb, Lindhalde",,0.000041,100,2,1,3,8147,8147,16294,12,0.144509,0.206719,425,0,0
8571743,"Worb, Längmatt",,0.000046,100,1,1,2,8147,8147,16294,11,0.162162,0.232938,432,0,0
8571744,"Worb, Filzfabrik",,0.00005,100,1,2,3,8147,8147,16294,10,0.185484,0.284576,437,0,0
8571745,Metzgerhüsi,,0.000032,100,1,1,2,3702,3702,7404,9,0.179487,0.259892,280,0,0
8571746,"Biglen, Biglenrohr",,0.000038,100,1,1,2,3702,3702,7404,8,0.203125,0.28489,273,0,0
8571748,"Biglen, Bahnhof",,0.000083,100,2,2,4,5742,6155,11897,6,0.282051,0.40303,302,0,0
8579436,"Enggistein, Rüttihubelstrasse",,0.000061,100,1,1,2,4445,4445,8890,1,1,1,7,0,0
8571749,"Biglen, Bären",,0.000046,100,1,1,2,2453,2453,4906,5,0.321429,0.401852,251,0,0
8571768,"Landiswil, Bärisbach",,0.000056,100,1,1,2,2215,2215,4430,3,0.444444,0.541667,20,0,0
8571753,"Worb, Wyden Schulhaus",,0.000019,100,1,2,3,4441,4441,8882,9,0.233333,0.37894,180,0,0
8571754,"Richigen, Lochi",,0.000019,100,1,2,3,865,865,1730,8,0.244444,0.398593,146,0,0
8571756,"Schlosswil, Kreuz",,0.000027,100,1,2,3,3576,3576,7152,8,0.244444,0.398593,11,0,0
8571760,"Grosshöchstetten, Bahnhof",,0.000037,100,1,1,2,3688,3688,7376,8,0.214286,0.320503,9,0,0
8571755,"Richigen, Abzw. Lochi",,0.000019,100,1,1,2,3576,3576,7152,9,0.210526,0.317097,16,0,0
8571759,"Grosshöchstetten, Neuhaus",,0.00003,100,2,1,3,3688,3688,7376,9,0.192308,0.297183,19,0,0
8571761,"Grosshöchstetten, Talacker",,0.000061,100,3,1,4,4441,4441,8882,7,0.242424,0.349107,138,0,0
8571762,"Schlosswil, Nest",,0.000063,100,1,1,2,4441,4441,8882,6,0.28,0.385714,124,0,0
8571763,"Schlosswil, Unterführung",,0.000065,100,1,1,2,4441,4441,8882,5,0.333333,0.436111,108,0,0
8571764,Ried bei Worb,,0.000066,100,1,1,2,4441,4441,8882,4,0.416667,0.516667,90,0,0
8571765,"Lützelflüh-Goldbach, Bahnhof",,0.000045,100,2,1,3,2215,2215,4430,6,0.259259,0.37381,107,0,0
8571766,"Goldbach BE, Sonnhalde",,0.000049,100,1,1,2,2215,2215,4430,5,0.3,0.413889,80,0,0
8571767,"Schwanden i.E., Aeschli",,0.000053,100,1,1,2,2215,2215,4430,4,0.357143,0.466667,51,0,0
8571769,"Obergoldbach, Längacker",,0.00008,100,2,1,3,2947,2946,5893,2,0.6,0.666667,111,0,0
8571770,"Arni BE, Tanne",,0.000078,100,1,2,3,2946,2927,5873,1,1,1,76,0,0
8571771,"Arni BE, Hämlismatt",,0.000044,100,1,1,2,2433,1721,4154,1,1,1,0,0,0
8576960,"Oberönz, Moos",,0.000048,88,1,1,2,8510,8510,17020,7,0.230769,0.328836,612,0,0
8571776,"Buttes, gare",,0.000041,35,1,1,2,4620,4620,9240,12,0.139037,0.213983,104,0,0
8571777,"La Côte-aux-Fées, Les Leuba",,0.000046,35,1,2,3,4620,4620,9240,11,0.15528,0.260812,125,0,0
8571778,"La Côte-aux-Fées, Entre-Bolles",,0.00003,35,1,2,3,3407,3407,6814,10,0.171429,0.274438,120,0,0
8579719,"Ste-Croix, av. de Neuchâtel",,0.000093,35,3,3,6,7076,7076,14152,3,0.5,0.611111,622.5,0,0
8571779,"La Côte-aux-Fées, Bolles-Vent",,0.000024,35,1,1,2,1222,1222,2444,9,0.159722,0.211491,133,0,0
8571780,"La Vraconnaz, Les Rochettes",,0.000031,35,1,1,2,1222,1222,2444,8,0.181818,0.232413,148,0,0
8571781,"La Vraconnaz, bif. nord",,0.000037,35,1,1,2,1222,1222,2444,7,0.212121,0.262472,161,0,0
8571783,La Chaux-de-Ste-Croix,,0.00002,35,1,1,2,2132,2922,5054,7,0.214286,0.270408,9,0,0
8571788,"Ste-Croix, gare",,0.000114,35,4,5,9,8397,8890,17287,4,0.435897,0.563725,1077,0,0
8579077,"L'Auberson, école",,0.000042,35,1,2,3,5854,5853,11707,5,0.311111,0.405952,28,0,0
8579282,"Ste-Croix, La Charmille",,0.000048,35,2,2,4,6173,6174,12347,5,0.309524,0.411538,3,0,0
8579284,"Ste-Croix, place du Pont",,0.000069,35,3,2,5,6466,6466,12932,4,0.387097,0.479167,42.5,0,0
8579287,"Les Rasses, Grand-Hôtel",,0.000079,35,1,2,3,6483,6483,12966,4,0.37037,0.475,10.5,0,0
8571793,Pierre-à-Sisier,,0.00003,48,1,2,3,13424,13419,26843,18,0.108252,0.131423,1031.166667,0,0
8594862,Pacotte,,0.000064,48,1,2,3,12975,12975,25950,7,0.294118,0.442619,3966.928571,0,0
8594863,Solitude,,0.000046,48,2,1,3,7094,6908,14002,7,0.272727,0.380688,15.083333,0,0
8571794,"Chambrelien, village",,0.000043,48,2,2,4,13276,13281,26557,17,0.119694,0.145516,2295.171429,0,0
8583766,"Le Locle, douane marchandises",,0.000124,134,4,2,6,5282,5289,10571,12,0.156495,0.201819,1500.614286,0,0
8587366,Croisette,,0.000044,134,3,3,6,32742,33871,66613,11,0.177193,0.231837,1893.775758,0,0
8587368,Gérardmer,,0.000023,134,1,2,3,21874,22116,43990,12,0.161812,0.21789,135.7,0,0
8580339,"Le Locle, Hôtel-de-Ville",,0.000065,134,5,10,15,29483,39083,68566,11,0.201709,0.300935,21937.960788,0,0
8587373,"Le Locle, Technicum",,0.000091,134,4,4,8,30417,30434,60851,11,0.182994,0.251816,2320.380952,0,0
8571802,"Le Locle-Col-des-Roches, gare",,0.000024,134,3,1,4,5282,5289,10571,33,0.048678,0.065335,1822,0,0
8571803,"Le Locle, cimetière",,0.000031,134,1,1,2,5289,5289,10578,32,0.05103,0.070018,1802,0,0
8571804,"Le Prévoux, Les Combes",,0.000037,134,1,1,2,5289,5289,10578,31,0.053629,0.07585,1780,0,0
8571805,"Le Prévoux, Bas Du Prévoux",,0.000043,134,1,1,2,5289,5289,10578,30,0.056514,0.083449,1756,0,0
8571825,"La Chaux-du-Milieu, P-Chaux",,0.000041,134,1,2,3,2567,2278,4845,13,0.14742,0.189691,274.585714,0,0
8571808,"Le Prévoux, bif. sur Bétod",,0.000025,134,1,1,2,3854,3847,7701,42,0.036909,0.052325,2765,0,0
8571809,"Le Cerneux-Péquignot, Le Creux",,0.000032,134,1,1,2,3847,3847,7694,41,0.038219,0.055012,2733,0,0
8571810,"Le Cerneux-Péquignot, Etages",,0.000038,134,1,1,2,3847,3847,7694,40,0.039628,0.058177,2699,0,0
8571811,"Le Cerneux-Péquignot, village",,0.000043,134,1,1,2,3847,3847,7694,39,0.041149,0.061984,2663,0,0
8571812,Le Bas-du-Cerneux,,0.000048,134,1,1,2,3847,3847,7694,38,0.042796,0.066701,2625,0,0
8571813,"Le Cerneux-Péquignot, M-Rochat",,0.000051,134,1,1,2,3847,3847,7694,37,0.044585,0.072802,2585,0,0
8571814,"Le Cerneux-Péquignot,M-Baillod",,0.000055,134,1,1,2,3847,3847,7694,36,0.046536,0.081276,2543,0,0
8579724,"Le Locle, Moulins souterrains",,0.000058,134,3,4,7,5282,5289,10571,12,0.170732,0.233928,2233.805952,0,0
8583696,"La Châtagne, Milieu des Prés",,0.000073,134,4,2,6,2574,2567,5141,14,0.123077,0.157285,1254.5,0,0
8571816,"La Châtagne, Combe-la Racine",,0.000046,134,3,1,4,2567,2566,5133,34,0.044317,0.056308,4258,0,0
8571817,"La Châtagne, anc. poste",,0.00005,134,1,1,2,2566,2567,5133,33,0.046242,0.059184,4210,0,0
8571818,"La Châtagne, Crêt-la Châtagne",,0.000053,134,1,1,2,2567,2566,5133,32,0.048347,0.062537,4160,0,0
8571819,"Le Cachot, Petit-Cachot",,0.000056,134,1,1,2,2566,2567,5133,31,0.05066,0.066531,4108,0,0
8571820,"Le Cachot, carrefour",,0.000059,134,1,1,2,2567,2567,5134,30,0.053212,0.071438,4054,0,0
8571821,"Le Cachot, Fromagerie",,0.000061,134,1,1,2,2567,2567,5134,29,0.056043,0.077793,3998,0,0
8571823,"La Chaux-du-Milieu, La Forge",,0.00007,134,3,1,4,9936,9936,19872,27,0.061336,0.085761,7038.5,0,0
8571826,"Le Locle, rue du Midi",,0.000061,134,3,2,5,15843,25142,40985,25,0.068972,0.105503,11644.997545,0,0
8593728,Fleurs,,0.000056,134,1,1,2,16979,16979,33958,3,0.5,0.611111,545.41674,0,0
8571827,"Le Locle, La Jaluse",,0.000037,134,1,3,4,24927,24915,49842,24,0.073741,0.122238,11472.914286,0,0
8571849,"Neuchâtel, gare",,0.000019,48,1,2,3,6918,6918,13836,12,0.169516,0.222724,8097.05,0,0
8579725,"Le Locle, Verger",,0.000047,134,3,6,9,21582,32063,53645,11,0.198003,0.276698,13404.452671,0,0
8571828,"Le Locle, Chemin-Blanc",,0.000021,134,1,1,2,7817,7817,15634,23,0.06216,0.070094,10660,0,0
8571829,"Le Locle, Les Replattes",,0.000029,134,1,1,2,7817,7817,15634,22,0.066087,0.074397,10575,0,0
8571830,"Le Locle, La Combe-Jeanneret",,0.000036,134,1,1,2,7817,7817,15634,21,0.070557,0.07941,10488,0,0
8571831,"Le Locle, Haut-du-Quartier",,0.000041,134,1,1,2,7817,7817,15634,20,0.07569,0.085339,10399,0,0
8571832,"Le Quartier, La Couronne",,0.000046,134,1,1,2,7817,7817,15634,19,0.081647,0.092486,10308,0,0
8571833,"Le Quartier, carrefour",,0.00005,134,1,1,2,7817,7817,15634,18,0.088644,0.101324,10215,0,0
8571834,"La Chaux-du-Milieu, La Gr-Joux",,0.000053,134,1,1,2,7817,7817,15634,17,0.096978,0.11269,10120,0,0
8571835,"Les Ponts-de-Martel, Molta-De.",,0.000056,134,1,2,3,7817,7817,15634,16,0.107075,0.12855,10023,0,0
8583699,"Corcelles NE, Les Vernets",,0.000032,134,1,1,2,6918,6918,13836,2,0.666667,0.75,2,0,0
8593709,Malakoff,,0.000113,134,2,2,4,21624,21624,43248,3,0.545455,0.638889,2774.666667,0,0
8593724,G. Favre,,0.000029,134,1,1,2,1117,1117,2234,2,0.666667,0.75,8,0,0
8593730,Avenir,,0.000085,134,2,1,3,17194,16763,33957,2,0.666667,0.75,19.5,0,0
8593735,"Le Locle, Monts",,0.000054,134,1,1,2,18326,18326,36652,2,0.666667,0.75,14,0,0
8593737,Côte de la Jaluse,,0.000041,134,2,2,4,17107,17434,34541,6,0.276596,0.392308,868.819048,0,0
8593738,Marie-Anne Calame,,0.000077,134,5,4,9,17226,17808,35034,3,0.588235,0.683333,5059.428571,0,0
8593748,"Le Locle, Communal",,0.000072,134,2,2,4,18736,18318,37054,2,0.75,0.833333,647,0,0
8593750,Piste Vita,,0.000041,134,1,1,2,9285,9073,18358,2,0.666667,0.75,0,0,0
8593751,Combe-Girard,,0.000048,134,2,2,4,22104,14438,36542,2,0.75,0.833333,155,0,0
8593752,Auguste-Lambelet,,0.00004,134,1,1,2,6265,6265,12530,2,0.666667,0.75,4,0,0
8593754,Jambe-Ducommun,,0.000038,134,2,1,3,6477,6264,12741,2,0.666667,0.75,38.133333,0,0
8594589,"Le Locle, Centenaire",,0.000062,134,2,1,3,2671,2677,5348,2,0.666667,0.75,6,0,0
8571843,"La Tourne, La Mauvaise-Combe",,0.000027,134,1,1,2,6918,6918,13836,19,0.098924,0.112656,6709.5,0,0
8571844,"Les Grattes, bif.",,0.000034,134,1,1,2,6918,6918,13836,18,0.109399,0.126507,6555.5,0,0
8579659,"Boudry, Les Tilles",,0.000089,105,3,2,5,10791,10296,21087,17,0.134021,0.188536,4234,0,0
8582487,"Marin-Epagnier, gare",,0.000074,48,3,6,9,74631,75210,149841,16,0.178846,0.269191,20078.6,0,0
8582593,"St-Aubin NE, Tivoli",,0.000094,35,2,2,4,4762,4733,9495,16,0.132787,0.185281,25022.666667,0,0
8571859,"Boveresse, Prise-Sèche",,0.000067,49,3,1,4,4585,4585,9170,27,0.055556,0.065217,3236,0,0
8571861,"Les Sagnettes, Chablais",,0.000068,49,1,1,2,4585,4585,9170,26,0.058629,0.068795,3118,0,0
8571862,"Les Sagnettes, La Roche",,0.000068,49,1,1,2,4585,4585,9170,25,0.062075,0.072952,2998,0,0
8571863,"Les Sagnettes, anc. poste",,0.000069,49,1,1,2,4585,4585,9170,24,0.065963,0.077865,2876,0,0
8571864,"Les Sagnettes, bif. Charbonni.",,0.00007,49,1,1,2,4585,4585,9170,23,0.070386,0.083803,2752,0,0
8571865,"Les Sagnettes, ch. Chenailleta",,0.00007,49,1,1,2,4585,4585,9170,22,0.075462,0.09122,2626,0,0
8571866,"La Brévine, Bois-de-l'Halle",,0.00007,49,1,1,2,4585,4585,9170,21,0.081348,0.100964,2498,0,0
8571871,"Les Bayards, Petit-Bayard",,0.000023,49,1,1,2,1594,1594,3188,20,0.083551,0.138611,4278,0,0
8571872,"Les Bayards, Bellevue",,0.00003,49,1,1,2,1594,1594,3188,19,0.088319,0.143512,3922,0,0
8571873,"Les Bayards, bif Place Jeannin",,0.000036,49,1,1,2,1594,1594,3188,18,0.09375,0.149001,3564,0,0
8571874,"Le Cernil NE, restaurant",,0.000042,49,1,1,2,1594,1594,3188,17,0.1,0.155226,3204,0,0
8571875,"Le Brouillet, bif. les Jordan",,0.000047,49,1,1,2,1594,1594,3188,16,0.10728,0.162395,2842,0,0
8571876,"Le Brouillet, anc. poste",,0.00005,49,1,1,2,1594,1594,3188,15,0.11588,0.170812,2478,0,0
8571877,"Le Brouillet, Chez-Petoud",,0.000054,49,1,1,2,1594,1594,3188,14,0.126214,0.180938,2112,0,0
8571878,"Bémont NE, restaurant",,0.000057,49,1,1,2,1594,1594,3188,13,0.138889,0.193507,1744,0,0
8571879,"Bémont NE, sur-le-Pont",,0.000059,49,1,1,2,1594,1594,3188,12,0.154839,0.209773,1374,0,0
8571880,"Les Taillères, restaurant",,0.000061,49,1,1,2,1594,1594,3188,11,0.175573,0.232075,1002,0,0
8571881,"Les Taillères, Bout du Lac",,0.000063,49,1,1,2,1594,1593,3187,10,0.203704,0.265386,628,0,0
8571882,"Les Taillères, Varodes",,0.000064,49,1,1,2,1593,1594,3187,9,0.244186,0.322808,252,0,0
8579597,Prise Milord,,0.000051,49,1,3,4,11490,11489,22979,8,0.278481,0.393994,2433,0,0
8579598,"Les Bayards, gare",,0.000025,49,1,1,2,7954,7820,15774,9,0.244186,0.322808,0,0,0
8593652,Abraham-Robert,,0.000026,134,1,2,3,44315,44314,88629,10,0.210744,0.271662,261.533333,0,0
8593666,Gentianes,,0.000062,134,2,2,4,21682,21538,43220,9,0.215247,0.271883,4085.333333,0,0
8571886,"La Chaux-de-Fonds, Parc Sports",,0.000016,134,1,1,2,3395,3395,6790,9,0.197368,0.272566,4380,0,0
8571887,"La Chaux-de-Fonds, Combettes",,0.000025,134,1,1,2,3395,3395,6790,8,0.229508,0.31199,3952,0,0
8571888,"Chur, Scawoba",,0.000024,109,1,1,2,38349,38363,76712,24,0.094519,0.116664,1984.166667,0,0
8571893,"Les Planchettes, Sur-le-Ring",,0.00005,134,1,2,3,3395,3395,6790,5,0.391304,0.512963,47,0,0
8571890,"Les Joux-Derrière, restaurant",,0.000036,134,2,1,3,3395,3395,6790,8,0.214286,0.294544,1355,0,0
8571891,"Les Joux-Derrière, La Grébille",,0.000041,134,1,1,2,3395,3395,6790,7,0.25,0.329654,921,0,0
8571892,"Les Planchettes, Le Dazenet",,0.000046,134,1,1,2,3395,3395,6790,6,0.30303,0.386667,485,0,0
8571895,"Biaufond, Les Avants",,0.00005,134,1,1,2,510,510,1020,5,0.35,0.445238,902,0,0
8571894,"La Chaux-de-Fonds, Brenetets",,0.000046,134,2,1,3,510,510,1020,6,0.285714,0.379167,1344,0,0
8582489,"Wavre, collège",,0.000029,48,1,1,2,2605,2605,5210,19,0.080437,0.107891,81,0,0
8571897,"La Neuveville, Les Moulins",,0.000031,117,3,1,4,3082,3081,6163,8,0.212766,0.308452,5678,0,0
8571898,"La Neuveville, La Main",,0.000037,117,1,1,2,3081,3082,6163,7,0.243243,0.338095,5116,0,0
8571902,"Prêles, collège",,0.000058,117,2,2,4,4332,4332,8664,4,0.461538,0.597222,3450,0,0
8571904,"Diesse, Chenaux",,0.000041,117,1,2,3,4168,4168,8336,3,0.571429,0.708333,4,0,0
8571903,"Lamboing, Scierie",,0.000035,117,1,1,2,4168,4168,8336,4,0.416667,0.516667,576,0,0
8571905,"Nods, bas du village",,0.000053,117,2,1,3,4266,3016,7282,3,0.5,0.611111,1728,0,0
8571906,"Le Landeron, gare",,0.000071,117,6,4,10,8086,9008,17094,18,0.100088,0.157847,13274.5,0,0
8571922,"Lignières, Moulin Navilot",,0.000039,117,1,4,5,3176,3176,6352,16,0.104031,0.167016,1312,0,0
8581997,"Lignières, bureau communal",,0.000035,117,2,2,4,2204,1720,3924,16,0.101695,0.145657,78,0,0
8571907,"Le Landeron, Montet-Dessus",,0.000026,117,1,1,2,3176,3176,6352,18,0.087983,0.121171,2304,0,0
8571908,"Le Landeron, bif. sur Frochaux",,0.000033,117,1,1,2,3176,3176,6352,17,0.095294,0.136096,1809,0,0
8571917,"Enges, collège",,0.000055,117,1,1,2,2605,2312,4917,17,0.153094,0.202118,799,0,0
8579627,Rocher,,0.000022,48,1,6,7,122640,123440,246080,16,0.169297,0.25208,10538.904762,0,0
8571911,"St-Blaise, gare CFF",,0.000026,117,1,1,2,2605,2450,5055,23,0.083403,0.104077,3691,0,0
8571912,"St-Blaise, La Goulette",,0.000033,117,1,1,2,2450,2605,5055,22,0.090082,0.111396,3214,0,0
8571913,"St-Blaise, Voëns",,0.000039,117,1,1,2,2605,2605,5210,21,0.098,0.120433,2735,0,0
8571914,"St-Blaise, bif. sur Maley",,0.000044,117,1,1,2,2605,2605,5210,20,0.107539,0.131925,2254,0,0
8571915,"St-Blaise, bif. sur Frochaux",,0.000048,117,1,1,2,2605,2605,5210,19,0.119255,0.14715,1771,0,0
8571916,"Enges, village",,0.000052,117,1,1,2,2605,2605,5210,18,0.133992,0.168587,1286,0,0
8581575,"Nods, La Ruine",,0.000019,117,1,1,2,1109,1108,2217,17,0.093381,0.126884,0,0,0
8582213,"La Neuveville, Ruis de Vaux",,0.000067,117,2,1,3,2283,1064,3347,16,0.099476,0.129753,2593.5,0,0
8582492,"Cressier NE, gare",,0.000059,48,1,2,3,2663,2663,5326,16,0.101695,0.145657,3222,0,0
8582668,"Le Landeron, zone industrielle",,0.000041,48,1,2,3,2605,2605,5210,15,0.110305,0.155632,76,0,0
8571923,"Tramelan, gare",,0.000062,1,1,1,2,3981,3981,7962,13,0.141956,0.192604,499,0,0
8571924,"Chur, Albula",,0.000031,109,1,2,3,38363,37644,76007,23,0.104207,0.136136,2551.166667,0,0
8572375,"Chur, Amselweg",,0.000012,109,1,1,2,3684,21952,25636,24,0.10247,0.136105,1,0,0
8571949,"Lajoux JU, école",,0.000061,1,1,2,3,1855,1855,3710,11,0.189873,0.285385,120,0,0
8571953,"Reconvilier, gare",,0.000042,1,1,3,4,2349,2349,4698,11,0.188811,0.31586,176.5,0,0
8572026,"Bassecourt, garage St-Hubert",,0.000057,1,3,2,5,1885,1871,3756,10,0.204545,0.298442,345.666667,0,0
8576775,"Les Genevez JU, ch.de Tramelan",,0.000085,1,4,1,5,4550,4445,8995,10,0.198473,0.271459,276,0,0
8571927,"Les Reussilles, Les Gérinnes",,0.000023,1,1,1,2,1425,1425,2850,14,0.116364,0.162325,302,0,0
8571928,"Les Reussilles, La Chaux",,0.00003,1,1,1,2,1425,1425,2850,13,0.127572,0.173003,299,0,0
8571929,"Les Reussilles, bif Montfaucon",,0.000037,1,1,1,2,1425,1425,2850,12,0.141509,0.186524,294,0,0
8571930,"Saignelégier, Moulin de Gruère",,0.000042,1,1,1,2,1425,1425,2850,11,0.159341,0.204394,287,0,0
8571931,"Saignelégier, Rouges-Terres",,0.000047,1,1,1,2,1425,1425,2850,10,0.183007,0.22945,278,0,0
8571932,"Saignelégier, La Neuvevie",,0.00005,1,1,1,2,1425,1425,2850,9,0.216,0.267784,267,0,0
8571934,"Saignelégier, gare",,0.000114,1,4,6,10,5392,5500,10892,7,0.347222,0.501714,741,0,0
8576777,"Lajoux JU, La Loge",,0.000119,1,3,2,5,4641,4788,9429,9,0.238095,0.355302,814.666667,0,0
8576778,"Lajoux JU, Le Paigre",,0.000061,1,1,4,5,4746,4607,9353,9,0.242424,0.404828,184.666667,0,0
8576779,"Glovelier, gare",,0.000091,1,3,4,7,5984,5974,11958,8,0.246575,0.42004,710,0,0
8583658,"Saignelégier, Le Graiteux",,0.000048,1,2,1,3,1314,1314,2628,2,0.666667,0.75,6,0,0
8583659,"Saignelégier, Rte de France",,0.000068,1,2,1,3,1428,888,2316,1,1,1,4,0,0
8588202,"St-Brais, Le Cerneux-Bénat",,0.000076,1,3,3,6,3287,3427,6714,3,0.625,0.766667,233,0,0
8571935,"Les Pommerats, bas du village",,0.000027,1,1,2,3,1311,998,2309,3,0.555556,0.666667,126,0,0
8571937,"Goumois, Tournant Theusseret",,0.00003,1,1,1,2,1072,1072,2144,3,0.5,0.611111,3,0,0
8571936,"Goumois, Belfond",,0.000022,1,1,1,2,756,1072,1828,4,0.4,0.520833,43,0,0
8571938,"Tavannes, gare",,0.000025,1,1,1,2,951,923,1874,18,0.101828,0.150189,24,0,0
8571940,"Le Fuet, poste",,0.000053,1,2,1,3,2806,2834,5640,16,0.120915,0.177609,236.333333,0,0
8571941,"Le Fuet, Chemin de la Bottière",,0.000056,1,1,1,2,2834,2834,5668,15,0.133829,0.201604,246.333333,0,0
8571943,"Châtelat, village",,0.000028,1,2,1,3,2086,2060,4146,8,0.246753,0.317607,44.666667,0,0
8571962,Plain-Fahyn,,0.000019,1,1,1,2,1513,1513,3026,7,0.288889,0.372527,8.666667,0,0
8571963,Les Ecorcheresses,,0.000037,1,2,3,5,2468,2468,4936,6,0.375,0.523611,30,0,0
8571945,"Fornet-Dessous, bif. Pré-Piat",,0.00005,1,2,1,3,1828,1855,3683,15,0.118056,0.166345,116,0,0
8571946,"Fornet-Dessous, village",,0.000054,1,1,1,2,1855,1855,3710,14,0.129921,0.180314,120,0,0
8571947,"Fornet-Dessus, village",,0.000057,1,1,1,2,1855,1855,3710,13,0.144796,0.199643,122,0,0
8571948,"Fornet-Dessus, Dos des Laves",,0.000059,1,1,1,2,1855,1855,3710,12,0.164021,0.229201,122,0,0
8571951,"Saicourt, poste",,0.000062,1,2,2,4,2861,2833,5694,13,0.154255,0.260772,265.333333,0,0
8581110,"Reconvilier, FMB",,0.000036,1,2,1,3,950,923,1873,4,0.4,0.486111,0,0,0
8571952,"Saules BE, poste",,0.000037,1,1,1,2,2419,2349,4768,12,0.163743,0.242449,184.5,0,0
8571957,"Moutier, gare",,0.00003,1,3,3,6,6437,9504,15941,6,0.314815,0.440196,58.666667,0,0
8571959,"Moutier, cimetière",,0.000019,1,1,2,3,6002,5946,11948,7,0.275862,0.374554,23,0,0
8571961,"Perrefitte, Blocs",,0.000027,1,1,3,4,4107,4107,8214,6,0.358974,0.490476,26,0,0
8571964,"Souboz, village",,0.000031,1,2,3,5,2201,2200,4401,6,0.366667,0.525758,20.666667,0,0
8578062,"Moutier, Les Fauvettes",,0.000054,1,5,1,6,4105,4105,8210,6,0.3125,0.403333,10,0,0
8571960,"Moutier, La Foule",,0.000019,1,1,1,2,4107,4107,8214,7,0.277778,0.352857,20,0,0
8583687,"Perrefitte, Les Rouges-Champs",,0.000112,1,3,1,4,1513,508,2021,1,1,1,13.666667,0,0
8572034,"St-Ursanne, gare",,0.000058,52,2,3,5,6253,7726,13979,10,0.236842,0.391424,108,0,0
8572035,"St-Ursanne, Le Tillot",,0.000027,52,1,1,2,118,118,236,14,0.138211,0.22124,0,0,0
8572039,"Ocourt, Moulin-du-Doubs",,0.000059,52,1,2,3,1353,1353,2706,10,0.213115,0.366331,59,0,0
8572040,La Motte,,0.000036,52,1,1,2,669,711,1380,10,0.2,0.313525,0,0,0
8572036,"St-Ursanne, bif. sur Seleute",,0.00005,52,2,1,3,1353,1353,2706,13,0.150943,0.2373,44,0,0
8572037,"St-Ursanne, Chamsat",,0.000054,52,1,1,2,1353,1353,2706,12,0.166667,0.259103,51,0,0
8572038,"St-Ursanne, Bellefontaine",,0.000057,52,1,1,2,1353,1353,2706,11,0.186667,0.293086,56,0,0
8572042,"Porrentruy, ville",,0.00002,50,1,1,2,5237,5237,10474,6,0.282051,0.362121,56,0,0
8572044,"Porrentruy, bif. de Beaupré",,0.00002,50,1,2,3,3264,3342,6606,6,0.294118,0.398889,56,0,0
8572045,"Porrentruy, Haut de la Presse",,0.00002,50,1,2,3,3351,3337,6688,6,0.294118,0.398889,56,0,0
8572053,"Fahy, douane",,0.000053,50,1,1,2,6455,6455,12910,6,0.3,0.392593,45,0,0
8572047,"Porrentruy, Varandin",,0.000028,50,2,1,3,6455,6455,12910,11,0.155556,0.242775,50,0,0
8572048,"Bure, haut du village",,0.000035,50,1,1,2,6455,6455,12910,10,0.171053,0.25873,53,0,0
8572050,"Bure, Buratte",,0.00004,50,1,1,2,6455,6455,12910,9,0.190476,0.278208,54,0,0
8572051,"Fahy, poids public",,0.000045,50,1,1,2,6455,6455,12910,8,0.215686,0.303139,53,0,0
8572052,"Fahy, église",,0.000049,50,1,1,2,6455,6455,12910,7,0.25,0.337619,50,0,0
8572054,"Porrentruy, Hôpital entrée",,0.000073,50,3,2,5,6679,6693,13372,5,0.380952,0.514583,120,0,0
8581962,"Porrentruy, avenue Cuenin",,0.000042,50,1,2,3,6615,6613,13228,5,0.368421,0.516667,17,0,0
8572061,"Grandfontaine, poste",,0.000011,51,0,2,2,0,1107,1107,4,0.461538,0.597222,0,0,0
8572063,"Grandfontaine, bas du village",,0.000024,51,1,1,2,807,1940,2747,4,0.4,0.520833,4,0,0
8572062,"Grandfontaine, haut du village",,0.000016,51,1,1,2,807,807,1614,5,0.333333,0.456667,1,0,0
8572064,"Grandfontaine, bif. Roche d'Or",,0.000036,51,2,1,3,2240,2240,4480,3,0.5,0.611111,9,0,0
8572065,"Réclère, village",,0.000041,51,1,1,2,2240,2240,4480,2,0.666667,0.75,8,0,0
8572067,"Damvant, église",,0.000046,51,1,1,2,2240,376,2616,1,1,1,5,0,0
8572068,"Coeuve, rte de Porrentruy",,0.000026,50,2,1,3,5961,5264,11225,7,0.215686,0.299351,88,0,0
8572069,"Coeuve, école",,0.000033,50,1,1,2,5264,5264,10528,6,0.25,0.33,90,0,0
8572070,"Damphreux, Le Coinat",,0.000039,50,1,1,2,5264,5264,10528,5,0.3,0.374074,90,0,0
8572071,"Lugnez, Union",,0.000044,50,1,1,2,5264,5264,10528,4,0.380952,0.447917,88,0,0
8572072,"Lugnez, Rauracienne",,0.000048,50,1,2,3,5264,5264,10528,3,0.538462,0.619048,84,0,0
8572075,"Beurnevésin, Couronne",,0.000043,50,1,1,2,5173,5173,10346,2,0.571429,0.625,8,0,0
8572073,"Lugnez, Terrain de football",,0.000031,50,1,1,2,5173,5173,10346,4,0.333333,0.430556,26,0,0
8572074,"Beurnevésin, poste",,0.000038,50,1,1,2,5173,5173,10346,3,0.416667,0.5,18,0,0
8572078,"Porrentruy, Mont Terri",,0.000028,50,1,2,3,5237,5237,10474,5,0.357143,0.47,58,0,0
8572081,"Bressaucourt, Les Brussattes",,0.000037,50,1,1,2,5169,5169,10338,5,0.318182,0.409524,14,0,0
8572079,"Bressaucourt, bas du village",,0.000023,50,1,1,2,5169,5169,10338,7,0.230769,0.328836,20,0,0
8572080,"Bressaucourt, poste",,0.00003,50,1,1,2,5169,5169,10338,6,0.266667,0.3625,18,0,0
8572082,"Fontenais,place de la Fontaine",,0.00002,50,1,1,2,5731,5880,11611,5,0.333333,0.436111,48,0,0
8572083,"Fontenais, sur Les Rochets",,0.000028,50,1,1,2,5880,5880,11760,4,0.416667,0.516667,45,0,0
8572084,Villars-sur-Fontenais,,0.000035,50,1,2,3,5880,5880,11760,3,0.571429,0.708333,40,0,0
8582126,"Porrentruy, Rasse",,0.000039,50,1,1,2,5731,5731,11462,1,1,1,2,0,0
8572085,"Porrentruy, Rte de Courgenay",,0.00002,50,1,1,2,5549,5549,11098,20,0.091286,0.169714,176,0,0
8572086,"Courgenay, Pierre Percée",,0.000028,50,1,1,2,5549,5549,11098,19,0.09589,0.175914,189,0,0
8572088,"Courgenay, haut du village",,0.000035,50,1,1,2,5549,5549,11098,18,0.10101,0.182697,200,0,0
8572089,"Cornol, bas du village",,0.00004,50,1,1,2,5549,5549,11098,17,0.106742,0.190167,209,0,0
8572092,"Fregiécourt, place La Baroche",,0.000045,50,1,1,2,5549,5549,11098,16,0.113208,0.198466,216,0,0
8572093,"Pleujouse, bas du village",,0.000049,50,1,1,2,5549,5549,11098,15,0.120567,0.207795,221,0,0
8572094,"Asuel, école",,0.000053,50,1,1,2,5549,5549,11098,14,0.129032,0.218447,224,0,0
8572095,"Asuel, Maison communale",,0.000056,50,1,1,2,5549,5549,11098,13,0.138889,0.230898,225,0,0
8572099,"Charmoille, anc. poste",,0.000058,50,1,1,2,5549,5549,11098,12,0.150538,0.246009,224,0,0
8572100,"Charmoille, village",,0.000061,50,1,1,2,5549,5549,11098,11,0.164557,0.265632,221,0,0
8572101,"Charmoille, douane",,0.000062,50,1,1,2,5549,5549,11098,10,0.181818,0.295007,216,0,0
8572102,"St-Ursanne, Lorette",,0.000083,52,3,2,5,7768,7716,15484,9,0.229167,0.393543,143,0,0
8576784,"Soubey, restaurant Relais",,0.000065,52,1,1,2,2431,2431,4862,2,0.666667,0.75,16,0,0
8572103,"Montenol, village",,0.000046,52,1,1,2,2430,2431,4861,10,0.181818,0.292897,112,0,0
8572104,"Montenol, Prés-de-Montenol",,0.00005,52,1,1,2,2431,2431,4862,9,0.2,0.31433,107,0,0
8572105,Chez-le-Baron,,0.000053,52,1,1,2,2431,2431,4862,8,0.222222,0.339732,100,0,0
8572106,"Epauvillers, bif. sur Le Péca",,0.000056,52,1,1,2,2431,2431,4862,7,0.25,0.370408,91,0,0
8572107,"Epauvillers, haut du village",,0.000059,52,1,1,2,2431,2431,4862,6,0.285714,0.408333,80,0,0
8572108,"Epiquerez, Montbion",,0.000061,52,1,1,2,2431,2431,4862,5,0.333333,0.456667,67,0,0
8572109,Essertfallon,,0.000063,52,1,1,2,2431,2431,4862,4,0.4,0.520833,52,0,0
8572110,"Soubey, Chercenay",,0.000064,52,1,1,2,2431,2431,4862,3,0.5,0.611111,35,0,0
8572113,"Laufen, Bahnhof",,0.000076,54,6,5,11,17655,18942,36597,39,0.056827,0.131768,2063.666667,0,0
8572115,"Breitenbach, Grien",,0.000024,54,1,1,2,123,123,246,9,0.174419,0.252196,0,0,0
8572175,"Bärschwil, Hölzlirank",,0.000028,54,1,2,3,6452,6466,12918,4,0.4375,0.559524,14,0,0
8572123,"Nunningen, See",,0.000027,53,1,1,2,5674,5672,11346,12,0.147826,0.224304,25,0,0
8572125,"Nunningen, Engi",,0.000034,53,1,1,2,5672,5674,11346,11,0.163265,0.240826,38,0,0
8572126,"Nunningen, Engimühle",,0.00004,53,1,1,2,5674,5674,11348,10,0.182927,0.262672,49,0,0
8572127,"Nunningen, Roderis",,0.000045,53,1,1,2,5674,5674,11348,9,0.208955,0.294331,58,0,0
8572129,"Himmelried, Waldeck",,0.000061,53,2,3,5,5950,7181,13131,7,0.3,0.47996,96,0,0
8572130,"Himmelried, Schulhaus",,0.000028,53,1,2,3,4030,5925,9955,6,0.305556,0.430303,63,0,0
8582811,"Himmelried, Schindelboden",,0.000045,53,1,1,2,1740,1740,3480,2,0.666667,0.75,4,0,0
8572132,"Grellingen, Bahnhof",,0.00004,53,2,1,3,10245,4571,14816,4,0.384615,0.483333,60,0,0
8572141,"Seewen SO, Bödeli",,0.000045,53,1,1,2,4571,4571,9142,3,0.5,0.583333,52,0,0
8572142,"Seewen SO, Seetalhöhe",,0.000049,53,1,2,3,4571,4571,9142,2,0.75,0.833333,42,0,0
8572210,"Seewen SO, Zelgli",,0.000032,53,1,1,2,328,328,656,2,0.666667,0.75,0,0,0
8572143,"Laufen, Katholische Kirche",,0.000024,54,1,1,2,663,663,1326,18,0.108225,0.174138,315,0,0
8572144,"Laufen, Bromberg",,0.000031,54,1,1,2,663,663,1326,17,0.116505,0.184568,320,0,0
8572145,"Röschenz, Unterdorf",,0.000037,54,1,1,2,663,663,1326,16,0.126374,0.19823,323,0,0
8572158,"Röschenz, Oberdorf",,0.000043,54,1,1,2,663,663,1326,15,0.138365,0.218361,324,0,0
8572161,"Metzerlen, Dorf",,0.000088,54,4,1,5,5666,5664,11330,13,0.163793,0.245446,463,0,0
8572164,"Flüh, Schulhaus",,0.000115,54,2,2,4,10433,13671,24104,11,0.21519,0.363914,527.6,0,0
8572165,"Hofstetten SO, Unterdorf",,0.00006,54,1,2,3,7307,7307,14614,10,0.206897,0.369081,396,0,0
8572167,"Burg im Leimental, Dorfplatz",,0.000054,54,2,1,3,2141,1154,3295,1,1,1,34,0,0
8572168,"Laufen, Wandplattenfabrik",,0.000044,54,2,1,3,6878,6878,13756,8,0.197183,0.277041,156.5,0,0
8572169,"Wahlen b. Laufen, Unterdorf",,0.000048,54,1,1,2,6878,6878,13756,7,0.22807,0.315568,149.5,0,0
8572170,"Wahlen b. Laufen, Traube",,0.000052,54,1,2,3,6878,6878,13756,6,0.272727,0.397222,140.5,0,0
8572171,"Wahlen b. Laufen, Oberdorf",,0.000033,54,1,2,3,6755,6754,13509,5,0.323529,0.437879,112,0,0
8572173,"Grindel, Oberdorf",,0.000032,54,1,3,4,6522,6522,13044,3,0.529412,0.62963,82,0,0
8572196,"Liesberg, Seemättli",,0.000025,54,1,2,3,7566,2804,10370,2,0.666667,0.75,41.5,0,0
8572197,"Liesberg, Ochsengasse",,0.000022,54,1,2,3,2739,3864,6603,2,0.75,0.833333,1,0,0
8572172,"Grindel, Unterdorf",,0.000025,54,1,1,2,6522,6522,13044,4,0.37037,0.433333,97,0,0
8572194,"Bärschwil, Station",,0.000036,54,2,1,3,5499,5499,10998,3,0.461538,0.527778,112.5,0,0
8572174,"Bärschwil, Oberdorf",,0.00002,54,1,1,2,6424,6452,12876,5,0.333333,0.420833,33,0,0
8572180,"Zwingen, Bahnhof",,0.000052,54,4,3,7,11474,12310,23784,35,0.054315,0.111365,2105.666667,0,0
8572198,"Dittingen, Buchholz",,0.000048,54,3,2,5,6923,5562,12485,4,0.466667,0.583333,80.833333,0,0
8572199,"Dittingen, Dorf",,0.000031,54,1,3,4,2276,3193,5469,3,0.6,0.722222,26.5,0,0
8572201,"Blauen, Dorfplatz",,0.000056,54,1,2,3,2324,3151,5475,3,0.571429,0.708333,13.5,0,0
8572181,"Brislach, Lärchenweg",,0.000026,54,1,1,2,9458,9458,18916,34,0.052859,0.077269,2089,0,0
8572183,"Brislach, Oberdorf",,0.000033,54,1,1,2,9458,9457,18915,33,0.055239,0.079907,2154,0,0
8572185,"Breitenbach, Bandfabrik",,0.000063,54,3,1,4,9894,9907,19801,31,0.060781,0.086272,2368,0,0
8572186,"Büsserach, Niederfeld",,0.000064,54,1,1,2,9907,9907,19814,30,0.064033,0.09018,2427,0,0
8572187,"Büsserach, Alte Mühle",,0.000065,54,1,1,2,9907,9907,19814,29,0.067686,0.09475,2484,0,0
8572188,"Büsserach, Ziegelhütte",,0.000066,54,1,1,2,9907,9894,19801,28,0.071819,0.100185,2539,0,0
8572189,"Erschwil, St. Benedikt",,0.000067,54,1,1,2,9894,2332,12226,27,0.076535,0.106794,2592,0,0
8572190,"Beinwil SO, Bachmättli",,0.000068,54,1,1,2,2332,2332,4664,26,0.081967,0.115071,2643,0,0
8572191,"Beinwil SO, Kloster",,0.000069,54,1,1,2,2332,2332,4664,25,0.088294,0.125886,2692,0,0
8572192,"Beinwil SO, Schachen",,0.000069,54,1,1,2,2332,937,3269,24,0.095756,0.14107,2739,0,0
8572195,"Liesberg, Station",,0.00005,54,2,3,5,5564,9363,14927,2,0.714286,0.8,118.5,0,0
8579511,"Laufen, Delsbergerstrasse",,0.000034,54,2,1,3,5197,5196,10393,1,1,1,0.5,0,0
8580734,"Laufen, Wahlenstrasse",,0.000088,54,6,1,7,6919,274,7193,1,1,1,9.5,0,0
8572204,"Nenzlingen, Dorfplatz",,0.000066,54,1,1,2,5370,5247,10617,1,1,1,2,0,0
8572200,"Zwingen, Schützenhaus",,0.000053,54,4,1,5,6437,2324,8761,4,0.416667,0.516667,43.5,0,0
8572202,"Zwingen, Strengenfeld",,0.000064,54,4,1,5,5370,5370,10740,3,0.5,0.611111,72,0,0
8572203,"Zwingen, Nenzlingenmatten",,0.000065,54,1,1,2,5370,5370,10740,2,0.666667,0.75,38,0,0
8572220,"Büren SO, Unterdorf",,0.000022,2,1,1,2,4394,4394,8788,10,0.181818,0.292897,0,0,0
8572349,"Waldenburg, Revue Thommen",,0.000064,94,1,1,2,7255,7255,14510,15,0.115385,0.181243,1680,0,0
8578315,Pratteln Hülften,,0.000036,2,1,1,2,28051,28051,56102,15,0.121849,0.137572,1693.333333,0,0
8578317,Füllinsdorf Schönthal,,0.000055,2,1,3,4,28369,28369,56738,13,0.159778,0.195666,2093.333333,0,0
8572218,Seltisberg Alte Post,,0.000046,2,1,1,2,17972,17972,35944,14,0.141215,0.168871,1032,0,0
8578248,Bretzwil Eichhöhe,,0.000043,2,1,3,4,2896,643,3539,14,0.144376,0.18086,341.166667,0,0
8578318,Liestal Kantonsspital,,0.000038,2,2,4,6,40637,40377,81014,14,0.145025,0.188461,572.78956,0,0
8578320,Liestal Wasserturmplatz,,0.000136,2,8,7,15,107321,107321,214642,13,0.163799,0.214554,7941.458789,0,0
8588878,Frenkendorf Dorfplatz,,0.000034,2,1,1,2,29847,29847,59694,8,0.247706,0.31336,27,0,0
8588855,Pratteln Grüssen,,0.000119,2,3,2,5,26029,26029,52058,6,0.30303,0.445,558.728571,0,0
8589405,Giebenacherstrasse,,0.000048,2,3,3,6,18444,18617,37061,7,0.289474,0.478139,106.721429,0,0
8589406,Mühlematt,,0.000031,2,2,1,3,15674,15674,31348,7,0.25641,0.359286,0,0,0
8572214,Liestal Burg,,0.000022,2,1,1,2,17972,17972,35944,18,0.091321,0.10195,104,0,0
8572215,Liestal Eglisacker,,0.00003,2,1,1,2,17972,17972,35944,17,0.100115,0.112169,339,0,0
8572216,Liestal Kinderheim auf Berg,,0.000036,2,1,1,2,17972,17972,35944,16,0.110827,0.125295,572,0,0
8572217,Seltisberg Sonnenblick,,0.000041,2,1,1,2,17972,17972,35944,15,0.124161,0.142989,803,0,0
8572221,"Liestal, Oris",,0.000041,2,2,1,3,6674,6674,13348,9,0.2,0.31433,243,0,0
8572222,"Liestal, Zeughaus",,0.000045,2,1,1,2,6674,6688,13362,8,0.222222,0.339732,224,0,0
8572223,"Nuglar, Neunuglar",,0.000049,2,1,1,2,6688,6675,13363,7,0.25,0.370408,203,0,0
8572224,"Nuglar, Orismühle",,0.000053,2,1,1,2,6675,4995,11670,6,0.285714,0.408333,180,0,0
8572225,"Nuglar, Neumatt",,0.000056,2,1,1,2,4995,5534,10529,5,0.333333,0.456667,155,0,0
8572226,"Nuglar, Schulhaus",,0.000058,2,1,1,2,5534,5534,11068,4,0.4,0.520833,128,0,0
8572227,"Nuglar, St. Pantaleonstrasse",,0.000061,2,1,1,2,5534,5534,11068,3,0.5,0.611111,99,0,0
8572228,"St. Pantaleon, bei den Tannen",,0.000062,2,1,1,2,5534,4394,9928,2,0.666667,0.75,68,0,0
8572229,Liestal Gestadeckplatz,,0.000022,2,1,1,2,12200,12200,24400,20,0.075643,0.083998,350,0,0
8572230,Liestal Altersheim,,0.00003,2,1,1,2,12200,12200,24400,19,0.081568,0.090514,632,0,0
8572231,Liestal Äussere Arisdörferstr,,0.000036,2,1,1,2,12200,12200,24400,18,0.088524,0.098411,912,0,0
8572232,Liestal Im Rank,,0.000041,2,1,1,2,12200,12200,24400,17,0.096805,0.108251,1190,0,0
8572233,Liestal Leisenberg,,0.000046,2,1,1,2,12200,12200,24400,16,0.10683,0.12108,1466,0,0
8572236,Hersberg Schützen,,0.000025,2,1,1,2,11082,11082,22164,16,0.106278,0.118579,0,0,0
8572238,Arisdorf Kreuz,,0.000068,2,3,1,4,12283,12252,24535,14,0.134016,0.15574,3540.752381,0,0
8578346,Giebenach Rainweg,,0.000064,2,4,4,8,12416,12416,24832,13,0.151574,0.184335,2949.514546,0,0
8578348,"Kaiseraugst, Liebrüti",,0.000082,2,4,5,9,27249,28110,55359,13,0.154557,0.191595,4031.595288,0,0
8578349,"Kaiseraugst, Bahnhof",,0.000025,2,1,4,5,24442,23523,47965,13,0.153999,0.188125,0,0,0
8578350,Pratteln Längi,,0.000044,2,3,2,5,11284,11284,22568,13,0.150212,0.176462,0,0,0
8578356,Pratteln Rankacker,,0.000073,2,2,3,5,25712,25712,51424,7,0.280488,0.385197,107.892857,0,0
8572244,"Magden, Schwimmbad",,0.00002,2,1,1,2,2218,2232,4450,18,0.088551,0.098762,216,0,0
8572245,"Olsberg, Schönenbühl",,0.000028,2,1,1,2,2232,2218,4450,17,0.096748,0.107903,400,0,0
8572246,"Olsberg, Vorstadt",,0.000034,2,1,1,2,2218,2218,4436,16,0.106661,0.119439,582,0,0
8572247,"Olsberg, Mitteldorf",,0.00004,2,1,1,2,2218,2232,4450,15,0.118892,0.134615,762,0,0
8572249,"Rheinfelden, Bahnhof",,0.000029,2,3,2,5,11454,33919,45373,15,0.124642,0.149576,757,0,0
8572250,"Rheinfelden, Post",,0.000023,2,1,2,3,18945,8345,27290,7,0.266667,0.348313,70,0,0
8572313,"Möhlin, Bahnhof",,0.000041,2,3,4,7,5960,5688,11648,4,0.5,0.628788,63.383333,0,0
8572270,"Rheinfelden, Altersheim",,0.000021,2,1,2,3,3936,7315,11251,5,0.388889,0.540476,35,0,0
8589428,"Rheinfelden, Flossländeweg",,0.00002,2,1,1,2,7207,7221,14428,5,0.352941,0.463889,0,0,0
8572282,"Gelterkinden, Bahnhof",,0.000089,55,3,4,7,16767,17494,34261,7,0.26,0.377289,308,0,0
8572283,Obere Mühle,,0.00003,55,1,1,2,11454,10776,22230,7,0.22807,0.300733,0,0,0
8572299,"Gelterkinden, Rünenbergerbr.",,0.00003,55,1,2,3,5696,5158,10854,6,0.305556,0.430303,61,0,0
8572284,"Gelterkinden, Maloya",,0.000055,55,2,1,3,11021,11288,22309,6,0.272727,0.348611,168,0,0
8572285,"Ormalingen, Schulhaus",,0.000058,55,1,2,3,11288,11261,22549,5,0.34375,0.45,165,0,0
8572286,"Ormalingen, Hemmikerstrasse",,0.000035,55,1,1,2,3963,3963,7926,6,0.290323,0.374074,64,0,0
8572290,"Hemmiken, Stiegelmatt",,0.000041,55,1,1,2,3963,3879,7842,5,0.363636,0.452083,56,0,0
8572291,"Hemmiken, Friedhof",,0.000046,55,1,3,4,3879,3963,7842,4,0.5,0.654762,46,0,0
8572293,"Ormalingen, Oberdorf",,0.000035,55,1,1,2,7298,7298,14596,6,0.304348,0.421429,80,0,0
8572298,"Kienberg, Kreuz",,0.000065,55,1,1,2,7828,443,8271,2,0.666667,0.75,10,0,0
8580467,"Hemmiken, Junkerschloss",,0.000079,55,2,1,3,3655,3631,7286,1,1,1,6,0,0
8572294,"Rothenfluh, Säge",,0.000054,55,2,2,4,7801,7389,15190,5,0.375,0.547222,82,0,0
8572295,"Rothenfluh, Asphof",,0.000034,55,1,1,2,502,503,1005,5,0.333333,0.456667,0,0,0
8572296,"Anwil, Talweiher",,0.000063,55,2,1,3,7390,7390,14780,4,0.4,0.520833,50,0,0
8572297,"Anwil, Ausserdorf",,0.000064,55,1,1,2,7390,7828,15218,3,0.5,0.611111,31,0,0
8572306,"Oltingen, Schulhaus",,0.000035,55,1,1,2,319,351,670,5,0.333333,0.456667,15,0,0
8572301,"Tecknau, Mitteldorf",,0.000042,55,2,1,3,450,449,899,8,0.212766,0.308452,70,0,0
8572302,"Tecknau, Bahnhof",,0.000047,55,1,1,2,449,449,898,7,0.243243,0.338095,65,0,0
8572303,"Wenslingen, Hinterdorf",,0.000051,55,1,1,2,449,449,898,6,0.285714,0.379167,58,0,0
8572304,"Wenslingen, Mooshof",,0.000054,55,1,1,2,449,449,898,5,0.35,0.445238,49,0,0
8572307,"Gelterkinden, Musikschule",,0.000053,55,2,1,3,5158,5256,10414,4,0.4,0.520833,66,0,0
8572308,"Rünenberg, Unterdorf",,0.000056,55,1,1,2,5256,5158,10414,3,0.5,0.611111,49,0,0
8572311,"Zeglingen, Sagi",,0.000091,55,3,1,4,5620,5046,10666,1,1,1,23,0,0
8577361,"Möhlin, Schallen",,0.000037,2,2,3,5,4137,4112,8249,4,0.47619,0.591667,29.616667,0,0
8580474,"Möhlin, Bäumlimatt Ost",,0.00003,2,2,2,4,1570,1474,3044,5,0.391304,0.512963,12.141667,0,0
8580475,"Möhlin, Industriestrasse",,0.000032,2,2,3,5,1029,1098,2127,4,0.5,0.635417,17.15,0,0
8580477,"Möhlin, Sportzentrum",,0.000033,2,2,2,4,1543,1950,3493,4,0.466667,0.583333,11.458333,0,0
8572315,"Balsthal, Zentrum",,0.000092,94,4,2,6,13869,13855,27724,22,0.086912,0.130033,2254,0,0
8572316,"Balsthal, Brauerei",,0.00005,94,1,1,2,6493,6493,12986,13,0.108796,0.141579,439,0,0
8572317,"Balsthal, St. Wolfgang",,0.000053,94,1,1,2,6493,6493,12986,12,0.119481,0.15191,435,0,0
8572318,"Mümliswil, Lobisei",,0.000056,94,1,1,2,6493,6578,13071,11,0.132743,0.16516,429,0,0
8572319,"Mümliswil, Kammfabrik",,0.000059,94,1,1,2,6578,6578,13156,10,0.14966,0.182991,421,0,0
8572320,"Mümliswil, Schulhaus",,0.000061,94,1,1,2,6578,6493,13071,9,0.172,0.208933,411,0,0
8572322,"Ramiswil, Abzw. Scheltenstr.",,0.000037,94,1,1,2,878,937,1815,2,0.666667,0.75,112,0,0
8572323,"Ramiswil, Kapelle",,0.000043,94,1,1,2,937,937,1874,1,1,1,57,0,0
8572325,"Balsthal, Thalbrücke",,0.000071,94,3,1,4,3560,3787,7347,7,0.234568,0.27287,2128,0,0
8572371,"Oensingen, Post",,0.000052,94,1,1,2,6281,9169,15450,7,0.234568,0.27287,589,0,0
8572343,"Balsthal, Pfadiheim",,0.00005,94,1,1,2,7362,7362,14724,21,0.078091,0.130097,1800,0,0
8572344,"Holderbank SO, Seblenhof",,0.000053,94,1,1,2,7362,7255,14617,20,0.082353,0.134885,1785,0,0
8572345,"Holderbank SO, Steinbruch",,0.000056,94,1,1,2,7255,7255,14510,19,0.087179,0.140403,1768,0,0
8572346,"Langenbruck, Unterdorf",,0.000059,94,1,1,2,7255,7255,14510,18,0.092697,0.146933,1749,0,0
8572347,"Langenbruck, Passhöhe",,0.000061,94,1,1,2,7255,7255,14510,17,0.099071,0.154973,1728,0,0
8572348,"Langenbruck, Spittel",,0.000063,94,1,1,2,7255,7255,14510,16,0.106529,0.165536,1705,0,0
8572351,"Waldenburg, Bahnhof",,0.000076,2,2,2,4,13710,13710,27420,14,0.126087,0.213203,1835,0,0
8578028,"Hägendorf, Nellen",,0.000044,94,1,1,2,33973,33972,67945,20,0.105521,0.152456,881.833333,0,0
8578025,"Kappel SO, Schulhaus",,0.000039,94,1,2,3,14425,14426,28851,19,0.159836,0.220112,1581.783333,0,0
8578037,"Olten, Hammer BOGG",,0.000057,94,1,1,2,34222,34222,68444,19,0.151163,0.195499,662.1,0,0
8578045,"Trimbach, Duleten",,0.00004,94,1,1,2,5705,5705,11410,28,0.078473,0.112607,222,0,0
8590290,"Trimbach, Schilla",,0.000068,94,3,2,5,64244,63151,127395,12,0.162162,0.256721,1063.358333,0,0
8578039,"Olten, Baslerstrasse",,0.000085,94,1,7,8,79194,79187,158381,17,0.210526,0.336752,3828.140476,0,0
8572353,"Aarburg, Längacker",,0.000019,94,1,1,2,33763,33763,67526,8,0.195122,0.23032,569,0,0
8572354,"Aarburg, Höhe",,0.000027,94,1,1,2,33763,33763,67526,7,0.234848,0.27235,555,0,0
8572355,"Aarburg, Städtli",,0.000034,94,1,2,3,33763,33763,67526,6,0.29703,0.350556,539,0,0
8572681,"Oftringen, Schulhaus/Kirche",,0.000059,94,1,1,2,16432,16432,32864,7,0.230769,0.264762,282,0,0
8572368,"Wolfwil, Oberdorf",,0.000077,94,1,2,3,7405,7403,14808,10,0.246988,0.312495,1281,0,0
8572372,"Oensingen, Bahnhof",,0.000115,94,2,3,5,12956,11144,24100,6,0.298387,0.363964,2676,0,0
8572682,"Oftringen, Baslerstrasse",,0.000075,94,2,1,3,41280,41281,82561,6,0.29,0.328161,283,0,0
8572356,"Boningen, Ruppoldingen",,0.000031,94,3,1,4,7059,6989,14048,21,0.076135,0.111236,807,0,0
8572358,"Boningen, Kappelerstrasse",,0.000038,94,1,1,2,6989,6988,13977,20,0.080824,0.115613,813,0,0
8572359,"Boningen, Gsteigli",,0.000043,94,1,1,2,6988,6985,13973,19,0.086207,0.120636,817,0,0
8572360,"Boningen, Hausenmühli",,0.000047,94,1,1,2,6985,6986,13971,18,0.092453,0.126483,819,0,0
8572362,"Fulenbach, Boningerstrasse",,0.000067,94,3,1,4,7374,7360,14734,16,0.108545,0.141749,877,0,0
8572363,"Fulenbach, Höchi",,0.000068,94,1,1,2,7360,7360,14720,15,0.119171,0.152071,873,0,0
8572364,"Fulenbach, Altes Schulhaus",,0.000068,94,1,1,2,7360,7360,14720,14,0.132353,0.165229,867,0,0
8572365,"Fulenbach, Wolfwilerstrasse",,0.000069,94,1,1,2,7360,7360,14720,13,0.149153,0.182683,859,0,0
8572367,"Wolfwil, Schulhaus",,0.000077,94,2,1,3,7583,7405,14988,11,0.201923,0.244578,1295,0,0
8572369,"Wolfwil, Schweissacker",,0.000044,94,1,1,2,6181,6281,12462,9,0.165975,0.19752,627,0,0
8572370,"Kestenholz, Rain",,0.000048,94,1,1,2,6281,6281,12562,8,0.19403,0.226618,609,0,0
8572373,"Solothurn, Hauptbahnhof",,0.000065,56,3,1,4,5731,5729,11460,10,0.156863,0.23192,128,0,0
8572376,"Solothurn, St. Katharinen",,0.000066,56,1,1,2,5729,5729,11458,9,0.174419,0.248757,135,0,0
8572377,"Feldbrunnen, Bahnhof",,0.000067,56,1,1,2,5729,5729,11458,8,0.197183,0.270493,140,0,0
8572378,"Riedholz, Bahnhof",,0.000068,56,1,1,2,5729,5729,11458,7,0.22807,0.300733,143,0,0
8572380,"Hubersdorf, Siggern",,0.000069,56,1,1,2,5729,5729,11458,6,0.272727,0.348611,144,0,0
8572381,"Günsberg, Neue Balmbergstrasse",,0.000069,56,1,2,3,5729,5729,11458,5,0.34375,0.45,143,0,0
8572382,"Günsberg, Bangerten",,0.00004,56,1,2,3,5235,4917,10152,4,0.416667,0.508333,98,0,0
8572385,"Balmberg, Mittler-Balmberg",,0.000062,56,1,1,2,1473,1473,2946,4,0.388889,0.464286,14,0,0
8572383,"Günsberg, Längmatt",,0.000057,56,2,1,3,1153,1473,2626,6,0.257143,0.344444,30,0,0
8572384,"Balmberg, Vorder-Balmberg",,0.00006,56,1,1,2,1473,1473,2946,5,0.307692,0.389583,23,0,0
8572386,"Solothurn, Baseltor",,0.00008,56,2,2,4,5731,5729,11460,3,0.545455,0.638889,108,0,0
8578065,"Solothurn, Vorstadt",,0.000049,56,1,1,2,2134,2134,4268,3,0.5,0.583333,4,0,0
8578681,"Dättwil AG, Kantonsspital",,0.000079,22,6,3,9,30235,30235,60470,22,0.11632,0.139377,447.537851,0.00021,0.000763
8578914,"Baden, Bahnhof West",,0.000245,22,17,14,31,69761,76447,146208,20,0.149471,0.200654,100606.631092,0.001079,0.005538
8572389,"Küttigen, Stock",,0.000021,57,2,1,3,23246,23245,46491,41,0.040539,0.053737,1135.461538,0,0
8590156,"Aarau, Tellizentrum",,0.00007,57,2,2,4,16503,15800,32303,5,0.388889,0.540476,564,0,0
8590159,"Aarau, Wöschnauring",,0.000051,57,2,2,4,6452,6452,12904,7,0.264151,0.391837,48.961538,0,0
8590216,"Buchs AG, Wynenfeld",,0.000062,57,1,1,2,15143,968,16111,2,0.666667,0.75,16,0,0
8590261,"Aarau Rohr, Unterdorf",,0.000056,57,1,1,2,15712,1056,16768,2,0.666667,0.75,8,0,0
8594393,"Suhr, Schweizerhof",,0.000081,57,1,2,3,17068,1057,18125,1,1,1,26.5,0,0
8572391,"Densbüren, Ausserdorf",,0.000033,57,2,1,3,8047,7970,16017,39,0.042137,0.047434,3258,0,0
8572392,"Densbüren, Breite",,0.000039,57,1,1,2,7970,7970,15940,38,0.043952,0.049821,4378,0,0
8572394,"Ueken, Zeihen Abzw.",,0.000054,57,2,1,3,8092,8169,16261,36,0.048101,0.055756,6633.5,0,0
8572398,"Frick, Neumatt",,0.00003,57,1,4,5,9136,9589,18725,32,0.058677,0.072454,17003,0,0
8572397,"Frick, Unterdorf",,0.000046,57,3,2,5,16117,15720,31837,33,0.05602,0.069724,16487.5,0,0
8572414,"Frick, Firma Müller",,0.00003,57,1,1,2,963,963,1926,14,0.136546,0.177784,134,0,0
8572422,"Stein AG, Zürcherstrasse",,0.000048,57,1,2,3,7351,7351,14702,29,0.067765,0.08166,7334,0,0
8572413,"Frick, Ebnet",,0.000045,57,2,2,4,1111,1111,2222,15,0.130217,0.180997,227,0,0
8572748,"Stein-Säckingen, Bahnhof",,0.000054,57,3,3,6,10333,9625,19958,6,0.333333,0.479487,606,0,0
8572399,"Frick, Abzw. Ittenthal",,0.000017,57,1,1,2,6150,6150,12300,31,0.061255,0.070509,17842,0,0
8572424,"Laufenburg, Regionalspital",,0.000028,57,2,2,4,3383,3441,6824,29,0.067725,0.081168,532.5,0,0
8577981,"Frick, Bänihübel",,0.00006,57,3,2,5,8140,6781,14921,13,0.155814,0.216331,3454.5,0,0
8580562,"Kaisten, Ritanne",,0.000041,57,2,1,3,5817,3746,9563,2,0.666667,0.75,22,0,0
8580733,"Kaisten, Eigenmatt",,0.000028,57,1,2,3,3298,3368,6666,1,1,1,19.5,0,0
8581949,"Kaisten, Lümberg",,0.000043,57,3,1,4,6094,6150,12244,2,0.666667,0.75,46.5,0,0
8572416,"Sisseln AG, Breitenacher",,0.000028,57,2,1,3,5817,6386,12203,35,0.048446,0.054152,1475,0,0
8572417,"Sisseln AG, Unterdorf",,0.000035,57,1,2,3,6386,6386,12772,34,0.050864,0.057766,2461,0,0
8572418,"Sisseln AG, DSM",,0.000026,57,1,1,2,6264,7349,13613,33,0.05349,0.059752,3418,0,0
8572419,"Sisseln AG, Syngenta",,0.000033,57,1,1,2,7349,7351,14700,32,0.056459,0.063663,4400,0,0
8572420,"Stein AG, Novartis",,0.000039,57,1,1,2,7351,7351,14702,31,0.05978,0.068308,5380,0,0
8572421,"Stein AG, Coop",,0.000044,57,1,1,2,7351,7351,14702,30,0.063521,0.074028,6358,0,0
8572436,"Kaisten, Steigstich",,0.00002,57,2,1,3,3650,3298,6948,2,0.6,0.666667,85.5,0,0
8572438,"Sulz AG, Leidikon",,0.000052,57,3,2,5,3713,3728,7441,3,0.571429,0.708333,308,0,0
8572439,"Sulz AG, Mitteldorf",,0.000033,57,1,1,2,3536,3465,7001,3,0.5,0.611111,0,0,0
8572440,"Obersulz, Hauptstrasse",,0.000061,57,2,1,3,3657,3536,7193,2,0.666667,0.75,158,0,0
8572445,"Hottwil, Gassweg",,0.000049,57,1,2,3,10647,4137,14784,40,0.038945,0.044272,2050,0,0
8572530,"Leuggern, Gippingen Härdlestr.",,0.00004,57,2,4,6,7768,7398,15166,4,0.526316,0.658333,866.75,0,0
8572536,"Reuenthal AG, Dorfplatz",,0.000053,57,2,2,4,710,709,1419,3,0.555556,0.666667,140,0,0
8572537,"Leibstadt, Kernkraftwerk",,0.000034,57,1,1,2,216,216,432,3,0.5,0.583333,0,0,0
8572443,"Wil AG, Steinhof",,0.000039,57,3,1,4,12095,10661,22756,42,0.036198,0.040295,156,0,0
8572444,"Wil AG, Ausserdorf",,0.000044,57,1,1,2,10661,10647,21308,41,0.037521,0.042009,1104,0,0
8572446,"Oberhofen AG, Kreuz",,0.000048,57,2,2,4,4340,5732,10072,39,0.040481,0.046057,4353.666667,0,0
8572464,"Brugg AG, Bahnhof/Zentrum",,0.000119,57,5,4,9,30236,28805,59041,34,0.050359,0.059324,14760.266667,0,0
8572447,"Gansingen, Oberdorf",,0.000031,57,1,1,2,5081,5081,10162,38,0.04214,0.047404,5178,0,0
8572456,"Chur, Lacuna",,0.000015,109,1,2,3,22273,22282,44555,25,0.097781,0.125978,50,0,0
8581561,"Domat/Ems, Plaz",,0.000051,109,2,4,6,17321,15425,32746,6,0.375,0.524444,11456,0,0
8572455,"Effingen, Dorf",,0.000031,57,1,1,2,6055,6055,12110,4,0.4,0.520833,24,0,0
8572457,"Effingen, Schwerzbrünneli",,0.000038,57,1,1,2,6055,5694,11749,3,0.5,0.611111,21,0,0
8572458,"Zeihen, Abzw. Station Effingen",,0.000043,57,1,1,2,5694,5694,11388,2,0.666667,0.75,16,0,0
8572459,"Zeihen, Stauftel",,0.000047,57,1,1,2,5694,6055,11749,1,1,1,9,0,0
8572462,"Bözberg, Sandbrunnen",,0.000072,57,2,1,3,5908,5908,11816,36,0.045849,0.051813,129.066667,0,0
8572479,"Brugg AG, Eisi",,0.000036,57,1,1,2,7440,7440,14880,34,0.049943,0.054856,0,0,0
8572467,"Auenstein, Gemeindehaus",,0.000026,58,1,2,3,5104,5336,10440,5,0.342857,0.45,6,0,0
8572466,"Auenstein, Fahr",,0.000035,58,2,2,4,6294,6062,12356,6,0.309524,0.425641,35,0,0
8572476,"Schinznach Dorf, Oberdorf",,0.00006,58,2,1,3,4852,726,5578,4,0.4,0.486111,30,0,0
8572468,"Veltheim AG, Au",,0.000036,58,2,1,3,4854,4854,9708,8,0.207547,0.297944,35,0,0
8572469,"Veltheim AG, Vorerli",,0.000042,58,1,1,2,4854,4854,9708,7,0.238095,0.329286,38,0,0
8572471,"Veltheim AG, Bären",,0.000046,58,1,1,2,4854,4854,9708,6,0.28125,0.377778,39,0,0
8572473,"Schinznach Dorf, Steinachbr.",,0.00005,58,1,2,3,4854,4852,9706,5,0.347826,0.483333,38,0,0
8572474,"Schinznach Dorf, Gemeindehaus",,0.000032,58,1,1,2,2422,2422,4844,5,0.318182,0.409524,0,0,0
8572480,"Bözberg, Bächle",,0.000067,57,2,1,3,5908,5584,11492,6,0.285714,0.408333,576,0,0
8572481,"Bözberg, Hübel",,0.000068,57,1,1,2,5584,5584,11168,5,0.333333,0.456667,485,0,0
8572482,"Bözberg, Riedacher",,0.000068,57,1,1,2,5584,5465,11049,4,0.4,0.520833,392,0,0
8572483,"Brugg AG, Kaserne",,0.000067,57,2,1,3,18249,18249,36498,33,0.052516,0.05794,15910,0,0
8572484,"Lauffohr, Sommerhaldenstrasse",,0.000068,57,1,1,2,18249,18249,36498,32,0.055372,0.061492,16818,0,0
8572485,"Lauffohr, Langmatt",,0.000068,57,1,1,2,18249,18249,36498,31,0.058559,0.065692,17724,0,0
8572487,"Rüfenach AG, Vorderrein",,0.000049,57,2,1,3,5937,5937,11874,1,1,1,101,0,0
8572491,"Villigen, Vor Tor",,0.00004,57,1,2,3,8333,8333,16666,29,0.066063,0.075521,19348,0,0
8577360,"Böttstein, Schmidberg",,0.000028,57,1,1,2,5217,4919,10136,1,1,1,94,0,0
8572492,"Böttstein, Schloss",,0.000028,57,1,1,2,5217,4919,10136,28,0.070646,0.081287,20222,0,0
8572528,"Leuggern, Dietsche/Sternen",,0.000028,57,1,2,3,3889,3668,7557,5,0.4,0.495833,141.25,0,0
8572495,"Siggenthal-W., Bahnhof",,0.000061,57,4,1,5,9773,7860,17633,25,0.087452,0.097307,239,0,0
8572496,"Würenlingen, Breite-Lochacker",,0.000063,57,1,1,2,7860,7861,15721,24,0.095657,0.10818,730,0,0
8572497,"Würenlingen, Bären",,0.000064,57,1,3,4,7861,6441,14302,23,0.10558,0.123346,1219,0,0
8572579,"Untersiggenthal, Hölzli",,0.000023,22,1,3,4,9778,9661,19439,24,0.096251,0.113049,235,0.000053,0
8580164,"Würenlingen, Sonne",,0.000044,57,3,1,4,3749,3265,7014,1,1,1,0,0,0
8572502,"Bad Zurzach, Thermalbad",,0.00002,98,1,1,2,425,5926,6351,27,0.075288,0.088072,981,0,0.000002
8572501,"Bad Zurzach, Oberflecken",,0.000011,98,0,1,1,0,425,425,28,0.070083,0.0801,0,0,0
8572503,"Bad Zurzach, Bahnhof",,0.000046,98,2,4,6,6022,6260,12282,26,0.081335,0.099272,5292,0.000002,0
8578779,"Bad Zurzach, Höfli",,0.000021,98,1,2,3,4647,3579,8226,8,0.228814,0.315256,366,0,0
8578780,"Bad Zurzach, Promenade",,0.000029,98,2,3,5,3607,3569,7176,7,0.261364,0.368219,1243,0,0
8582509,"Bad Zurzach, Dachsweg",,0.000027,98,1,1,2,104,104,208,7,0.22807,0.302747,13,0,0
8582512,"Bad Zurzach, Tulpenweg",,0.000034,98,1,1,2,397,397,794,7,0.22807,0.302747,26,0,0
8572510,"Windisch, Gemeindehaus",,0.000031,22,1,1,2,4550,4827,9377,1,1,1,11.666667,0,0.00003
8581294,"Windisch, Kunzareal",,0.000061,22,1,1,2,7849,7887,15736,1,1,1,5.5,0,0.00003
8581730,"Baden, Rütihof Moosstrasse",,0.000055,22,1,5,6,20613,20492,41105,21,0.077899,0.107842,968.67152,0,0.000577
8578674,"Gebenstorf, Brühl",,0.000033,22,2,2,4,19377,18965,38342,23,0.105903,0.125312,1392,0,0.000026
8572513,"Birmenstorf AG, Schinebüel",,0.000042,22,3,1,4,19145,19145,38290,24,0.096194,0.109154,703.1,0.000069,0
8572514,"Birmenstorf AG, Gemeindehaus",,0.000047,22,1,1,2,19145,18709,37854,23,0.106239,0.123987,1188.1,0,0
8572516,"Windisch, Zelgli",,0.00005,22,2,1,3,5127,5172,10299,9,0.196078,0.299563,186,0,0
8572517,"Mülligen, Löh",,0.000053,22,1,1,2,5172,5172,10344,8,0.219512,0.324206,173,0,0
8572518,"Mülligen, Stock",,0.000056,22,1,1,2,5172,5172,10344,7,0.25,0.355357,158,0,0
8572519,"Birrhard, Steibode",,0.000059,22,1,1,2,5172,5172,10344,6,0.291667,0.397619,141,0,0
8572520,"Birrhard, Unterdorf",,0.000061,22,1,1,2,5172,5171,10343,5,0.352941,0.463889,122,0,0
8572522,"Windisch, Dammstrasse",,0.000044,22,2,1,3,4123,4123,8246,4,0.4,0.520833,78,0.000001,0
8572529,"Leuggern, Brühlmatt",,0.000023,57,1,1,2,3210,3403,6613,1,1,1,24.25,0,0
8580320,"Leuggern, Turnhalle",,0.000056,57,2,2,4,7204,7398,14602,1,1,1,84.5,0,0
8580329,"Schwaderloch, Bahnhof",,0.000072,57,2,1,3,7140,7108,14248,1,1,1,39.25,0,0
8572535,"Full, Schulweg",,0.00004,57,1,1,2,494,494,988,4,0.4,0.486111,18,0,0
8580184,"Leibstadt, Milchhüsli",,0.000087,57,4,2,6,7125,6946,14071,2,0.75,0.833333,260,0,0
8572532,"Leuggern, Felsenau Werkhof",,0.000019,57,1,1,2,494,494,988,7,0.230769,0.328836,360,0,0
8572533,"Full, Fähre",,0.000027,57,1,1,2,494,494,988,6,0.266667,0.3625,248,0,0
8572534,"Full, Mitte",,0.000034,57,1,1,2,494,494,988,5,0.318182,0.409524,134,0,0
8572621,"Wohlen AG, Migros",,0.000069,115,4,6,10,11659,11727,23386,23,0.110186,0.132967,8169.431598,0.00114,0.008151
8572546,"Mellingen, Krone",,0.000027,22,2,1,3,7519,7391,14910,26,0.082304,0.096592,174.666667,0.000067,0
8580311,"Dättwil AG, Langacker",,0.000064,22,2,4,6,10351,10935,21286,21,0.156022,0.193247,2991.296235,0.0001,0.00807
8579692,"Oberrohrdorf, Friedhof",,0.000086,22,5,2,7,17560,17796,35356,23,0.119954,0.138626,1014.960557,0.000662,0.000026
8572555,"Fislisbach, Niederrohrdorferst",,0.000084,22,6,1,7,17303,17959,35262,23,0.097368,0.11504,61113.924277,0.000039,0
8572557,"Niederrohrdorf, Fohrhölzli",,0.000034,22,1,1,2,4946,4946,9892,22,0.097404,0.110735,0,0.000026,0.000027
8572561,"Bellikon, Rehaklinik",,0.000017,85,1,2,3,3982,3982,7964,19,0.12246,0.138801,49,0.00003,0.00071
8572596,"Oberwil-Lieli, Englisächer",,0.000036,85,2,2,4,16820,16820,33640,20,0.113472,0.129473,6420.899139,0,0.003139
8572597,"Oberwil-Lieli, im Moos",,0.000033,85,2,1,3,13410,13410,26820,19,0.118209,0.132161,938.115474,0.000102,0.000047
8572570,"Bremgarten AG, Waage",,0.000016,85,1,1,2,6051,6051,12102,26,0.07964,0.087669,9.4,0.000362,0
8572574,"Nussbaumen AG, Breite",,0.000043,22,3,2,5,23015,23015,46030,22,0.117761,0.140244,912.190476,0.000069,0.000092
8572575,"Kirchdorf AG, Aesch",,0.000029,22,1,2,3,17516,17516,35032,23,0.105631,0.1222,225.133333,0.000002,0
8572576,"Kirchdorf AG, Dorf",,0.000023,22,1,1,2,8567,8567,17134,23,0.105457,0.120583,0,0,0
8590169,"Baden, Brunnmatt",,0.000046,22,4,2,6,11860,11860,23720,21,0.077351,0.097864,843.9,0.000563,0.000089
8590171,"Baden, Föhrenweg",,0.000057,22,1,2,3,9995,9995,19990,22,0.072438,0.092642,1948,0,0.000089
8578673,"Turgi, Sitten",,0.000019,22,1,1,2,12124,12124,24248,24,0.095925,0.109715,343,0.000048,0
8572582,"Baden, Historisches Museum",,0.00002,22,1,1,2,15295,15295,30590,22,0.116462,0.136636,1306,0.000005,0
8572584,"Lengnau AG, Abzw. Husen",,0.000034,22,2,1,3,6090,6090,12180,24,0.094286,0.105041,351,0.000037,0.000038
8572586,"Niederweningen, Bahnhof",,0.000018,22,1,1,2,66,96,162,24,0.094286,0.105041,0,0.000036,0.000038
8572587,"Lengnau AG, Brücke",,0.000062,22,3,1,4,12406,11669,24075,23,0.103904,0.117856,1585,0.000038,0
8572588,"Endingen, Schöntal",,0.000063,22,1,2,3,11669,12406,24075,22,0.115732,0.135691,1933,0,0
8572589,"Döttingen, Zentrum",,0.000038,22,1,1,2,96,96,192,22,0.115537,0.134045,0,0,0
8573213,"Zürich Flughafen, Werft",,0.000021,107,2,4,6,117716,117679,235395,29,0.12586,0.167256,7444.717187,0.000556,0.012537
8572645,"Hermetschwil, Kloster",,0.000049,85,2,2,4,6293,6172,12465,23,0.104049,0.120601,3073.133078,0,0.003414
8572598,"Berikon, Mattenhof",,0.000053,85,3,1,4,14480,14480,28960,18,0.133901,0.154151,69046.82024,0.000047,0
8580310,"Remetschwil, Garage",,0.000023,85,1,1,2,1070,1070,2140,19,0.13512,0.153158,0,0.002454,0.002584
8572600,"Zufikon, Emaus",,0.000042,85,2,1,3,9028,11646,20674,19,0.124437,0.140605,144.075,0.000096,0
8572604,"Obfelden, Bickwil",,0.000018,85,1,1,2,2989,2988,5977,20,0.106416,0.117944,118.666667,0.002325,0
8572605,"Ottenbach, Hinterdorf",,0.000026,85,1,1,2,2988,2986,5974,19,0.118954,0.134752,946.666667,0,0
8573195,"Obfelden, Hölibachstrasse",,0.000047,115,2,3,5,10462,10462,20924,20,0.095822,0.113518,971.433333,0.002358,0.026591
8580889,"Waltenschwil, Maiächer",,0.000034,115,1,2,3,5604,3179,8783,20,0.0953,0.109634,570.95,0,0.003939
8581563,"Muri AG, Luzernstrasse",,0.000021,115,1,2,3,3095,3095,6190,20,0.0953,0.109634,13.766667,0.00428,0.003863
8572611,"Hägglingen, Dottikerstrasse",,0.000033,115,2,1,3,3785,3784,7569,30,0.062589,0.067538,138,0.000233,0
8572612,"Hägglingen, Mitteldorf",,0.000039,115,1,1,2,3784,3771,7555,29,0.066696,0.072222,1034,0,0
8572613,"Hägglingen, Dorfmatten",,0.000044,115,1,1,2,3771,3785,7556,28,0.071384,0.0777,1928,0,0
8572616,"Dottikon, Bergstrasse",,0.000049,115,1,1,2,3785,3785,7570,27,0.076788,0.084215,2820,0,0
8572617,"Dottikon, Lehmhof",,0.000052,115,1,1,2,3785,3785,7570,26,0.083084,0.092137,3710,0,0
8572618,"Anglikon, Zentrum",,0.000055,115,1,1,2,3785,3785,7570,25,0.090513,0.102099,4598,0,0
8580283,"Wohlen AG, Manor",,0.000039,115,1,1,2,933,933,1866,5,0.35,0.445238,337,0.000429,0.000004
8572628,"Wohlen AG, Rösslimatt",,0.000015,115,1,2,3,3661,3661,7322,20,0.117088,0.134467,21.500269,0.000136,0.006241
8572625,"Waltenschwil, altes Schulhaus",,0.00005,115,1,3,4,5253,5253,10506,19,0.126539,0.146635,4535,0,0.015203
8572627,"Wohlen AG, Friedhof",,0.000021,115,1,1,2,1605,818,2423,20,0.116411,0.131909,0,0.000188,0.005909
8579278,"Wohlen AG, Brühlmattstrasse",,0.000057,115,1,2,3,4128,4128,8256,20,0.116694,0.134199,4320,0,0.002257
8580285,"Wohlen AG, Bünzstrasse",,0.000069,115,2,2,4,2765,2765,5530,4,0.461538,0.597222,266.5,0.000028,0.00003
8572622,"Wohlen AG, Rigistrasse",,0.000036,115,3,1,4,5604,5253,10857,22,0.091972,0.099753,2096,0.001205,0
8572623,"Wohlen AG, Turmstrasse",,0.000041,115,1,1,2,5253,5604,10857,21,0.101174,0.111083,2911,0,0
8572624,"Waltenschwil, Hofmatten",,0.000046,115,1,1,2,5604,5253,10857,20,0.112437,0.12586,3724,0,0
8580270,"Wohlen AG, Freihofweg",,0.0001,115,7,3,10,7984,8771,16755,19,0.131565,0.154935,12826.582614,0.005909,0.002823
8572629,"Wohlen AG, Harzer",,0.000027,115,2,1,3,4128,4128,8256,25,0.07418,0.080431,492,0.000332,0
8572630,"Büttikon AG, Brünishalden",,0.000034,115,1,2,3,4128,4128,8256,24,0.080013,0.087732,1135,0,0
8572631,"Büttikon AG, Rossweid",,0.000025,115,1,1,2,2064,2064,4128,24,0.079912,0.086472,0,0,0
8572632,"Büttikon AG, Oberdorf",,0.000047,115,2,1,3,4128,4128,8256,23,0.086732,0.094456,2415,0,0
8572633,"Uezwil, im Letten",,0.000051,115,1,1,2,4128,4128,8256,22,0.094838,0.104321,3052,0,0
8572634,"Uezwil, Waage",,0.000054,115,1,1,2,4128,4128,8256,21,0.104629,0.116947,3687,0,0
8572636,"Benzenschwil, Bahnhof",,0.000037,115,2,1,3,1543,1543,3086,19,0.124064,0.140676,4.666667,0.000089,0.000002
8572639,"Muri AG, Marktstrasse",,0.000033,115,3,1,4,3204,4562,7766,19,0.124169,0.141077,219,0.001115,0
8572643,"Bremgarten AG, West",,0.000036,85,2,2,4,6172,6293,12465,24,0.094469,0.107523,1567.133078,0,0
8572644,"Staffeln AG, Gass",,0.000026,85,1,1,2,3145,3145,6290,24,0.094356,0.106347,0,0,0
8572646,"Unterlunkhofen, Gemeindehaus",,0.000039,115,4,2,6,3083,3155,6238,18,0.141702,0.165934,1168.694268,0.003849,0.007186
8573722,"Oberlunkhofen, Oberdorf",,0.000039,85,1,2,3,14979,9516,24495,19,0.135871,0.157354,5316.694601,0,0.011731
8582462,"Bremgarten AG, Zelgli",,0.000084,85,4,2,6,11646,11280,22926,19,0.104484,0.121025,3358.29646,0.00471,0.022345
8572649,"Schlossrued, Längenthal",,0.000035,59,1,1,2,4602,4602,9204,1,1,1,75,0,0
8572655,"Chur, Tulpenweg",,0.000017,109,1,1,2,21993,21996,43989,24,0.107689,0.141341,461,0,0
8572656,"Schöftland, Dreistein",,0.000035,59,1,1,2,8023,8023,16046,61,0.035424,0.045248,300,0,0
8572657,"Schöftland, Pikardie",,0.000041,59,1,1,2,8023,8023,16046,60,0.03666,0.047321,794,0,0
8572660,"Staffelbach, Suhrenbrücke",,0.000045,59,1,1,2,8023,8023,16046,59,0.037988,0.049757,1286,0,0
8572661,"Kirchleerau, Fabrik Hunziker",,0.000049,59,1,1,2,8023,8023,16046,58,0.039419,0.052766,1776,0,0
8572663,"Felsberg, Bahnhof",,0.000014,109,1,1,2,5977,7003,12980,25,0.102469,0.129,0,0,0
8572906,"Reichenau, Adler",,0.000025,109,4,1,5,7621,8198,15819,28,0.085014,0.098572,131.5,0,0
8572667,"Felsberg, Underchrüzli",,0.000019,109,2,1,3,8219,7198,15417,27,0.084989,0.100401,109.033333,0,0
8572669,"Triengen, Dorf",,0.000074,59,4,2,6,14479,15054,29533,56,0.0426,0.05973,33880.5,0,0
8572961,"Sursee, Park",,0.000104,59,7,8,15,46837,46837,93674,50,0.056232,0.103348,46969.683333,0,0
8572671,"Felsberg, Kirchenstutz",,0.000033,109,2,1,3,13972,13969,27941,26,0.092668,0.112105,646.066667,0,0
8572672,"Felsberg, Ringelweg",,0.000039,109,1,1,2,13969,13969,27938,25,0.101896,0.128004,1042.066667,0,0
8572673,"Büron, Eichenmoos",,0.000053,59,2,1,3,15969,15969,31938,54,0.046197,0.063241,34234,0,0
8572674,"Geuensee, Sternen",,0.000056,59,1,1,2,15969,15969,31938,53,0.048348,0.06845,34714,0,0
8572675,"Geuensee, Ausserdorf",,0.000058,59,1,1,2,15969,15969,31938,52,0.050714,0.075306,35192,0,0
8572677,"Zofingen, Mühlethalstrasse",,0.000046,94,3,1,4,16406,16434,32840,11,0.130769,0.169691,334,0,0
8572678,"Oftringen, Döbeligut",,0.00005,94,1,1,2,16434,16432,32866,10,0.146018,0.183514,324,0,0
8572679,"Oftringen, Bühnenberg-Sonnmatt",,0.000054,94,1,1,2,16432,16432,32864,9,0.165803,0.201724,312,0,0
8572680,"Küngoldingen, Post",,0.000056,94,1,1,2,16432,16432,32864,8,0.192547,0.226997,298,0,0
8582525,"Olten, Sälistrasse",,0.000062,94,1,1,2,33763,16635,50398,1,1,1,3,0,0
8572684,"Zofingen, Spitalgasse",,0.000039,94,3,1,4,22043,22059,44102,14,0.115672,0.143336,126,0,0
8572685,"Oftringen, Ruhbank",,0.000044,94,1,1,2,22059,22059,44118,13,0.128692,0.157554,145,0,0
8572686,"Oftringen, Wirtshüsli",,0.000048,94,1,1,2,22059,22059,44118,12,0.145278,0.176808,162,0,0
8574668,"Chur, Strassenverkehrsamt",,0.000077,109,1,1,2,45219,45219,90438,24,0.13357,0.173045,3177.433333,0,0
8572691,"Rothrist, Grüebli",,0.000045,94,2,1,3,10284,10286,20570,7,0.221429,0.255453,392,0,0
8572692,"Rothrist, Brunnhalde",,0.000049,94,1,1,2,10286,10286,20572,6,0.275229,0.312778,373,0,0
8572694,"Rothrist, Hungerzelg",,0.000033,94,1,1,2,5173,5173,10346,9,0.17284,0.215533,260,0,0
8572695,"Murgenthal, Rank",,0.000039,94,1,1,2,5173,5173,10346,8,0.201493,0.246076,235,0,0
8572696,"Murgenthal, Gemeindehaus",,0.000044,94,1,2,3,5173,5173,10346,7,0.242991,0.301648,208,0,0
8572697,"Murgenthal, Post",,0.00003,94,1,1,2,2533,2533,5066,7,0.235849,0.273714,0,0,0
8572698,"Murgenthal, Hohwart",,0.000055,94,2,1,3,5173,5173,10346,6,0.296296,0.336111,148,0,0
8572745,"Zofingen, Bahnhof",,0.000451,94,13,11,24,122403,82824,205227,4,0.594595,0.723485,5306,0,0
8572700,"Zofingen, Henzmannstrasse",,0.000078,94,6,3,9,30331,30418,60749,8,0.219626,0.281307,1166,0,0
8572701,"Zofingen, Falkeisenmatte",,0.000033,94,1,1,2,21636,21636,43272,9,0.172727,0.206307,740,0,0
8572702,"Zofingen, Mühlewiese",,0.000039,94,1,1,2,21636,21636,43272,8,0.203297,0.239929,727,0,0
8572703,"Strengelbach, Bifang",,0.000044,94,1,2,3,21636,21636,43272,7,0.248276,0.300265,712,0,0
8572721,"Strengelbach, Seniorenzentrum",,0.000055,94,1,1,2,5426,5426,10852,9,0.176796,0.221999,160,0,0
8572704,"Vordemwald, Weierdentsch",,0.00003,94,1,1,2,20237,20237,40474,6,0.292135,0.329487,228,0,0
8572706,"Vordemwald, Schulhaus",,0.000026,94,1,1,2,7401,7401,14802,6,0.285714,0.322222,55,0,0
8572711,"Roggliswil, Niederwil",,0.000039,94,2,2,4,19960,9118,29078,10,0.205479,0.284153,617,0,0
8572713,"St. Urban, Birchmatt",,0.000049,94,1,1,2,9706,9706,19412,10,0.195804,0.250879,28,0,0
8572712,"St. Urban, Sonnhalden",,0.000044,94,2,1,3,8310,9706,18016,11,0.168605,0.21753,23,0,0
8572714,"St. Urban, Klinik",,0.000069,94,2,1,3,12170,16268,28438,9,0.234783,0.308524,675,0,0
8572715,"St. Urban, Bahnhof",,0.00007,94,1,5,6,16268,16117,32385,8,0.295455,0.444643,676,0,0
8572752,"Ufhusen, Käserei Dorf",,0.00003,94,1,1,2,2114,2114,4228,16,0.102326,0.17461,22,0,0
8572731,"Brittnau, Liebigen",,0.00003,94,1,2,3,11988,11988,23976,7,0.304348,0.417347,14,0,0
8572775,"Grossdietwil, Sandgruebe",,0.000065,94,1,1,2,6351,6351,12702,8,0.208955,0.284099,126,0,0
8572785,"St. Urban, Tundwilerweg",,0.00006,94,1,3,4,6562,6562,13124,4,0.5,0.654762,40,0,0
8572716,"Zofingen, Tagblatt",,0.000033,94,1,1,2,5426,5426,10852,14,0.103933,0.145943,250,0,0
8572717,"Strengelbach, Schürliweg",,0.000039,94,1,1,2,5426,5426,10852,13,0.112853,0.154349,236,0,0
8572718,"Strengelbach, Hard",,0.000044,94,1,1,2,5426,5426,10852,12,0.123675,0.164707,220,0,0
8572719,"Strengelbach, Sägetstrasse",,0.000048,94,1,1,2,5426,5426,10852,11,0.137097,0.177942,202,0,0
8572720,"Strengelbach, Hardmattenweg",,0.000052,94,1,1,2,5426,5426,10852,10,0.154206,0.195767,182,0,0
8572722,"Strengelbach, Gemeindehaus",,0.000076,94,2,2,4,6825,6825,13650,8,0.208054,0.2697,600,0,0
8572724,"Brittnau, Kleinfeld",,0.000048,94,1,1,2,5426,5426,10852,8,0.19863,0.236576,29,0,0
8572723,"Brittnau, Nelkenweg",,0.000043,94,1,1,2,5426,5426,10852,9,0.170455,0.209021,60,0,0
8572728,"Zofingen, Oberer Stadteingang",,0.000086,94,2,2,4,30355,30356,60711,6,0.294118,0.349333,392,0,0
8572730,"Reiden, Friedmattstrasse",,0.000023,94,1,1,2,11988,11988,23976,8,0.245902,0.322302,27,0,0
8572733,"Langnau bei Reiden, Oberdorf",,0.00004,94,1,1,2,7598,7597,15195,1,1,1,19,0,0
8572742,"Zofingen, Wässermattenweg",,0.000033,94,1,1,2,3356,3356,6712,6,0.285714,0.322222,73,0,0
8581658,"Geltwil, Dorf",,0.000021,115,1,1,2,3841,3841,7682,3,0.5,0.583333,0,0.00428,0.004382
8577503,"Oftringen, Obristhof",,0.000046,94,1,2,3,16399,16432,32831,2,0.75,0.833333,243,0,0
8580586,"Brittnau, Post",,0.000046,94,1,1,2,10810,2471,13281,1,1,1,0,0,0
8594490,"Rothrist, Neue Industriestr.",,0.000075,94,2,1,3,5173,632,5805,1,1,1,2,0,0
8595160,"Rothrist, Schwimmbad",,0.000056,94,1,1,2,7172,3462,10634,1,1,1,3,0,0
8572746,"Felsberg, Calanda",,0.000023,109,1,1,2,7198,7217,14415,27,0.084635,0.099722,111,0,0
8580840,"Staffeln AG, Schulhaus",,0.000042,85,2,1,3,3145,3024,6169,21,0.111475,0.122608,3,0.000377,0.000046
8580846,"Bremgarten AG, Kaserne",,0.000057,85,2,1,3,6050,6051,12101,20,0.125215,0.13994,510,0.000306,0.000046
8576498,"Zufikon, Haldenstrasse",,0.000041,85,1,1,2,2618,2618,5236,20,0.094768,0.106894,1527,0,0.00471
8572749,"Felsberg, Schöneggstrasse",,0.000031,109,1,1,2,7217,7217,14434,26,0.092245,0.111148,501,0,0
8572751,"Hüswil, Bahnhof",,0.000023,94,1,1,2,1354,2114,3468,17,0.096639,0.168134,27,0,0
8572767,"Ebersecken, Unterdorf",,0.000026,59,1,2,3,1877,1838,3715,13,0.145833,0.231812,9,0,0
8572764,"Schötz, Feld",,0.00002,59,1,1,2,2003,2003,4006,15,0.11811,0.166404,106.5,0,0
8572765,"Schötz, Gläng",,0.000028,59,1,1,2,2003,2003,4006,14,0.130952,0.189349,116.5,0,0
8572766,"Ebersecken, Badachtal",,0.000035,59,1,2,3,2003,2003,4006,13,0.14726,0.232235,124.5,0,0
8572808,"Schötz, Moosbrücke",,0.000066,59,1,1,2,8672,7831,16503,13,0.138298,0.202636,127.5,0,0
8572768,"Zell LU, Bahnhof",,0.000048,94,2,1,3,4598,6296,10894,15,0.108808,0.181797,231,0,0
8572769,"Zell LU, St. Urbanstrasse",,0.000052,94,1,1,2,6296,6351,12647,14,0.116279,0.189859,222,0,0
8572770,"Fischbach LU, Leimbütz",,0.000055,94,1,1,2,6351,6351,12702,13,0.125,0.199021,211,0,0
8572771,"Fischbach LU, alte Post",,0.000058,94,1,1,2,6351,6351,12702,12,0.135338,0.209616,198,0,0
8572772,"Fischbach LU, Krone",,0.00006,94,1,1,2,6351,6351,12702,11,0.147826,0.222154,183,0,0
8572773,"Fischbach LU, Reiferswil",,0.000062,94,1,1,2,6351,6351,12702,10,0.163265,0.237475,166,0,0
8572774,"Grossdietwil, Post",,0.000063,94,1,1,2,6351,6351,12702,9,0.182927,0.25709,147,0,0
8572776,"Altbüron, Hiltbrunnen",,0.000091,94,3,1,4,8934,8934,17868,7,0.245283,0.326374,333,0,0
8572777,"Altbüron, Post",,0.000088,94,1,2,3,8934,8567,17501,6,0.3,0.415278,306,0,0
8572778,"Altbüron, Halde",,0.000048,94,1,1,2,6195,6562,12757,8,0.211538,0.298593,176,0,0
8572779,"Altbüron, Feld",,0.000052,94,1,1,2,6562,6562,13124,7,0.243902,0.329286,145,0,0
8572780,"Altbüron, Gruenbach",,0.000055,94,1,1,2,6562,6562,13124,6,0.290323,0.374074,112,0,0
8572781,"St. Urban, Unterberghof",,0.000058,94,1,1,2,6562,6562,13124,5,0.363636,0.452083,77,0,0
8572784,"Felsberg, Bahnhofstrasse",,0.000037,109,1,1,2,7217,6990,14207,25,0.10138,0.126519,889,0,0
8577646,"Grossdietwil, Schönegg",,0.000065,94,2,1,3,6351,3979,10330,4,0.384615,0.483333,60,0,0
8579864,"Pfaffnau, Steinacher",,0.000053,94,3,2,5,12160,10514,22674,3,0.555556,0.666667,155,0,0
8572809,"Schötz, Neubühl",,0.000092,59,3,3,6,8996,6994,15990,12,0.156379,0.258138,278,0,0
8572810,"Altishofen, Bäckerei",,0.000046,59,2,1,3,427,427,854,13,0.136029,0.200719,0,0,0
8572790,"Willisau, Schlüsselacher",,0.00002,59,1,1,2,3075,3075,6150,56,0.043378,0.059707,432,0,0
8572791,"Willisau, Zopfmatt",,0.000028,59,1,1,2,3075,3075,6150,55,0.045267,0.064701,976,0,0
8580016,"Hergiswil LU, Vordere Säge",,0.000058,59,1,2,3,400,400,800,4,0.444444,0.552083,64,0,0
8572793,"Willisau, Feld",,0.000021,59,1,1,2,400,400,800,12,0.135593,0.219077,312,0,0
8572794,"Willisau, Breiten",,0.000029,59,1,1,2,400,400,800,11,0.147059,0.23114,288,0,0
8572795,"Willisau, Feldmatt-Kapelle",,0.000035,59,1,1,2,400,400,800,10,0.16092,0.24521,262,0,0
8572797,"Hergiswil LU, Unter Schmiede",,0.000041,59,1,1,2,400,400,800,9,0.178082,0.262027,234,0,0
8572798,"Hergiswil LU, Dorf",,0.000046,59,1,1,2,400,400,800,8,0.2,0.282837,204,0,0
8572799,"Hergiswil LU, Luegental",,0.00005,59,1,1,2,400,400,800,7,0.229167,0.309957,172,0,0
8572800,"Hübeli, Hintersagi",,0.000053,59,1,1,2,400,400,800,6,0.27027,0.348333,138,0,0
8572801,"Hübeli, Sagenmatt",,0.000056,59,1,1,2,400,400,800,5,0.333333,0.411111,102,0,0
8572802,"Willisau, Widenmatt",,0.000042,59,4,1,5,10309,10179,20488,53,0.048827,0.071742,1850,0,0
8572804,"Alberswil, Burgrain",,0.000046,59,1,2,3,10179,10119,20298,52,0.051243,0.080827,2378,0,0
8572806,"Ettiswil, Hinterdorf",,0.00004,59,3,1,4,1998,2040,4038,15,0.112948,0.159468,35.5,0,0
8572811,"Altishofen, Unterdorf",,0.000086,59,3,3,6,3050,2995,6045,12,0.153191,0.25396,188.833333,0,0
8572807,"Alberswil, Unterdorf",,0.000064,59,2,1,3,8672,8672,17344,14,0.124224,0.1762,135.5,0,0
8573246,"Willisau, Feldli",,0.000081,59,4,3,7,10119,10128,20247,11,0.169903,0.271294,1548.166667,0,0
8581502,"Willisau, Chrüzhof",,0.000058,59,2,2,4,7273,7071,14344,4,0.4375,0.559524,558.666667,0,0
8581975,"Willisau, Postplatz",,0.00006,59,2,3,5,3610,3396,7006,3,0.6,0.722222,399.5,0,0
8572816,"Menznau, Bahnhof",,0.00002,60,1,2,3,2024,2162,4186,8,0.25641,0.421786,10,0,0
8572820,"Menznau, Höhe",,0.000027,60,1,1,2,1928,1857,3785,8,0.222222,0.339732,8,0,0
8572818,"Menznau, Untertreien",,0.000019,60,1,1,2,1920,1928,3848,9,0.2,0.31433,2,0,0
8572822,"Menznau, Twerenegg",,0.000043,60,2,1,3,2099,2024,4123,7,0.25,0.370408,28,0,0
8572823,"Menzberg, Buchen",,0.000047,60,1,1,2,2024,2024,4048,6,0.285714,0.408333,30,0,0
8572824,"Menzberg, Buchensäge",,0.000051,60,1,1,2,2024,2024,4048,5,0.333333,0.456667,30,0,0
8572825,"Menzberg, Gutenegg",,0.000054,60,1,1,2,2024,2024,4048,4,0.4,0.520833,28,0,0
8572826,"Menzberg, Hasenrank",,0.000057,60,1,1,2,2024,2024,4048,3,0.5,0.611111,24,0,0
8572827,"Menzberg, Oberlehn/Napf",,0.000059,60,1,1,2,2024,1341,3365,2,0.666667,0.75,18,0,0
8572829,"Malters, Bahnhof",,0.000049,90,1,1,2,4387,4388,8775,15,0.12266,0.141356,325.291667,0,0
8572830,"Malters, Schürmatt",,0.000052,90,1,2,3,4388,4388,8776,14,0.139073,0.165703,500.291667,0,0
8573051,"Hergiswald, Bauernhaus",,0.000046,90,1,1,2,1395,1307,2702,14,0.138767,0.161735,960,0,0
8573053,"Eigenthal, Talboden",,0.000072,90,2,2,4,4261,4349,8610,13,0.160273,0.196176,1718.291667,0,0
8577052,"Entlebuch, Drei Könige",,0.000038,92,1,6,7,4763,4790,9553,8,0.257143,0.425441,810,0,0
8577295,"Ruswil, Rüediswil",,0.000079,92,1,3,4,7050,7050,14100,11,0.161538,0.24334,4383,0,0
8572844,"Wolhusen, Markt",,0.000019,92,1,1,2,4582,4528,9110,13,0.153025,0.206312,420,0,0
8572846,"Wolhusen, Neuemsern-Rossei",,0.000022,92,1,1,2,2866,2867,5733,11,0.166667,0.265545,384,0,0
8572849,Burgmatt (Fontannen),,0.00003,92,1,1,2,2867,2895,5762,10,0.183333,0.284452,363,0,0
8572850,"Doppleschwand, Spittel",,0.000036,92,1,1,2,2895,2895,5790,9,0.204082,0.307897,340,0,0
8572851,"Doppleschwand, Hohfuren",,0.000042,92,1,1,2,2895,2895,5790,8,0.230769,0.339021,315,0,0
8572852,"Doppleschwand, Brüggweid",,0.000046,92,1,1,2,2895,2895,5790,7,0.266667,0.386607,288,0,0
8572853,"Romoos, Flühboden",,0.00005,92,1,2,3,2895,2895,5790,6,0.318182,0.492857,259,0,0
8572859,"Romoos, Holzwäge",,0.000055,92,1,1,2,653,653,1306,1,1,1,5,0,0
8572854,"Romoos, Talherrenburg",,0.000032,92,1,1,2,653,653,1306,6,0.285714,0.408333,190,0,0
8572855,"Romoos, Stude",,0.000038,92,1,1,2,653,653,1306,5,0.333333,0.456667,157,0,0
8572856,"Romoos, Adlisberg",,0.000044,92,1,1,2,653,653,1306,4,0.4,0.520833,122,0,0
8572857,"Romoos, Schmitteli",,0.000048,92,1,1,2,653,653,1306,3,0.5,0.611111,85,0,0
8572858,"Romoos, Schwändi Zyberlibahn",,0.000052,92,1,1,2,653,653,1306,2,0.666667,0.75,46,0,0
8572862,"Wiggen, Egghus",,0.000059,61,2,1,3,6199,6201,12400,7,0.233333,0.313265,98.166667,0,0
8572865,"Schangnau, Grunachen",,0.00006,61,1,2,3,4970,4977,9947,6,0.314286,0.434848,76.833333,0,0
8572867,"Schangnau, Leu",,0.000042,61,1,2,3,2912,2683,5595,6,0.321429,0.466667,43,0,0
8572869,"Bumbach, Schwand",,0.000035,61,1,1,2,1957,1957,3914,6,0.28,0.385714,7,0,0
8572864,"Schangnau, Wald",,0.000058,61,2,1,3,4978,4970,9948,7,0.255319,0.339683,80.833333,0,0
8572866,"Schangnau, Stein",,0.000036,61,1,1,2,2912,2912,5824,7,0.263158,0.362619,51,0,0
8572868,"Bumbach, Bödeli",,0.000029,61,1,1,2,1957,1957,3914,7,0.242424,0.349107,19,0,0
8579708,"Hasle LU, Hohwald",,0.000051,92,1,2,3,1324,1324,2648,3,0.5,0.583333,344,0,0
8572871,"Schüpfheim, Landbrücke",,0.000022,92,1,1,2,3971,3971,7942,13,0.144231,0.240898,205,0,0
8572872,"Schüpfheim, Badhus",,0.00003,92,1,1,2,3971,3971,7942,12,0.157303,0.265309,201,0,0
8572873,"Schüpfheim, Wegmattensäge",,0.000036,92,1,2,3,3971,3971,7942,11,0.173333,0.318837,195,0,0
8572874,"Flühli LU, Usser-Lamm",,0.000026,92,1,1,2,1700,2615,4315,11,0.162162,0.262073,0,0,0
8572875,"Flühli LU, Matzenbach",,0.000049,92,2,1,3,4886,3971,8857,10,0.177419,0.279257,177,0,0
8572876,"Flühli LU, Torbach",,0.000052,92,1,1,2,3971,3891,7862,9,0.196078,0.299563,165,0,0
8572877,"Flühli LU, Hüttlenen",,0.000055,92,1,1,2,3891,3891,7782,8,0.219512,0.324206,151,0,0
8572878,"Flühli LU, Hochwald",,0.000058,92,1,1,2,3891,3891,7782,7,0.25,0.355357,135,0,0
8572879,"Sörenberg, Mittlere Hirsegg",,0.00006,92,1,1,2,3891,3891,7782,6,0.291667,0.397619,117,0,0
8572881,"Sörenberg, Camping",,0.000062,92,1,1,2,3891,3891,7782,5,0.352941,0.463889,97,0,0
8572886,"Giswil, Emmenrank",,0.000052,92,2,1,3,824,742,1566,1,1,1,13,0,0
8572883,"Sörenberg, Flühhütten",,0.000054,92,2,1,3,2538,2538,5076,3,0.444444,0.541667,74,0,0
8572884,"Sörenberg, Schwändili",,0.000057,92,1,1,2,2538,2538,5076,2,0.6,0.666667,48,0,0
8572887,"Giswil, Jwi",,0.000026,92,1,1,2,221,221,442,13,0.137615,0.227009,135,0,0
8572888,"Giswil, Abzw. Brosmatt",,0.000033,92,1,1,2,221,221,442,12,0.148936,0.239798,140,0,0
8572889,"Giswil, Buechenegg",,0.000039,92,1,1,2,221,221,442,11,0.1625,0.254734,143,0,0
8572890,"Giswil, Bärecken",,0.000044,92,1,1,2,221,221,442,10,0.179104,0.272652,144,0,0
8572891,"Giswil, Rütimatt",,0.000048,92,1,1,2,221,221,442,9,0.2,0.295058,143,0,0
8572892,"Giswil, Kirche",,0.000052,92,1,1,2,221,3330,3551,8,0.227273,0.325119,140,0,0
8572893,"Giswil, Bahnhof",,0.000055,92,1,1,2,3330,3109,6439,7,0.264706,0.371429,135,0,0
8572898,"Kerns, Foribach",,0.000032,62,1,3,4,13986,13694,27680,18,0.08543,0.116502,420,0,0
8572905,"Stalden (Sarnen), Brünischwand",,0.000038,62,1,1,2,522,523,1045,4,0.416667,0.516667,5,0,0
8572915,"Melchtal, Weidli",,0.000045,62,1,2,3,3662,3663,7325,3,0.571429,0.708333,65,0,0
8580102,"Melchtal, Plätzli",,0.00003,62,1,1,2,1552,1552,3104,3,0.5,0.611111,0,0,0
8581333,"Stans, Kantonalbank",,0.000103,62,4,2,6,10451,9651,20102,13,0.133984,0.163057,4797,0,0
8572901,"Ennetmoos, Waldheim",,0.000063,62,2,1,3,6641,6641,13282,16,0.097546,0.11357,3878,0,0
8572902,"Ennetmoos, Schützenhaus",,0.000065,62,1,1,2,6641,6641,13282,15,0.107392,0.12614,3982,0,0
8572903,"Ennetmoos, Morgenstern",,0.000066,62,1,2,3,6641,6640,13281,14,0.119531,0.144912,4084,0,0
8577147,Horw Wegscheide,,0.000041,90,4,4,8,60430,60664,121094,13,0.171403,0.220461,3591.640476,0,0
8579966,"Ennetmoos, Riedmatthof",,0.000039,62,1,1,2,3281,3281,6562,14,0.118843,0.139286,0,0,0
8572904,"Sarnen, Ei",,0.000032,62,1,1,2,523,522,1045,5,0.333333,0.436111,48,0,0
8572907,"Kägiswil, Schlieren",,0.000032,62,1,1,2,3834,3834,7668,5,0.318182,0.409524,240,0,0
8572908,"Alpnach Dorf, Kantonalbank",,0.000038,62,1,1,2,3834,3908,7742,4,0.4,0.486111,198,0,0
8572910,"Sarnen, Kirchhofen",,0.000064,62,2,2,4,3422,3422,6844,3,0.571429,0.708333,200,0,0
8579959,"Stalden (Sarnen), Sportplatz",,0.000038,62,1,1,2,523,523,1046,3,0.5,0.611111,0,0,0
8572911,"Kerns, Bodacher",,0.00002,62,1,1,2,3662,3663,7325,7,0.242424,0.349107,245,0,0
8572912,"St. Niklausen OW, Alpenblick",,0.000028,62,1,1,2,3663,3663,7326,6,0.28,0.385714,203,0,0
8572913,"St. Niklausen OW, Eistlibach",,0.000035,62,1,1,2,3663,3663,7326,5,0.333333,0.436111,159,0,0
8572914,"Melchtal, gedeckte Brücke",,0.00004,62,1,1,2,3663,3662,7325,4,0.416667,0.516667,113,0,0
8572917,"Grossteil, Schulhaus",,0.000058,92,1,2,3,3109,2818,5927,6,0.32,0.472917,128,0,0
8572918,"Grossteil, Unterni",,0.000035,92,1,2,3,2337,2331,4668,5,0.388889,0.540476,51,0,0
8572919,"Kleinteil, Post",,0.00005,92,2,1,3,2743,2270,5013,5,0.352941,0.463889,51,0,0
8572923,"Stans, Länderpark",,0.000022,62,1,2,3,3809,3811,7620,16,0.117347,0.140022,360,0,0
8572926,"Stansstad, Seehof",,0.000028,62,1,1,2,3730,3730,7460,16,0.116411,0.134071,205,0,0
8572925,"Stans, Galgenried",,0.00002,62,1,1,2,3730,3730,7460,17,0.104728,0.119308,26,0,0
8572929,"Stansstad, Werkhof",,0.000033,62,1,1,2,4343,4343,8686,7,0.258065,0.365774,258,0,0
8572930,"Stansstad, Sommerweid",,0.000039,62,1,1,2,4343,4343,8686,6,0.304348,0.421429,229,0,0
8579842,"Obbürgen, Unter-Misli",,0.000057,62,1,1,2,2388,1242,3630,1,1,1,4,0,0
8572964,"Schenkon, Dorf",,0.000022,59,1,1,2,10019,10019,20038,50,0.050287,0.068835,0,0,0
8581347,"Moosleerau, Unterdorf",,0.000078,59,1,2,3,6484,6388,12872,5,0.357143,0.47,620,0,0
8572976,"Gunzwil, Linden",,0.000052,59,1,2,3,8076,8076,16152,9,0.205298,0.273861,1015,0,0
8580010,"Sempach Stadt, Seemätteli",,0.000022,59,1,4,5,8999,8999,17998,9,0.22807,0.362424,465,0,0
8581079,"Menziken, Spital",,0.000063,59,2,3,5,8070,8070,16140,9,0.258427,0.384593,150,0,0
8572966,"Schenkon, Haldenweid",,0.000022,59,1,1,2,11310,11310,22620,12,0.143939,0.193569,1669,0,0
8572967,"Schenkon, Tannberg",,0.00003,59,1,2,3,11310,11310,22620,11,0.163717,0.231929,1594,0,0
8572974,"Gunzwil, Kagiswil",,0.000029,59,2,1,3,5217,5217,10434,11,0.152778,0.196911,11,0,0
8572969,"Gunzwil, Chommle",,0.000024,59,1,1,2,8451,8451,16902,12,0.143426,0.188395,341,0,0
8572970,"Gunzwil, Holdern",,0.000031,59,1,1,2,8451,8451,16902,11,0.162791,0.214502,262,0,0
8572975,"Gunzwil, Dorf",,0.000048,59,2,1,3,8076,8076,16152,10,0.174863,0.224095,1102,0,0
8572981,"St. Erhard, Dorf",,0.000022,59,1,1,2,4664,4663,9327,10,0.170854,0.215698,996.633333,0,0
8572983,"Knutwil, Hofacker",,0.00003,59,1,1,2,4663,4664,9327,9,0.2,0.254738,919.633333,0,0
8572991,"Uffikon, Kantonsstrasse",,0.000043,59,2,2,4,4136,4136,8272,8,0.218487,0.289606,180.9,0,0
8573002,Etzelwil,,0.000039,59,1,2,3,3628,3392,7020,8,0.245283,0.326419,82.083333,0,0
8572988,"Buchs LU, Eintracht",,0.000029,59,2,2,4,4136,4136,8272,9,0.190476,0.264512,354.9,0,0
8572990,"Buchs LU, Wendeplatz",,0.000023,59,1,1,2,2084,2084,4168,9,0.184932,0.237272,0,0,0
8581445,"Sursee, Kotten",,0.000106,59,3,5,8,16034,16037,32071,6,0.342857,0.474306,1265.45,0,0
8582754,"St. Erhard, Heidenacher",,0.000035,59,1,1,2,2575,2575,5150,1,1,1,1,0,0
8582565,"Sursee, Chommlibach",,0.000062,59,1,2,3,8905,8905,17810,5,0.368421,0.516667,127,0,0
8582759,"Triengen, Grossfeld",,0.000037,59,1,1,2,1082,1040,2122,5,0.333333,0.436111,0,0,0
8581086,"Schenkon, Zellburg",,0.000085,59,1,2,3,21329,21329,42658,7,0.28,0.368707,1503.966667,0,0
8581469,"Sursee, Frieslirain",,0.000065,59,2,3,5,11936,11936,23872,6,0.338983,0.445,1750.716667,0,0
8582547,"Rickenbach LU, Rüchlig",,0.000047,59,2,2,4,3963,3963,7926,4,0.4,0.5,815,0,0
8582760,"Triengen, Forum",,0.000106,59,4,1,5,14591,3787,18378,4,0.416667,0.516667,335,0,0
8582762,"Reinach AG, Saalbau",,0.000063,59,2,2,4,8408,7825,16233,4,0.461538,0.597222,183,0,0
8573000,"Schlierbach, Oberdorf",,0.000026,59,3,1,4,3628,3628,7256,10,0.173913,0.222449,258.083333,0,0
8573001,"Schlierbach, Dorf",,0.000033,59,1,1,2,3628,3628,7256,9,0.203008,0.258216,171.083333,0,0
8573003,"Eich, Seematt",,0.000033,59,2,1,3,8998,8999,17997,48,0.053719,0.069399,38593,0,0
8573005,"Sempach Stadt, Vogelwarte",,0.000055,59,2,1,3,17062,17061,34123,46,0.059941,0.082061,40117.5,0,0
8573081,"Rotkreuz, Bahnhof Süd",,0.000028,90,1,1,2,4324,4324,8648,44,0.062752,0.0862,842,0,0
8582112,"Rain, Sandblatten",,0.000037,59,1,2,3,3485,3487,6972,3,0.571429,0.708333,20,0,0
8582118,"Rothenburg, Bahnhof",,0.000068,90,2,3,5,9979,9981,19960,3,0.583333,0.690476,671.083333,0,0
8583054,"Sursee, Rothüsli",,0.000222,59,7,2,9,28152,5542,33694,3,0.571429,0.708333,591.416667,0,0
8583509,"Eich, Eichhof",,0.000031,59,1,2,3,3206,3206,6412,2,0.666667,0.75,8,0,0
8583513,"Sempach Station, Mettenwilstr.",,0.000169,59,6,2,8,13250,8535,21785,2,0.75,0.833333,570.583333,0,0
8583550,"Gunzwil, Bäch",,0.000092,59,1,1,2,3206,3206,6412,1,1,1,1,0,0
8573016,"Bonaduz, Alte Post",,0.000035,109,2,1,3,8739,8176,16915,27,0.092697,0.10942,565.333333,0,0
8573017,"Bonaduz, Crusch",,0.00004,109,1,1,2,8176,8175,16351,26,0.101929,0.123695,959.333333,0,0
8589744,Kriens Unter-Dattenberg,,0.000029,90,1,3,4,18757,18752,37509,8,0.304147,0.367947,175.166667,0,0
8573024,"Luzern, Kasernenplatz",,0.000018,90,1,5,6,193105,193300,386405,47,0.070165,0.125873,2922,0,0
8589750,Littau Dorf,,0.00005,90,1,1,2,28857,28856,57713,16,0.095745,0.118712,1765,0,0
8589770,Luzern Bramberg,,0.000014,90,1,2,3,18865,18825,37690,11,0.164589,0.197932,29,0,0
8589671,Emmenbrücke Krauerstrasse,,0.000038,90,1,1,2,63356,63352,126708,10,0.191045,0.21697,5594.333333,0,0
8589736,Kriens Schachenstrasse,,0.000035,90,1,4,5,107024,107083,214107,8,0.303167,0.37365,3908.630952,0,0
8589765,Littau Schützenhaus,,0.000067,90,1,3,4,90012,90010,180022,9,0.241636,0.295354,722,0,0
8573028,Emmenbrücke Bahnhof,,0.000015,90,1,1,2,63320,63354,126674,23,0.089696,0.120205,307,0,0
8573032,"Emmenbrücke, Riffig",,0.000014,90,1,1,2,8227,8227,16454,23,0.087791,0.116766,1882,0,0
8573037,"Neuenkirch, Weierhüsli",,0.000039,90,1,3,4,14423,14423,28846,22,0.099838,0.152731,702,0,0
8573041,"Neuenkirch, Feldmatt",,0.000049,90,3,2,5,14510,14397,28907,22,0.098441,0.144883,253.5,0,0
8577234,Emmenbrücke Sonnenplatz,,0.000024,90,1,1,2,63354,63357,126711,22,0.09772,0.135716,368,0,0
8577235,"Emmenbrücke, Sprengi",,0.000075,90,4,3,7,71640,71507,143147,21,0.107401,0.162445,6686.833333,0,0
8573035,"Emmenbrücke, Holzhof",,0.000026,90,2,1,3,14423,14423,28846,24,0.084402,0.113959,760,0,0
8573036,"Emmenbrücke, Geisselermoos",,0.000033,90,1,1,2,14423,14423,28846,23,0.091445,0.12805,732,0,0
8573039,"Neuenkirch, Kirche",,0.000022,90,1,2,3,14260,14370,28630,23,0.090977,0.13171,155,0,0
8573040,"Neuenkirch, Klösterli",,0.00002,90,1,1,2,14288,14347,28635,23,0.090299,0.124534,0,0,0
8574533,"Mutten, Oberdorf",,0.000028,109,1,3,4,1245,1350,2595,26,0.111141,0.145262,826,0,0
8574596,"Tartar, Valeina",,0.00006,109,1,1,2,3288,3288,6576,26,0.115344,0.153368,767.5,0,0
8574676,"Domat/Ems, Ems GR, Chemie",,0.000055,109,1,2,3,16301,16295,32596,24,0.144754,0.200376,1175,0,0
8574906,"Thusis, Schützenweg",,0.000054,109,1,1,2,5002,5003,10005,26,0.115344,0.153368,218,0,0
8579936,"Bellinzona, Stazione",,0.000295,108,13,14,27,156422,165992,322414,26,0.135012,0.213254,98916.704762,0,0
8577148,Horw Spitz,,0.000011,90,0,1,1,0,11342,11342,13,0.158526,0.189447,0,0,0
8577172,Perlen Fabrik,,0.000049,90,1,5,6,39110,39112,78222,39,0.085877,0.14691,1725.5,0,0
8577174,Ebikon Fildern,,0.000041,90,1,5,6,105477,105495,210972,39,0.085763,0.145556,48913.42381,0,0
8577181,Root Schlosshof,,0.000055,90,2,5,7,58531,58526,117057,13,0.172575,0.223143,2731.583333,0,0
8580573,"Kriens, Busschleife",,0.000099,90,8,7,15,129949,150621,280570,12,0.187373,0.245804,15181.17619,0,0
8588417,Horw Hofrüti,,0.000032,90,2,2,4,17099,16904,34003,12,0.149793,0.180726,2131.37619,0,0
8589737,Kriens Schappe-Center,,0.000079,90,2,3,5,72138,72110,144248,8,0.295775,0.360336,1385,0,0
8589766,Luzern Allmend/Messe,,0.000048,90,2,2,4,43598,43587,87185,8,0.297561,0.356577,3181.733333,0,0
8589767,Kriens Südpol,,0.000056,90,2,2,4,29439,29494,58933,8,0.29304,0.345015,1702.154762,0,0
8589775,Luzern Bundesplatz,,0.000089,90,7,6,13,201432,201104,402536,8,0.315353,0.394095,4407.97384,0,0
8589780,Luzern Eisfeldstrasse,,0.000164,90,8,6,14,156871,156616,313487,8,0.30837,0.389779,2730.102656,0,0
8589781,Luzern Europe,,0.00011,90,5,4,9,78721,78703,157424,8,0.30137,0.371735,3580.506349,0,0
8589786,Luzern Gartenheim,,0.000048,90,1,2,3,61972,61971,123943,8,0.292453,0.350019,62,0,0
8589787,Luzern Geissenstein,,0.000055,90,2,2,4,61970,61978,123948,8,0.291866,0.350293,22.202381,0,0
8589790,Luzern Giseli,,0.000055,90,2,4,6,58336,58291,116627,7,0.313131,0.381874,373.81746,0,0
8589794,Luzern Gütschwald,,0.000041,90,2,2,4,37014,37017,74031,8,0.294393,0.3524,244.666667,0,0
8589795,Luzern Hirtenhof,,0.000069,90,3,2,5,39444,39456,78900,8,0.291866,0.350293,53.93631,0,0
8589796,Luzern Hirzenhof,,0.000126,90,3,3,6,203478,203334,406812,8,0.298077,0.362922,6016.833333,0,0
8589798,Luzern Hubelmatt,,0.000046,90,2,2,4,48645,48649,97294,8,0.293269,0.351659,129.616667,0,0
8589800,Luzern Kanonenstrasse,,0.000085,90,3,3,6,89923,90012,179935,8,0.300493,0.367506,879.033333,0,0
8573044,"Kriens, Feldmühle",,0.000026,90,2,1,3,66681,66673,133354,47,0.064885,0.098648,619,0,0
8573045,"Obernau, Stampfeli",,0.000033,90,1,1,2,66673,66686,133359,46,0.069245,0.112794,1045,0,0
8573047,"Obernau, Feldmatt",,0.000022,90,1,1,2,1395,1395,2790,18,0.090695,0.102623,460,0,0
8573048,"Obernau, Oberrodel",,0.00003,90,1,1,2,1395,1395,2790,17,0.099225,0.112082,588,0,0
8573049,"Obernau, Schiessstand Stalden",,0.000036,90,1,1,2,1395,1395,2790,16,0.109581,0.124046,714,0,0
8573050,"Hergiswald, Kirche",,0.000042,90,1,1,2,1395,1395,2790,15,0.122423,0.139777,838,0,0
8573054,Luzern Schwanenplatz,,0.000027,90,3,3,6,334087,333925,668012,44,0.07552,0.131177,17324.969048,0,0
8577143,"Gisikon-Root, Bahnhof",,0.000027,90,3,3,6,54492,58537,113029,42,0.07632,0.126468,15311.928571,0,0
8573056,Luzern Gärtnerstrasse,,0.000021,90,2,1,3,31067,31073,62140,12,0.19496,0.222838,336.167216,0,0
8573058,Luzern Unterlöchli,,0.000021,90,2,2,4,61939,80363,142302,44,0.073228,0.132971,926.167216,0,0
8573059,Ebikon Schweizerheim,,0.00002,90,1,3,4,18393,16474,34867,43,0.069906,0.106966,812.333333,0,0
8573063,Adligenswil Widspüel,,0.000038,90,1,3,4,17935,17935,35870,43,0.071015,0.11114,1287,0,0
8577156,Ebikon Schmiedhof,,0.000047,90,1,1,2,91969,91968,183937,44,0.064882,0.090223,2894,0,0
8577157,Ebikon Löwen,,0.000067,90,3,1,4,99780,99780,199560,43,0.069222,0.101011,3313,0,0
8573060,Ebikon Schlössli,,0.000017,90,1,1,2,16016,17935,33951,46,0.058904,0.07928,204,0,0
8573061,Ebikon Bühl,,0.000025,90,1,1,2,17935,17935,35870,45,0.062446,0.08674,567,0,0
8573062,Adligenswil Stuben,,0.000032,90,1,1,2,17935,17935,35870,44,0.06645,0.09656,928,0,0
8577161,Ebikon Bahnhof,,0.000054,90,2,7,9,164325,188206,352531,41,0.079895,0.140541,21454.511905,0,0
8573068,"Udligenswil, Götzentalstrasse",,0.000026,90,1,1,2,5570,6125,11695,40,0.071127,0.092266,3878.495238,0,0
8573069,"Udligenswil, Neuheim",,0.000033,90,1,1,2,6125,6125,12250,39,0.076384,0.10243,4249.495238,0,0
8573070,"Udligenswil, alte Post",,0.000039,90,1,1,2,6125,6125,12250,38,0.082495,0.116233,4618.495238,0,0
8577176,Dierikon-Migros,,0.000026,90,2,1,3,39502,39506,79008,38,0.082495,0.116233,41065,0,0
8577393,Altdorf Ruberst/Neuland,,0.000056,93,2,3,5,17303,17287,34590,10,0.202479,0.273081,681.888095,0,0
8573093,"Seedorf UR, Seehof",,0.000021,93,1,1,2,948,948,1896,13,0.125786,0.162074,330,0,0
8573094,"Seedorf UR, Bolzbach",,0.000029,93,1,1,2,948,948,1896,12,0.140288,0.176598,336,0,0
8573098,"Isenthal, Chäppeli",,0.000035,93,1,1,2,948,948,1896,11,0.158996,0.196398,340,0,0
8573099,"Isenthal, Heissrüti",,0.000041,93,1,1,2,948,948,1896,10,0.18408,0.225719,342,0,0
8573100,"Isenthal, Schwybogenbrücke",,0.000046,93,1,2,3,948,948,1896,9,0.219512,0.277921,342,0,0
8577394,Attinghausen Post,,0.000037,93,2,2,4,12558,12558,25116,9,0.227488,0.285177,362.764286,0,0
8577395,Bürglen Seminar,,0.00005,93,2,4,6,24260,24276,48536,8,0.274854,0.360005,2273.9,0,0
8581321,"Isenthal, Luss",,0.000054,93,1,1,2,867,867,1734,9,0.20979,0.251839,150,0,0
8573101,"Isenthal, Weid-Furggelen",,0.00003,93,1,1,2,867,867,1734,14,0.113636,0.155672,190,0,0
8573102,"Isenthal, Schwanden",,0.000037,93,1,1,2,867,867,1734,13,0.124542,0.165803,186,0,0
8573103,"Isenthal, Schluchen",,0.000042,93,1,1,2,867,867,1734,12,0.138075,0.178536,180,0,0
8573104,"Isenthal, Chliwäldli",,0.000047,93,1,1,2,867,867,1734,11,0.15534,0.195165,172,0,0
8573105,"Isenthal, Stettli",,0.000051,93,1,1,2,867,867,1734,10,0.178161,0.218024,162,0,0
8573140,"Andermatt, Bahnhof",,0.000045,108,2,2,4,450,450,900,15,0.168571,0.243433,1025,0,0
8577380,Schattdorf Rynächt,,0.000057,93,2,2,4,26571,26571,53142,15,0.157685,0.221212,2009.82619,0,0
8577391,Amsteg Grund / Seilbahn,,0.00005,93,1,2,3,21856,21880,43736,15,0.170213,0.271095,312,0,0
8573116,Altdorf Kollegium,,0.000086,93,5,6,11,50418,50847,101265,18,0.144304,0.244468,4847.597619,0,0
8577370,Flüelen Altersheim,,0.00005,93,1,1,2,25096,25097,50193,25,0.079393,0.10537,89,0,0
8573124,"Unterschächen, Stutz",,0.000057,93,1,3,4,1913,1913,3826,21,0.126904,0.203455,1345.5,0,0
8573125,"Unterschächen, Ribi",,0.000027,93,1,2,3,851,851,1702,21,0.115385,0.164481,846,0,0
8573126,"Unterschächen, Frittertal",,0.000022,93,1,2,3,456,456,912,21,0.116114,0.165856,778,0,0
8577374,Altdorf Ringli,,0.000068,93,1,1,2,25445,25445,50890,21,0.110246,0.151264,425,0,0
8577376,Altdorf Gemeindehaus,,0.000054,93,1,1,2,27295,27292,54587,19,0.135179,0.189693,1613.366667,0,0
8577379,Schattdorf Adlergarten,,0.00004,93,1,1,2,26393,26393,52786,16,0.137694,0.180195,1040,0,0
8573117,Bürglen Hartolfingen,,0.000023,93,1,1,2,24276,24276,48552,20,0.11275,0.154458,1219,0,0
8573119,"Spiringen, Grindli",,0.000037,93,2,1,3,1913,1913,3826,26,0.080583,0.106119,1220.5,0,0
8573120,"Spiringen, Locherbach",,0.000042,93,1,1,2,1913,1913,3826,25,0.086811,0.11475,1249.5,0,0
8573121,"Spiringen, Holzboden",,0.000047,93,1,1,2,1913,1913,3826,24,0.09415,0.125885,1276.5,0,0
8573122,"Spiringen, Kipfen-Tristel",,0.000051,93,1,1,2,1913,1913,3826,23,0.102926,0.141005,1301.5,0,0
8573123,"Spiringen, Glätti",,0.000054,93,1,1,2,1913,1913,3826,22,0.113611,0.163374,1324.5,0,0
8579872,"Linthal, Bebié",,0.000069,128,3,2,5,1913,1672,3585,8,0.231579,0.290043,2259.5,0,0
8573128,"Urnerboden, Vorfrutt",,0.000035,128,2,1,3,384,384,768,24,0.099174,0.134218,947.5,0,0
8577526,"Schwanden GL, Bahnhof",,0.000153,128,7,6,13,22990,20440,43430,9,0.222222,0.328083,1923.5,0,0
8573141,"Hospental, Dorf",,0.00003,108,1,2,3,257,257,514,5,0.344828,0.461667,632,0,0
8573146,"Hospental, Zumdorf",,0.000024,108,1,1,2,129,129,258,5,0.321429,0.401852,0,0,0
8573158,"Langnau am Albis, Hinteralbis",,0.000036,63,1,1,2,1222,1229,2451,30,0.057389,0.063872,1036,0,0
8573161,"Langnau-Gattikon, Bahnhof",,0.00007,63,2,1,3,3151,3151,6302,27,0.068885,0.077204,7701,0,0
8573162,"Gattikon, Gattikerhof",,0.000071,63,1,1,2,3151,3151,6302,26,0.073834,0.083319,8174,0,0
8573163,"Gattikon, Gattikerhöhe",,0.000071,63,1,1,2,3151,3152,6303,25,0.079562,0.090764,8645,0,0
8573164,"Thalwil, Feldstrasse",,0.000071,63,1,1,2,3152,3151,6303,24,0.086266,0.100119,9114,0,0
8573165,"Thalwil, Schützenhaus",,0.000072,63,1,1,2,3151,3173,6324,23,0.094222,0.112477,9581,0,0
8590779,"Rüschlikon, Moosstrasse",,0.000072,130,1,1,2,24420,24496,48916,17,0.104953,0.114855,3553.666667,0,0
8590812,"Thalwil, Alterszentrum",,0.000024,63,2,2,4,2316,2317,4633,5,0.341463,0.433333,132,0,0
8590814,"Thalwil, Aubrigstrasse",,0.000068,130,2,2,4,3411,3411,6822,5,0.342105,0.441026,961,0,0
8590815,"Thalwil, Böni",,0.000063,130,4,2,6,2627,2627,5254,4,0.416667,0.516667,892,0,0
8590817,"Thalwil, Gewerbestrasse",,0.000038,130,1,3,4,2600,2425,5025,4,0.473684,0.601852,422,0,0
8590822,"Thalwil, Pilgerweg",,0.00003,130,1,1,2,1363,1363,2726,4,0.416667,0.516667,68,0,0
8590823,"Thalwil, Platte",,0.00006,130,2,2,4,3411,3411,6822,4,0.454545,0.616667,10.5,0,0
8573169,"Hausen am Albis, Grindlen",,0.000023,115,1,1,2,3162,3157,6319,20,0.106416,0.117944,941.917112,0,0
8573170,"Rifferswil, Seleger Moor",,0.00003,115,1,1,2,3157,3162,6319,19,0.118954,0.134752,1805.917112,0,0
8573194,"Ottenbach, Rickenbach",,0.000025,115,1,1,2,2988,2988,5976,21,0.087597,0.099972,0,0.002303,0.002358
8580300,"Mettmenstetten, Rossauerstr.",,0.000058,115,1,1,2,1983,1833,3816,3,0.5,0.566667,41.666667,0,0.002358
8573179,"Maschwanden, Sagi",,0.00002,115,1,1,2,4525,4526,9051,10,0.164384,0.262599,12,0,0
8573181,"Mettmenstetten, Bahnhof",,0.000039,115,2,1,3,6434,1796,8230,8,0.2,0.300357,36.666667,0.000302,0
8573184,"Kappel a.A., Allenwinden",,0.000034,115,1,1,2,1983,1987,3970,6,0.285714,0.408333,306,0.001756,0
8573185,"Uerzlikon, Kappelerstrasse",,0.00004,115,1,1,2,1987,1987,3974,5,0.333333,0.456667,260,0,0
8573186,"Uerzlikon, Weid",,0.000045,115,1,1,2,1987,1987,3974,4,0.4,0.520833,212,0,0
8573187,"Baar, Bachtalerhöhe",,0.000049,115,1,1,2,1987,1986,3973,3,0.5,0.611111,162,0,0
8573188,"Blickensdorf, H. Waldmann-Str",,0.000052,115,1,1,2,1986,1986,3972,2,0.666667,0.75,110,0,0
8573189,"Baar, Waldmannhalle",,0.000055,115,1,1,2,1986,1987,3973,1,1,1,56,0,0
8573193,"Zwillikon, Fehrenbach",,0.000025,115,1,1,2,2944,2944,5888,14,0.096135,0.113937,216,0.002303,0
8582104,"Zwillikon, Lochhof",,0.000039,115,1,1,2,2944,2944,5888,12,0.116422,0.135629,190,0,0.000628
8582054,"Muri AG, Grindelstrasse",,0.000053,115,1,3,4,11066,10029,21095,18,0.11677,0.140812,4410.130631,0.000014,0.021581
8583069,"Ottenbach, Rigiblick",,0.000035,115,1,1,2,2988,2988,5976,10,0.14673,0.163035,368,0,0.001139
8573697,"Hettlingen, Föhrenstrasse",,0.000081,68,3,7,10,19301,18270,37571,13,0.160221,0.259907,3304.240476,0,0
8573701,"Henggart, Bahnhof",,0.000045,68,3,3,6,10567,10598,21165,14,0.139726,0.202261,407.157143,0,0
8573197,"Kleinandelfingen, Dorf",,0.000022,68,1,1,2,4252,4234,8486,42,0.041066,0.059846,5060,0,0
8573200,"Ossingen, Usserdorf",,0.000024,65,1,1,2,4245,4252,8497,39,0.04451,0.065995,14030,0,0
8573201,"Oberneunforn, Dorf",,0.000031,65,1,1,2,4252,4252,8504,38,0.046444,0.071711,14301,0,0
8573328,"Stammheim, Frohsinn",,0.000044,65,2,1,3,5216,5216,10432,39,0.041993,0.05892,60,0,0
8573209,"Winkel, Oberdorf",,0.000035,107,2,3,5,14016,14009,28025,20,0.115198,0.141921,835.621409,0.00043,0.006624
8573242,"Rümlang, Rümelbach",,0.000016,107,1,1,2,10199,10205,20404,22,0.131937,0.152805,2474.697398,0,0.000417
8573232,"Kloten, Freienberg",,0.000078,107,3,3,6,56450,56465,112915,30,0.111503,0.146813,8709.366667,0.000448,0.093013
8576159,"Bassersdorf, Schmitte",,0.000027,107,3,3,6,22019,21984,44003,22,0.113147,0.138527,2930.983169,0.000008,0.003706
8576160,"Bassersdorf, Löwen",,0.000021,107,1,2,3,18250,18249,36499,16,0.119875,0.138572,234.666667,0,0.003618
8579843,"Kloten, Sporthalle Ruebisbach",,0.000024,107,2,1,3,13839,13853,27692,16,0.119426,0.13549,0,0.000322,0.000523
8579969,"Kloten, Chanzler",,0.000047,107,1,2,3,26456,26463,52919,16,0.120653,0.140912,916,0,0.003664
8583769,"Niederglatt ZH, Seeblerstrasse",,0.000072,107,3,1,4,10708,10197,20905,13,0.168999,0.187964,13082.682925,0.000005,0.010978
8587655,"Wallisellen, Bahnhof",,0.000032,107,3,6,9,70436,112150,182586,14,0.166415,0.195147,24820.43085,0.004797,0.012498
8580301,"Zürich Flughafen, OPC",,0.00013,107,10,6,16,166671,166575,333246,15,0.135327,0.163061,9535.002761,0.003445,0.09926
8573220,"Rorbas, Hirschen",,0.000084,107,1,2,3,21407,21078,42485,24,0.079632,0.094516,6668.333333,0,0.000156
8573226,"Embrach, Zürcherstrasse",,0.000068,107,5,1,6,26789,26655,53444,34,0.077573,0.089422,6501.5,0.000174,0.000152
8573230,"Lufingen, Augwil",,0.000071,107,1,1,2,30002,29992,59994,31,0.100485,0.124338,8048,0,0.000448
8573214,"Kloten, Balsberg Hardacher",,0.000015,107,1,3,4,96611,96587,193198,28,0.12277,0.155739,6508.818696,0.000289,0.000168
8573234,"Kloten, Hohrainli",,0.000039,107,1,2,3,26462,26460,52922,28,0.089963,0.107261,1535,0,0.000164
8576152,"Kloten, Kirchgasse",,0.000034,107,3,3,6,54145,54153,108298,27,0.098618,0.121551,2297.276299,0.000156,0.000168
8573216,"Teufen ZH, Schulhaus",,0.000033,107,2,1,3,8034,8035,16069,28,0.060759,0.067596,601,0.000004,0
8573217,"Teufen ZH, Schloss",,0.000039,107,1,1,2,8035,8035,16070,27,0.064575,0.072251,1149,0,0
8573219,"Rorbas, Dorfplatz",,0.000086,107,4,1,5,21411,21407,42818,25,0.07388,0.08486,6148.333333,0.00016,0
8573691,"Winterthur, Spital",,0.000032,68,3,4,7,24287,24289,48576,16,0.144989,0.212338,548.8,0,0.000004
8573223,"Embrach-Rorbas, Bahnhof",,0.000036,107,3,2,5,29919,29764,59683,36,0.067599,0.078829,125.833333,0.000165,0
8573228,"Lufingen, Unterdorf",,0.00007,107,2,1,3,29974,29980,59954,33,0.083941,0.098195,7070,0.000152,0
8573229,"Lufingen, Hintermarchlen",,0.000071,107,1,1,2,29980,30002,59982,32,0.091463,0.109357,7560,0,0
8583052,"Embrach, Im Feld",,0.000029,107,1,1,2,13367,13371,26738,15,0.132195,0.148228,0,0.002292,0.087421
8583775,"Winkel, Wisental",,0.000075,107,2,1,3,27672,27534,55206,15,0.132195,0.148228,836,0.002346,0.087421
8587420,"Kloten, Bahnhof",,0.000109,107,6,5,11,53247,53000,106247,15,0.134436,0.158818,5295.195238,0.000219,0.096591
8587799,"Kloten Balsberg, Bahnhof",,0.000111,85,6,4,10,106819,106564,213383,12,0.202947,0.237741,39833.52059,0.010978,0.193094
8588319,"Brüttisellen, Zentrum",,0.000045,107,1,2,3,64127,66728,130855,15,0.133931,0.154249,15642.259422,0,0.089591
8573233,"Kloten, Kaserne Ost",,0.000033,107,1,1,2,26463,26462,52925,29,0.082679,0.095578,1054,0.002148,0
8573238,"Oberglatt ZH, Rietli",,0.000019,107,1,2,3,20055,20019,40074,19,0.110372,0.128463,0,0.000141,0.000424
8573259,"Bülach, Niederflachs",,0.000029,107,2,1,3,12063,12063,24126,17,0.103119,0.112846,196.666667,0.000194,0.000144
8580617,"Bülach, Kaffeestrasse",,0.00003,107,1,1,2,18373,18353,36726,11,0.195876,0.295783,370.666667,0,0.000019
8573240,"Rümlang, Riedmatt",,0.000033,107,3,1,4,10179,10189,20368,24,0.10856,0.123971,2701.588284,0.000273,0
8573241,"Rümlang, Bahnhof",,0.000039,107,1,6,7,10189,49405,59594,23,0.121597,0.145731,3319.588284,0,0
8590765,"Rümlang, Letten",,0.000016,107,1,1,2,18774,18785,37559,12,0.130072,0.138728,0,0,0
8594236,"Rümlang, Hörnlistrasse",,0.000086,85,3,2,5,21603,2809,24412,3,0.571429,0.708333,5476,0.002332,0
8595709,"Rümlang, Heuelstrasse",,0.000053,85,2,1,3,4978,4989,9967,3,0.5,0.611111,0,0,0
8580536,"Opfikon, Schulstrasse",,0.000017,107,1,2,3,31279,37258,68537,15,0.148346,0.168058,507.2,0.001303,0.00379
8587654,"Glattbrugg, Glatthof",,0.000018,107,1,2,3,31292,52131,83423,15,0.149363,0.170588,22298.372157,0.005673,0.005028
8588510,"Ettiswil, Surseestrasse",,0.000062,59,1,1,2,2950,2550,5500,2,0.666667,0.75,96,0,0
8573251,"Stadel b. N., Neuwis-Huus",,0.000063,107,5,3,8,19339,19333,38672,20,0.094532,0.106745,1285.535714,0.004588,0.000186
8573265,"Dielsdorf, Erlen",,0.000045,107,1,1,2,4724,4721,9445,26,0.053914,0.058488,604,0,0.000004
8573260,"Höri, Fuhrstrasse",,0.000043,107,2,3,5,12537,12537,25074,16,0.114754,0.129163,1097.166723,0.000144,0.000203
8573254,"Bülach, Hirslen",,0.000039,107,3,1,4,12402,12414,24816,19,0.092362,0.101725,592.9,0.000266,0
8573255,"Bülach, Hinterbirch",,0.000044,107,1,1,2,12414,12414,24828,18,0.101583,0.113801,1113.9,0,0
8573263,"Niederglatt ZH, Zentrum",,0.000028,107,1,3,4,16679,16189,32868,15,0.14452,0.161471,1287.258333,0,0.000202
8573276,"Dielsdorf, Wehntalerstrasse",,0.000045,107,1,2,3,4724,4724,9448,16,0.113363,0.123589,5599,0,0.000196
8580583,"Bülach, Gewerbehaus",,0.000061,107,4,3,7,35051,17286,52337,15,0.127574,0.141112,9370.666258,0.000187,0.00003
8580620,"Bachenbülach, Bramenstrasse",,0.000023,107,1,2,3,14134,14128,28262,11,0.193182,0.335483,61.166667,0.000005,0.000028
8573272,"Steinmaur, Heitlig",,0.00007,107,1,1,2,5027,4869,9896,20,0.078593,0.084048,3628,0,0.000005
8573261,"Niederglatt ZH, Nöschikon",,0.000035,107,2,1,3,22030,22039,44069,17,0.112651,0.12166,1634.016667,0.000011,0
8573262,"Niederglatt ZH,Altes Schulhaus",,0.000041,107,1,2,3,22039,22036,44075,16,0.126705,0.139317,2088.016667,0,0
8582720,"Niederglatt ZH, Sonnenbergstr.",,0.000028,107,1,2,3,5357,5359,10716,14,0.145079,0.158979,1193.758333,0,0.000002
8583712,"Weiach, Oberdorfstrasse",,0.000048,107,3,1,4,12102,10234,22336,14,0.144823,0.157242,9327.832925,0.00001,0.000005
8573264,"Niederhasli, Dorf",,0.00004,107,2,1,3,4720,4724,9444,27,0.051249,0.055817,139,0.000178,0
8573267,"Stadel b. N., Stig",,0.000067,107,2,1,3,5195,5182,10377,25,0.056877,0.061476,1343,0.000004,0
8573268,"Bachs, Alt-Bachs",,0.000067,107,1,1,2,5182,5190,10372,24,0.060191,0.06484,1804,0,0
8573269,"Bachs, Milchhütte",,0.000068,107,1,1,2,5190,5187,10377,23,0.063922,0.068658,2263,0,0
8573270,"Bachs, Neu-Bachs",,0.000069,107,1,1,2,5187,5032,10219,22,0.068155,0.073032,2720,0,0
8573271,"Bachs, Weiherbach",,0.000069,107,1,1,2,5032,5027,10059,21,0.072998,0.078099,3175,0,0
8573273,"Steinmaur, Obersteinmaur",,0.000083,107,2,1,3,5129,5134,10263,19,0.085131,0.09116,4332,0.000005,0
8573274,"Steinmaur, Gemeindehaus",,0.000081,107,1,1,2,5134,5143,10277,18,0.092871,0.099905,4779,0,0
8573275,"Steinmaur, Bahnhof",,0.00008,107,1,2,3,5143,4984,10127,17,0.10218,0.111384,5224,0,0
8573277,"Dielsdorf, Bahnhof",,0.000011,107,0,2,2,0,30707,30707,13,0.122664,0.136436,0,0,0
8576250,"Watt, Schulhaus",,0.000023,107,1,1,2,24446,24446,48892,13,0.121492,0.13184,225,0,0
8573279,"Bauma, Hörnen",,0.00002,84,1,1,2,3055,3058,6113,6,0.285714,0.408333,60,0,0
8573280,"Bauma, Schindlet",,0.000028,84,1,1,2,3058,3058,6116,5,0.333333,0.456667,55,0,0
8573281,"Bauma, Musterplatz",,0.000035,84,1,1,2,3058,3057,6115,4,0.4,0.520833,48,0,0
8573282,"Sternenberg, Höchstock",,0.00004,84,1,1,2,3057,3058,6115,3,0.5,0.611111,39,0,0
8573283,"Sternenberg, Rossweid",,0.000045,84,1,1,2,3058,3057,6115,2,0.666667,0.75,28,0,0
8573284,"Frauenfeld, Scheidweg",,0.000122,65,3,2,5,19672,19672,39344,37,0.047465,0.074956,4669.5,0,0
8573285,"Felben, Unterdorf",,0.000063,65,1,1,2,8601,8601,17202,37,0.047325,0.072083,0,0,0
8573286,"Weinfelden, Bahnhof",,0.000114,65,4,4,8,13214,14076,27290,45,0.049747,0.07615,55581,0,0
8573355,"Ermatingen, Bahnhof",,0.000041,65,1,1,2,4580,4801,9381,45,0.048505,0.071459,1504,0,0
8573616,"Wil SG, Schwanen",,0.000081,20,5,9,14,99172,106233,205405,36,0.063117,0.094048,8261.333333,0,0
8573287,"Weinfelden, Aeuli",,0.000035,65,1,1,2,4823,4607,9430,29,0.0568,0.075868,4566,0,0
8573403,"Kreuzlingen, Löwenstrasse",,0.000043,65,1,1,2,9991,9991,19982,29,0.0568,0.075868,37530,0,0
8573322,"Frauenfeld, Sportplatz",,0.000061,65,1,2,3,14895,14895,29790,35,0.051836,0.091157,1397.5,0,0
8573301,"Frauenfeld, Thurgipark",,0.000116,65,2,1,3,19672,19669,39341,36,0.049522,0.079687,5245.5,0,0
8573302,"Frauenfeld, Wellauer",,0.000109,65,1,2,3,19669,19671,39340,35,0.05194,0.091498,5530.5,0,0
8573303,"Frauenfeld, Schlosspark",,0.000027,65,1,1,2,6778,6780,13558,34,0.052166,0.09284,903,0,0
8573319,"Uesslingen, Thurbrücke",,0.000067,65,1,1,2,4537,4537,9074,34,0.052166,0.09284,1806,0,0
8573323,"Warth, Breite",,0.000058,65,2,2,4,12375,12374,24749,34,0.054216,0.102016,22819.5,0,0
8573326,"Hüttwilen, Neumühle",,0.000037,65,1,2,3,6663,6663,13326,34,0.053013,0.099006,831,0,0
8573327,"Stein am Rhein, Bahnhof",,0.000034,65,2,3,5,21396,21396,42792,34,0.053223,0.102906,1683,0,0
8573334,"Diessenhofen, Bahnhof",,0.000068,65,1,2,3,7042,7042,14084,34,0.052194,0.095332,1528.5,0,0
8573341,"Steckborn, Bahnhof",,0.000045,65,1,1,2,8444,8444,16888,34,0.052166,0.09284,3352,0,0
8573345,"Müllheim Dorf, Kirche",,0.000063,65,1,1,2,11071,11071,22142,34,0.052166,0.09284,903,0,0
8573363,"Aadorf, Bahnhof",,0.000052,65,2,2,4,9064,8947,18011,34,0.052331,0.095844,2725,0,0
8573366,"Thundorf, Ildbach",,0.00005,65,3,1,4,6112,6112,12224,34,0.052166,0.09284,1505,0,0
8573310,"Rickenbach Sulz, Mottlistrasse",,0.000028,64,1,1,2,7648,7648,15296,3,0.5,0.583333,8,0,0
8573311,"Rickenbach-Attikon, Bahnhof",,0.000035,64,1,2,3,7648,7646,15294,2,0.75,0.833333,9,0,0
8576302,"Altikon, Brückenwaage",,0.000026,64,1,1,2,3230,3216,6446,2,0.666667,0.75,0,0,0
8573312,"Frauenfeld, Jugendmusikschule",,0.000113,65,5,2,7,19431,19426,38857,37,0.048073,0.078256,1434.5,0,0
8573313,"Frauenfeld, Neuhofstrasse",,0.000059,65,1,1,2,4537,4537,9074,40,0.040411,0.05577,456,0,0
8573314,"Frauenfeld, Sonnmatt",,0.000061,65,1,1,2,4537,4537,9074,39,0.041975,0.058739,686,0,0
8573315,"Frauenfeld, Hilzinger",,0.000063,65,1,1,2,4537,4537,9074,38,0.043671,0.062307,914,0,0
8573316,"Frauenfeld, Graströchni",,0.000064,65,1,1,2,4537,4537,9074,37,0.045516,0.066729,1140,0,0
8573317,"Erzenholz, Schulhaus",,0.000065,65,1,1,2,4537,4537,9074,36,0.047529,0.072458,1364,0,0
8573318,"Erzenholz, Dorfbrunnen",,0.000066,65,1,1,2,4537,4537,9074,35,0.049736,0.080406,1586,0,0
8573321,"Frauenfeld, Thurstrasse",,0.000059,65,1,1,2,14889,14895,29784,36,0.049428,0.079432,1154.5,0,0
8573324,"Warth, Oberdorf",,0.000035,65,1,1,2,8232,8232,16464,36,0.049122,0.079845,656.5,0,0
8578397,"Stein am Rhein, Rathaus",,0.000021,65,1,1,2,6629,6629,13258,4,0.375,0.458333,0,0,0
8573330,"Unterstammheim, Adler",,0.000063,65,2,1,3,7042,7037,14079,38,0.04369,0.062553,656.5,0,0
8573331,"Unterstammheim, Neubr.-Ulmerh.",,0.000065,65,1,1,2,7037,7041,14078,37,0.045536,0.067081,877.5,0,0
8573332,"Schlattingen, Hauptstrasse",,0.000066,65,1,1,2,7041,7042,14083,36,0.047552,0.073008,1096.5,0,0
8573333,"Basadingen, Grüt",,0.000067,65,1,1,2,7042,7042,14084,35,0.049761,0.081399,1313.5,0,0
8580247,"Nussbaumen TG, Tobelbrunnen",,0.000025,65,1,1,2,5216,5216,10432,1,1,1,141.5,0,0
8573337,"Hörhausen, alte Post",,0.000069,65,2,1,3,10974,10974,21948,37,0.046726,0.072883,2912,0,0
8573340,"Steckborn, Schulhaus Hub",,0.00004,65,1,1,2,8444,8444,16888,35,0.049736,0.080406,3098,0,0
8573342,"Wellhausen, Weinfelderstrasse",,0.000057,65,1,1,2,11070,11071,22141,37,0.045516,0.066729,111,0,0
8573343,"Felben-Wellhausen, Schulhaus",,0.00006,65,1,1,2,11071,11071,22142,36,0.047529,0.072458,377,0,0
8573344,"Pfyn, Grütli",,0.000062,65,1,1,2,11071,11071,22142,35,0.049736,0.080406,641,0,0
8573346,"Müllheim-Wigoltingen, Bahnhof",,0.000072,65,2,2,4,5451,5451,10902,8,0.206522,0.3099,519.5,0,0
8573349,"Illhart, Oberdorf",,0.000042,65,1,1,2,2921,2921,5842,8,0.191176,0.270238,227,0,0
8573350,"Raperswilen, Im Wiel",,0.000046,65,1,1,2,2921,2921,5842,7,0.218182,0.295238,190,0,0
8573352,"Fruthwilen, Oberfruthwilen",,0.000035,65,1,1,2,4580,4580,9160,46,0.046291,0.064822,51,0,0
8573356,"Müllheim, Alterssiedlung",,0.000042,65,1,1,2,2530,2530,5060,7,0.225,0.325132,213.5,0,0
8573357,"Müllheim, Ober Hungerbüel",,0.000046,65,1,1,2,2530,2530,5060,6,0.258065,0.35625,172.5,0,0
8573358,"Oberhörstetten, Abzw.",,0.00005,65,1,1,2,2530,2530,5060,5,0.304348,0.397619,129.5,0,0
8573360,"Frauenfeld, Reutenenstrasse",,0.000018,65,1,1,2,8830,8830,17660,37,0.045638,0.06733,36,0,0
8573361,"Häuslenen, Moos",,0.000027,65,1,1,2,8830,8438,17268,36,0.047664,0.073316,327,0,0
8579758,"Steckborn, im Rank",,0.000048,65,1,3,4,8444,8444,16888,4,0.434783,0.558333,340,0,0
8581758,"Steckborn, Feldbach",,0.000025,65,1,2,3,4219,4219,8438,4,0.409091,0.509259,0,0,0
8581971,"Lipperswil, Kellhof",,0.000158,65,3,2,5,12115,9194,21309,4,0.409091,0.509259,646,0,0
8581972,"Dettighofen, Linde",,0.000035,65,2,1,3,1786,1786,3572,4,0.380952,0.447917,0,0,0
8573376,"Kreuzlingen, Bahnhof",,0.000072,65,2,2,4,13966,14605,28571,32,0.051063,0.07633,37773,0,0
8573379,"Tägerwilen, Hertler",,0.00005,65,1,2,3,4614,4614,9228,32,0.050648,0.074068,508,0,0
8573377,"Kreuzlingen, MOWAG",,0.000041,65,1,1,2,4614,4614,9228,34,0.046326,0.062874,348,0,0
8573378,"Tägerwilen, Kirche",,0.000046,65,1,1,2,4614,4614,9228,33,0.048387,0.067235,429,0,0
8573401,"Kreuzlingen, Rebstockplatz",,0.000063,65,2,2,4,12301,12298,24599,31,0.053006,0.077354,38057,0,0
8573384,"Engwang, Dorf",,0.00005,65,1,1,2,2921,2921,5842,6,0.255814,0.330303,151,0,0
8573385,"Märstetten, Obstgarten",,0.000041,65,1,1,2,4580,4580,9160,10,0.154639,0.235344,590,0,0
8573386,"Märstetten, Bahnhof",,0.000045,65,1,1,2,4580,4580,9160,9,0.170732,0.250964,550,0,0
8573688,Berg am Irchel,,0.000071,68,2,2,4,5143,5192,10335,14,0.144981,0.208625,1177.333333,0,0
8573702,"Volken, Post",,0.000045,68,3,1,4,9071,9077,18148,13,0.141593,0.204414,862.733333,0,0
8573705,"Flaach, Ziegelhütte",,0.000027,68,1,1,2,4114,4116,8230,13,0.132716,0.169787,1512,0,0
8573707,"Rüdlingen, Sandgruben",,0.000044,68,1,1,2,4677,4677,9354,11,0.171548,0.218448,1482,0,0
8573402,"Kreuzlingen, Kolosseumplatz",,0.000038,65,1,1,2,9988,9991,19979,30,0.053954,0.070612,37462,0,0
8573404,"Kreuzlingen, Bärenplatz",,0.000077,65,2,1,3,14598,16066,30664,28,0.059976,0.08312,42378,0,0
8573405,"Kreuzlingen, Seminar",,0.000076,65,1,3,4,16066,15850,31916,27,0.063542,0.09555,42412,0,0
8581620,"Opfershofen TG, Dorf",,0.000048,65,1,1,2,4823,4823,9646,18,0.105263,0.185311,60,0,0
8573406,"Kreuzlingen, Blaues-Haus-Platz",,0.000033,65,1,2,3,10629,10629,21258,26,0.064035,0.088445,37356,0,0
8573408,"Kreuzlingen, Kurzrickenbach",,0.000032,65,1,1,2,1313,1313,2626,26,0.063506,0.082348,217,0,0
8573407,"Kreuzlingen, Breite",,0.000025,65,1,1,2,1313,1313,2626,27,0.059972,0.076565,213,0,0
8573409,"Kreuzlingen, Zihlstrasse",,0.000052,65,2,1,3,10629,10629,21258,25,0.0675,0.090127,37368,0,0
8573411,"Bottighofen, Turnhalle",,0.000034,65,1,1,2,9353,9353,18706,25,0.06698,0.087076,217,0,0
8573413,"Münsterlingen, Spitaleingang",,0.000092,65,3,3,6,15550,15550,31100,23,0.07659,0.112368,37992,0,0
8573427,"Landschlacht, Vorderdorf",,0.000029,65,1,1,2,638,638,1276,27,0.057995,0.072001,209,0,0
8573415,"Scherzingen, Bäckerstübli",,0.000037,65,1,3,4,6197,6197,12394,22,0.081846,0.116449,34413,0,0
8573430,"Altnau, Zentrum",,0.000065,65,1,1,2,5313,5313,10626,24,0.069118,0.088356,812,0,0
8573417,Schönenbaumgarten,,0.000021,65,1,1,2,4921,4921,9842,21,0.082652,0.09989,33936,0,0
8573418,"Zuben, Kreuzstrasse",,0.000029,65,1,1,2,4921,4921,9842,20,0.089629,0.109971,33903,0,0
8573419,"Herrenhof, Dorf",,0.000036,65,1,1,2,4921,4920,9841,19,0.097938,0.123929,33868,0,0
8581717,"Kreuzlingen, Seepark",,0.000114,65,3,2,5,10628,10629,21257,19,0.098403,0.128516,3280,0,0
8581718,"Scherzingen, Kirche",,0.000059,65,1,1,2,1276,1276,2552,19,0.097938,0.123929,0,0,0
8573422,"Mattwil, Ochsen",,0.000033,65,1,1,2,4607,4607,9214,21,0.089844,0.165462,636,0,0
8573426,"Landschlacht, Schulstrasse",,0.000021,65,1,1,2,638,638,1276,28,0.055068,0.068421,227,0,0
8573428,"Altnau, Längiacker",,0.000062,65,2,1,3,5313,5313,10626,26,0.061267,0.076254,858,0,0
8573429,"Altnau, Unterhof",,0.000063,65,1,1,2,5313,5313,10626,25,0.064947,0.081488,836,0,0
8573431,"Altnau, Kirche",,0.000102,65,3,2,5,10629,10629,21258,23,0.073884,0.099036,3698,0,0
8581675,"Altnau, Schmitteweg",,0.000057,65,1,3,4,9991,9991,19982,22,0.078927,0.107187,430,0,0
8581678,"Güttingen, Zentrum",,0.000027,65,1,1,2,4678,4678,9356,23,0.072947,0.091317,0,0,0
8573432,"Altnau, Rössli",,0.000054,65,1,1,2,9991,9991,19982,23,0.073492,0.093891,460,0,0
8573433,"Rheinau, Hallenbad",,0.000036,66,2,1,3,6006,6009,12015,1,1,1,30,0,0
8573435,"Rudolfingen, Dorf",,0.000043,66,3,1,4,4702,4695,9397,9,0.154472,0.223663,697,0,0
8573436,"Trüllikon, Kindergarten",,0.000047,66,1,1,2,4695,4728,9423,8,0.173077,0.247553,652,0,0
8573458,Schützenhaus,,0.000052,66,1,3,4,60611,60611,121222,13,0.161148,0.207192,890,0,0
8573445,"Feuerthalen, Kirchstrasse",,0.00005,66,3,1,4,12677,12691,25368,6,0.217391,0.277778,727.5,0,0
8573447,"Uhwiesen, Rebhof",,0.000054,66,1,1,2,12691,12691,25382,5,0.259259,0.315476,670.5,0,0
8573449,"Feuerthalen, Stumpenboden",,0.000056,66,1,1,2,12691,12683,25374,4,0.325,0.378205,611.5,0,0
8573450,"Feuerthalen, Lindenbuck",,0.000059,66,1,2,3,12683,10215,22898,3,0.444444,0.513889,550.5,0,0
8573455,"Dachsen, Bahnhof",,0.000046,66,1,2,3,7729,5625,13354,3,0.45,0.537037,18,0,0
8573737,Lindli,,0.000035,66,1,2,3,12642,12643,25285,4,0.380952,0.453125,729.5,0,0
8573747,Dörflingen Kirche,,0.000032,66,2,2,4,1600,1860,3460,3,0.454545,0.533333,77.333333,0,0
8573755,Buch Brücke,,0.000042,66,3,3,6,5288,5288,10576,3,0.529412,0.62963,159.666667,0,0
8573453,"Uhwiesen, Unterdorf",,0.000036,66,1,1,2,7742,7734,15476,5,0.268293,0.337879,150,0,0
8573454,"Dachsen, Lindenstrasse",,0.000041,66,1,1,2,7734,7729,15463,4,0.333333,0.4,85,0,0
8581073,"Schaffhausen, Bachstrasse",,0.000096,66,5,4,9,15737,11028,26765,2,0.666667,0.75,718.666667,0,0
8573456,Promenade,,0.000045,66,2,1,3,60609,60609,121218,15,0.123231,0.144208,644,0,0
8573457,Steigbrunnen,,0.000049,66,1,1,2,60609,60611,121220,14,0.139601,0.167685,768,0,0
8573464,Hemmental Dorfplatz,,0.000027,66,1,1,2,5425,5425,10850,13,0.149457,0.198789,128.933333,0,0
8573461,Plattenhalde,,0.000022,66,1,1,2,24733,24733,49466,12,0.141475,0.166576,176,0,0
8573463,Hemmental Hochrahn,,0.000019,66,1,1,2,5425,5425,10850,14,0.132075,0.171103,102.933333,0,0
8573466,Gemsstübli,,0.00007,66,4,1,5,25303,25303,50606,13,0.148094,0.179476,1747.5,0,0
8579930,Weinberg,,0.000044,66,1,2,3,18803,18803,37606,9,0.241071,0.321443,404.5,0,0
8573473,Merishausen im Kerr,,0.000023,66,1,1,2,4907,4907,9814,16,0.103352,0.149176,69,0,0
8573474,Merishausen Gemeindehaus,,0.000031,66,1,1,2,4907,4907,9814,15,0.11215,0.159002,82,0,0
8573476,Merishausen Schlauch,,0.000037,66,1,1,2,4907,4907,9814,14,0.122807,0.171724,93,0,0
8573482,Stetten Braati,,0.000025,66,1,2,3,5891,5891,11782,5,0.319149,0.41,504,0,0
8573487,Opfertshofen Reiatstube,,0.000061,66,4,5,9,4019,4019,8038,5,0.478261,0.662121,474,0,0
8573495,Hofen Reiatschulhaus,,0.000055,66,3,3,6,4012,2920,6932,4,0.5,0.654762,40,0,0
8573483,Stetten Staaringelacker,,0.000022,66,1,1,2,5824,5824,11648,6,0.318182,0.383333,288,0,0
8573493,Thayngen Weierli,,0.000029,66,1,3,4,2707,4122,6829,3,0.529412,0.62963,24,0,0
8573494,Thayngen Hüttenleben,,0.000029,66,2,1,3,2530,2411,4941,5,0.363636,0.452083,0,0,0
8573488,"Schlatt TG, Gemeindehaus",,0.00002,66,1,1,2,3241,5109,8350,6,0.285714,0.408333,168,0,0
8573490,"Schlatt TG, Held",,0.000028,66,1,1,2,5109,5109,10218,5,0.333333,0.456667,145,0,0
8573491,"Schlatt TG, Bahnhof",,0.000034,66,1,1,2,5109,5109,10218,4,0.4,0.520833,120,0,0
8573492,Thayngen Bahnhof,,0.000021,66,1,1,2,2109,2707,4816,4,0.37037,0.433333,76,0,0
8594364,Thayngen Fallenwiese,,0.000066,66,3,2,5,2449,2411,4860,3,0.571429,0.708333,101.833333,0,0
8595427,Otteregass,,0.000078,66,3,1,4,5891,1208,7099,3,0.5,0.611111,79.5,0,0
8579931,Stetten Rietwis,,0.000056,66,4,2,6,5475,5326,10801,4,0.454545,0.616667,211.333333,0,0
8591863,Stetten Sonne,,0.000037,66,2,2,4,582,565,1147,4,0.454545,0.616667,56.333333,0,0
8573510,"Fehraltorf, Zelgli",,0.000029,84,1,1,2,3561,3562,7123,12,0.130178,0.1995,172,0,0
8573519,"Turbenthal, Bahnhof",,0.00005,84,1,3,4,6422,13272,19694,52,0.036912,0.048906,49199,0,0
8573548,"Bauma, Widen",,0.000041,84,1,1,2,5537,5531,11068,5,0.288889,0.344872,39,0,0
8573501,"Pfäffikon ZH, Im Spitz",,0.000021,84,1,1,2,9060,9057,18117,18,0.096018,0.108804,10735,0,0
8576095,"Uster, Stadtpark",,0.000021,84,1,1,2,15053,15005,30058,5,0.318182,0.42619,0,0,0
8587858,"Volketswil, Giessen",,0.000044,84,3,3,6,23021,23040,46061,5,0.365854,0.474444,382,0,0
8587859,"Uster, Loren",,0.000033,84,2,1,3,11425,11431,22856,5,0.304348,0.361905,0,0,0
8582659,"Pfäffikon ZH, Matten",,0.000035,84,1,1,2,9057,4529,13586,6,0.325,0.4,26,0,0
8583225,"Wermatswil, Stapferstrasse",,0.000034,84,2,2,4,5010,3674,8684,6,0.341463,0.442857,380,0,0
8583767,"Fehraltorf, Am Wildbach",,0.000038,84,2,1,3,2561,1159,3720,6,0.325,0.4,13,0,0
8587860,"Uster, Strick",,0.000061,84,3,2,5,40693,30955,71648,4,0.40625,0.487179,442.666667,0,0
8588050,"Uster, Bordacker",,0.000021,84,1,1,2,8622,9185,17807,6,0.325,0.4,0,0,0
8588051,"Uster, Dammstrasse",,0.00014,84,6,4,10,39714,33249,72963,5,0.444444,0.593056,885,0,0
8588056,"Uster, Talweg",,0.000041,84,1,2,3,9173,9185,18358,2,0.75,0.833333,29.333333,0,0
8588057,"Uster, Himmelriich",,0.000068,84,3,2,5,9020,9021,18041,1,1,1,121.333333,0,0
8573507,"Fehraltorf, Bahnhof",,0.00005,84,3,4,7,13380,13876,27256,12,0.179167,0.299578,2011.666667,0,0
8581564,"Fehraltorf, Undermüli",,0.000029,84,1,2,3,5288,5002,10290,7,0.272727,0.369524,15,0,0
8573508,"Fehraltorf, Halden",,0.000022,84,1,1,2,4782,4764,9546,11,0.137931,0.204509,1063.666667,0,0
8573509,"Fehraltorf, Sennerei",,0.000022,84,1,1,2,3562,3561,7123,13,0.119792,0.186469,229,0,0
8573511,"Russikon, Morgenthal",,0.000029,84,1,1,2,4764,4781,9545,10,0.152,0.218546,1003.666667,0,0
8573529,"Russikon, Tüfi",,0.000062,84,1,2,3,11090,11090,22180,10,0.15873,0.257619,723.333333,0,0
8573513,"Madetswil, Bläsimühle",,0.000021,84,1,1,2,6171,6171,12342,57,0.031253,0.037535,41664,0,0
8573514,Ehrikon,,0.000029,84,1,1,2,6171,6423,12594,56,0.03224,0.039106,43175,0,0
8573515,"Wildberg, Alte Post",,0.000035,84,1,1,2,6423,6420,12843,55,0.033292,0.040883,44684,0,0
8573517,"Turbenthal, Fridtal",,0.000041,84,1,1,2,6420,6420,12840,54,0.034416,0.042941,46191,0,0
8573518,"Turbenthal, Hutzikon",,0.000046,84,1,1,2,6420,6422,12842,53,0.03562,0.045439,47696,0,0
8573550,"Pfäffikon ZH, Hörnlistrasse",,0.000021,84,1,3,4,5815,5815,11630,12,0.188235,0.371034,464,0,0
8573520,"Turbenthal, Schloss",,0.000025,84,1,1,2,6011,6010,12021,51,0.037562,0.046514,50472,0,0
8573521,"Turbenthal, Kehlhof",,0.000032,84,1,1,2,6010,6011,12021,50,0.039002,0.049042,51933,0,0
8573522,"Turbenthal, Oberhofen",,0.000038,84,1,1,2,6011,6011,12022,49,0.040558,0.051952,53392,0,0
8573523,"Turbenthal, Neubrunn",,0.000043,84,1,1,2,6011,2922,8933,48,0.042244,0.05536,54849,0,0
8573524,"Turbenthal, Seelmatten",,0.000048,84,1,1,2,2922,2574,5496,47,0.044078,0.059441,56304,0,0
8573525,"Turbenthal,Strandbad Bichelsee",,0.000051,84,1,1,2,2574,2574,5148,46,0.046079,0.06449,57757,0,0
8573528,"Pfäffikon ZH, Sulzberg",,0.00006,84,3,1,4,11090,11090,22180,11,0.142857,0.21858,790.333333,0,0
8573530,"Russikon, Kirche",,0.000062,84,2,1,3,9700,9701,19401,9,0.169811,0.236706,1586,0,0
8573531,"Russikon, Platte",,0.000064,84,1,1,2,9701,9700,19401,8,0.193182,0.261975,1512,0,0
8573532,"Rumlikon, Stuketen",,0.000065,84,1,1,2,9700,5916,15616,7,0.225352,0.301786,1436,0,0
8573538,"Kollbrunn, Bahnhof",,0.000047,84,1,1,2,6040,6043,12083,2,0.666667,0.75,7,0,0
8575935,"Weisslingen, Lendikon",,0.000072,84,2,2,4,5030,4967,9997,1,1,1,35.5,0,0
8573535,"Weisslingen, Widum",,0.000031,84,1,1,2,6037,6038,12075,5,0.333333,0.456667,295,0,0
8573536,"Weisslingen, Mühle",,0.000037,84,1,1,2,6038,6043,12081,4,0.4,0.520833,201,0,0
8573537,"Kollbrunn, Weissenthal",,0.000042,84,1,1,2,6043,6040,12083,3,0.5,0.611111,105,0,0
8573540,"Pfäffikon ZH, Grundstrasse",,0.000021,84,1,1,2,4903,4897,9800,15,0.114206,0.153646,107,0,0
8573542,"Hittnau, Oberhittnau",,0.000041,84,2,1,3,5263,5261,10524,13,0.140288,0.183343,136,0,0
8573543,"Hittnau, Luppmen",,0.000046,84,1,1,2,5261,5265,10526,12,0.158996,0.208595,143,0,0
8573545,"Saland, Laubberg",,0.000021,84,1,1,2,5540,5540,11080,8,0.177778,0.244643,87,0,0
8573546,"Saland, Dorf",,0.000029,84,1,1,2,5540,5539,11079,7,0.202703,0.266825,73,0,0
8573547,"Saland, Dillhus",,0.000035,84,1,1,2,5539,5537,11076,6,0.237288,0.297619,57,0,0
8573549,"Vuarrengel, Orée du Bois",,0.000041,35,1,1,2,5481,5489,10970,18,0.11435,0.164938,433.5,0,0
8579734,"Suchy, village",,0.00003,35,1,1,2,2745,2745,5490,18,0.11435,0.164938,487.4,0,0
8573636,"Wila, Bahnhof",,0.000031,84,2,2,4,6653,6653,13306,11,0.197368,0.340214,420,0,0
8581691,"Schalchen, altes Schulhaus",,0.00003,84,2,1,3,5689,5685,11374,3,0.5,0.611111,21,0,0
8573553,"Horgen, Stocker",,0.000091,63,6,5,11,8057,8058,16115,20,0.099671,0.182884,5068.666667,0,0
8573554,"Horgen Oberdorf, Bahnhof",,0.000026,63,1,1,2,3462,3462,6924,20,0.091743,0.129137,0,0,0
8588987,"Horgen, Schnegg",,0.000065,63,2,4,6,5276,3601,8877,10,0.208054,0.352176,246.333333,0,0
8573557,"Horgen, Fischenrüti",,0.000032,63,1,2,3,1788,1752,3540,17,0.101828,0.149595,3275.666667,0,0
8581674,"Horgenberg, Widenbach",,0.000069,63,5,4,9,1715,1189,2904,10,0.225,0.339647,1735.22381,0,0
8588508,"Hütten, Schulhaus",,0.000057,63,4,5,9,7703,7697,15400,10,0.226804,0.356836,358.75,0,0
8589110,"Horgen, Widmerheim",,0.000049,63,1,2,3,2492,2422,4914,9,0.21374,0.311678,56,0,0
8589111,"Horgen, Gumelenstrasse",,0.000099,63,6,5,11,4092,3286,7378,9,0.225,0.386802,1877.5,0,0
8573555,"Horgen, Bergli",,0.000049,63,2,3,5,5216,5214,10430,19,0.100168,0.154484,4133.5,0,0
8577912,"Horgen, untere Mühle",,0.000027,63,2,2,4,3176,3176,6352,13,0.159875,0.22963,146.5,0,0
8588416,"Horgen, Bocken",,0.000036,63,2,2,4,3563,3563,7126,12,0.16835,0.237255,852.666667,0,0
8573556,"Horgen, Ebnetstrasse",,0.000025,63,1,1,2,1787,1788,3575,18,0.093133,0.126565,3216.666667,0,0
8573558,"Horgenberg, Hinterklausen",,0.000024,63,1,1,2,1717,1719,3436,16,0.094694,0.113024,3226,0,0
8573559,"Horgenberg, Vorderklausen",,0.000032,63,1,1,2,1719,1717,3436,15,0.103697,0.12329,3281,0,0
8573560,"Hirzel, Neuhaus",,0.000038,63,1,1,2,1717,1719,3436,14,0.114688,0.136568,3334,0,0
8573561,"Hirzel, Strickler",,0.000043,63,1,1,2,1719,1717,3436,13,0.128409,0.154599,3385,0,0
8573579,"Schönenberg ZH, Sonne",,0.00004,63,3,3,6,8296,8297,16593,13,0.158317,0.231979,1137.72619,0,0
8579182,"Hütten, Friedhof",,0.00003,63,1,4,5,7700,7700,15400,12,0.167391,0.2484,77,0,0
8581417,"Wädenswil, Campus Grüental",,0.000035,63,3,3,6,12239,12238,24477,12,0.165577,0.23851,729.642857,0,0
8573566,"Schönenberg ZH, Aesch",,0.000031,63,1,1,2,805,805,1610,15,0.139045,0.180659,2214.6,0,0
8573578,"Wädenswil, Mühlebach",,0.000023,63,1,3,4,19840,19840,39680,13,0.150094,0.221217,163.271429,0,0
8573571,"Wädenswil, Oedischwend",,0.000028,63,1,1,2,1790,1790,3580,15,0.134094,0.16778,76,0,0
8573574,"Wädenswil, Gulmenmatt",,0.000053,63,5,1,6,17162,17258,34420,17,0.115482,0.161757,345.266667,0,0
8573584,"Wädenswil, Schluchtal",,0.000047,63,1,2,3,1791,1791,3582,12,0.168565,0.238134,251,0,0
8590853,"Wädenswil, Baumgarten",,0.000059,63,3,2,5,12967,12965,25932,6,0.304348,0.388095,403.5,0,0
8590854,"Wädenswil, Boller",,0.000025,63,2,2,4,3920,3920,7840,6,0.333333,0.415873,201.533333,0,0
8590855,"Wädenswil, Büelen",,0.000029,63,1,1,2,3280,3281,6561,6,0.287671,0.35,11,0,0
8590861,"Wädenswil, Glärnisch",,0.000092,63,5,3,8,23914,13029,36943,4,0.454545,0.575,623.166667,0,0
8573580,"Schönenberg ZH, Wolfbühl",,0.000022,63,1,1,2,7702,7700,15402,13,0.144981,0.192488,85,0,0
8573581,"Wädenswil, Burstel",,0.000031,63,2,1,3,1791,1791,3582,15,0.115442,0.14488,278,0,0
8573582,"Wädenswil, Chotten",,0.000037,63,1,1,2,1791,1791,3582,14,0.128814,0.163138,271,0,0
8573583,"Wädenswil, Mugern",,0.000042,63,1,1,2,1791,1791,3582,13,0.145914,0.190314,262,0,0
8581572,"Wädenswil, Rötiboden",,0.000027,63,2,1,3,12008,12008,24016,12,0.157447,0.201905,672.666667,0,0
8573589,"Goldingen, Baumgarten",,0.000045,67,2,1,3,5903,5903,11806,48,0.036588,0.047763,37,0,0
8573591,"Goldingen, Unterdorf",,0.000066,67,2,1,3,6240,6515,12755,46,0.039407,0.054059,2441,0,0
8573592,"Goldingen, Riedern",,0.000067,67,1,1,2,6515,6515,13030,45,0.040989,0.058224,3566,0,0
8573593,"Neuhaus SG, Schwärzi",,0.000068,67,1,1,2,6515,6515,13030,44,0.042704,0.063495,4689,0,0
8573597,"Eschenbach SG, Twirren",,0.00003,67,1,1,2,32037,32037,64074,43,0.044502,0.070521,2235.714286,0,0
8573848,"Ernetschwil, Häblingen",,0.000047,67,2,2,4,1159,1156,2315,42,0.046235,0.07544,19455.547619,0,0
8573600,"Wald ZH, Abzweigung Oberholz",,0.000017,67,1,1,2,856,841,1697,3,0.5,0.611111,84,0,0
8573601,"Cresmino, Case",,0.000035,101,1,1,2,5370,5370,10740,33,0.085166,0.107685,1464,0,0
8573603,"Wil SG, Rose",,0.000028,20,1,3,4,62248,62248,124496,37,0.059745,0.083056,628,0,0
8573604,"Wil SG, Kapuziner Kloster",,0.000019,20,1,2,3,33540,33540,67080,37,0.059667,0.081782,0,0,0
8573605,"Rossrüti, Furtbach",,0.000027,20,2,2,4,34239,27178,61417,37,0.059599,0.081432,318,0,0
8573612,"Weinfelden, Thurland",,0.00003,20,1,1,2,3373,3373,6746,37,0.059448,0.079567,717,0,0
8573618,"Wil SG, Letten",,0.000027,20,1,3,4,43985,43527,87512,27,0.06496,0.102826,959,0,0
8573912,"Wil SG, Friedberg",,0.000027,20,1,1,2,91,91,182,34,0.063734,0.072139,3982,0,0
8574042,"Neu St. Johann, Klosterkirche",,0.000081,73,3,6,9,11003,10658,21661,29,0.096341,0.167927,36202.6,0,0
8578516,"Kirchberg SG, Strick",,0.000049,20,1,1,2,16618,17151,33769,24,0.07279,0.127544,168,0,0
8578595,"Fischingen, Kloster",,0.000045,20,2,2,4,12639,12639,25278,18,0.101633,0.168891,777.5,0,0
8578597,"Wil SG, Psychiatrie",,0.000051,20,1,2,3,12639,12639,25278,16,0.114407,0.18027,102,0,0
8578609,"Fischingen, Grüner Baum",,0.000072,20,1,2,3,12639,12639,25278,16,0.101538,0.185488,206,0,0
8578794,"Busswil TG, Kreuzstrasse",,0.000092,20,2,2,4,29137,29137,58274,11,0.151685,0.22975,864,0,0
8578795,"Wil SG, STIHL",,0.000067,20,2,1,3,27311,27311,54622,10,0.165563,0.221095,691,0,0
8573608,"Schönholzerswilen, Wartenwil",,0.000022,20,1,1,2,3373,3373,6746,38,0.056186,0.071431,160,0,0
8578823,"Wilen bei Wil, Lerchenfeld",,0.000034,20,1,1,2,27650,27650,55300,11,0.146893,0.200125,52,0,0
8582599,"Bussnang, Alterszentrum",,0.000029,20,1,1,2,1923,1868,3791,16,0.097122,0.157496,284,0,0
8582809,"Schönholzerswilen, Häusern",,0.000062,20,1,1,2,3373,3373,6746,9,0.181818,0.24629,158,0,0
8578826,"Wil SG, Bahnhof Süd",,0.000126,20,2,2,4,55626,40705,96331,8,0.22549,0.31501,1438,0,0
8573617,"Wil SG, Kreuzackerstrasse",,0.000019,20,1,1,2,43985,43985,87970,28,0.061187,0.088126,820,0,0
8573925,"Wil SG, Rössli",,0.000036,20,2,2,4,65821,65835,131656,26,0.066959,0.099908,10457,0,0
8573619,"Bronschhofen, Gemeindehaus",,0.000036,20,2,3,5,29359,29817,59176,8,0.291667,0.456037,2278,0,0
8589071,"Braunau, Ebnet",,0.000021,20,1,1,2,6355,6355,12710,3,0.5,0.583333,0,0,0
8591680,"Wil SG, Altgruben",,0.000045,20,1,2,3,14183,13944,28127,3,0.555556,0.666667,181.5,0,0
8591681,"Wil SG, Gruben",,0.000052,20,1,2,3,14199,14199,28398,3,0.555556,0.666667,283.5,0,0
8591683,"Wil SG, Flurhof",,0.000052,20,2,1,3,27417,27417,54834,3,0.5,0.583333,0,0,0
8573622,"Tobel-Affeltrangen, Bahnhof",,0.000048,65,1,1,2,6112,6112,12224,12,0.153846,0.258601,2040,0,0
8573623,"Lommis, Matzingerstrasse",,0.000052,65,1,1,2,6112,6112,12224,11,0.166667,0.274534,1881,0,0
8573624,"Weingarten, Brücke",,0.000055,65,1,1,2,6112,5832,11944,10,0.181818,0.292897,1720,0,0
8573625,"Weingarten-Kalthäusern,Dorfstr",,0.000058,65,1,1,2,5832,6112,11944,9,0.2,0.31433,1557,0,0
8573626,"Kalthäusern, Dorf",,0.00006,65,1,1,2,6112,6112,12224,8,0.222222,0.339732,1392,0,0
8573627,"Stettfurt, Lettenstrasse",,0.000062,65,1,1,2,6112,6112,12224,7,0.25,0.370408,1225,0,0
8573628,"Stettfurt, Dorfzentrum",,0.000063,65,1,1,2,6112,6112,12224,6,0.285714,0.408333,1056,0,0
8573637,"Turbenthal, Tablat",,0.000024,84,1,1,2,1090,1090,2180,10,0.181818,0.292897,370,0,0
8573638,"Wila, Talgarten",,0.000031,84,1,1,2,1090,1090,2180,9,0.2,0.31433,342,0,0
8573639,"Turbenthal, Gosswil",,0.000038,84,1,1,2,1090,1090,2180,8,0.222222,0.339732,312,0,0
8573640,"Turbenthal, Abzw. Auli",,0.000043,84,1,1,2,1090,1090,2180,7,0.25,0.370408,280,0,0
8573644,"Turbenthal, Kellersacker",,0.000047,84,1,1,2,1090,1090,2180,6,0.285714,0.408333,246,0,0
8573645,"Turbenthal, Freckmünd",,0.000051,84,1,1,2,1090,1090,2180,5,0.333333,0.456667,210,0,0
8573646,"Schmidrüti, Dorf",,0.000054,84,1,1,2,1090,1088,2178,4,0.4,0.520833,172,0,0
8573647,"Schmidrüti, Buchenenstock",,0.000057,84,1,1,2,1088,1090,2178,3,0.5,0.611111,132,0,0
8573648,"Sitzberg, Sternen",,0.000059,84,1,1,2,1090,1090,2180,2,0.666667,0.75,90,0,0
8573653,"La Comballaz, L'Ortier",,0.000115,36,2,1,3,831,831,1662,1,1,1,35,0,0
8579712,"Schlatt ZH, Berg b.Waltenstein",,0.000023,68,2,1,3,4125,4116,8241,14,0.121622,0.201695,0,0,0
8580258,"Elsau, Dorf",,0.000053,68,1,1,2,12168,12166,24334,11,0.154639,0.23696,63,0,0
8580259,"Elsau, Sportplatz",,0.000057,68,2,1,3,12339,12337,24676,10,0.170732,0.253543,71,0,0
8573660,"Winterthur, Schützenbühl",,0.000018,68,1,1,2,4158,4158,8316,9,0.180723,0.252725,74.5,0,0
8573661,"Winterthur, Ziegelhütte",,0.000026,68,1,1,2,4158,4158,8316,8,0.205882,0.276276,77.5,0,0
8573662,"Winterthur, Gotzenwil",,0.000033,68,1,1,2,4158,4158,8316,7,0.240741,0.309707,78.5,0,0
8573663,"Winterthur, Taa",,0.000039,68,1,1,2,4158,4242,8400,6,0.292683,0.363889,77.5,0,0
8573664,"Winterthur, Klösterli Iberg",,0.000044,68,1,2,3,4242,4242,8484,5,0.37931,0.480303,74.5,0,0
8573666,"Winterthur, Eidberg",,0.000036,68,1,1,2,2142,2058,4200,5,0.346154,0.42037,9,0,0
8590984,"Winterthur, Pflanzschulstrasse",,0.000077,68,2,2,4,11898,11891,23789,4,0.428571,0.527778,1302.1,0,0
8573665,"Winterthur, Binzenloo",,0.00003,68,1,1,2,2142,2142,4284,6,0.277778,0.353333,16,0,0
8573667,"Schlatt ZH, Waltenstein",,0.000013,68,1,1,2,9240,9206,18446,10,0.182609,0.264267,73,0,0
8573671,"Winterthur, Tellstrasse",,0.000055,68,6,2,8,22544,22518,45062,17,0.126126,0.17111,765.778571,0,0
8580461,"Winterthur, Fotozentrum",,0.000051,68,2,1,3,14340,14177,28517,7,0.270833,0.359707,81.466667,0,0
8581532,"Hettlingen, Bahnhof",,0.000063,68,2,3,5,7720,7709,15429,7,0.32,0.464137,108.778571,0,0
8581537,"Dägerlen, Berg",,0.000049,68,1,1,2,6017,232,6249,7,0.270833,0.359707,1172.790476,0,0
8583360,"Flaach, Kirche",,0.000048,68,1,3,4,5193,5077,10270,7,0.304348,0.459014,137.028571,0,0
8573674,"Winterthur, Lindenplatz",,0.000044,68,2,2,4,20788,20781,41569,17,0.132983,0.181995,587.5,0,0
8573676,"Neftenbach, Wolfzangen",,0.00003,68,1,3,4,7787,7825,15612,16,0.128893,0.176133,629.5,0,0
8573684,"Buch am Irchel, Oberbuch",,0.000047,68,1,1,2,4266,4263,8529,16,0.115348,0.148651,451,0,0
8573677,"Neftenbach, Herrgass",,0.000019,68,1,1,2,3440,3439,6879,18,0.115,0.149361,179.833333,0,0
8581701,"Winterthur, Rosenberg",,0.000032,68,1,3,4,15494,15507,31001,13,0.16129,0.26382,2382.833333,0,0
8573680,Aesch (Neftenbach),,0.000047,68,3,2,5,7722,7712,15434,14,0.142857,0.202454,2184.540476,0,0
8573695,"Unterohringen, Wisental",,0.000023,68,2,1,3,11579,11585,23164,14,0.13912,0.192711,435.366667,0,0
8573681,Hünikon (Neftenbach),,0.000031,68,1,1,2,4260,4233,8493,19,0.087447,0.107982,211,0,0
8573682,"Buch am Irchel, Desibach",,0.000037,68,1,1,2,4233,4260,8493,18,0.095054,0.117781,293,0,0
8573683,"Buch am Irchel, Sägerei",,0.000043,68,1,1,2,4260,4266,8526,17,0.104184,0.13064,373,0,0
8573685,"Buch am Irchel, Unterbuch",,0.000059,68,2,2,4,5191,5134,10325,15,0.12931,0.17759,961.333333,0,0
8573687,Gräslikon,,0.000042,68,1,1,2,5075,5118,10193,15,0.127568,0.167888,118,0,0
8573686,"Buch am Irchel, Wiler",,0.000036,68,1,1,2,5109,5075,10184,16,0.113985,0.144146,46,0,0
8574474,"Dinhard, Grüt",,0.00003,68,1,1,2,3845,3859,7704,14,0.1375,0.182834,204.333333,0,0
8576147,"Pfungen, Bahnhof",,0.000053,107,2,2,4,10739,11061,21800,14,0.14032,0.197193,2854,0.000004,0
8573692,"Winterthur, Bachtelstrasse",,0.000018,68,1,1,2,11879,11873,23752,17,0.120328,0.153618,22,0,0
8576297,"Seuzach, Bahnhof",,0.000076,68,4,3,7,10247,10249,20496,13,0.15735,0.230478,3618.466667,0,0
8580472,"Winterthur, Schmidgasse",,0.000054,68,5,1,6,31978,31976,63954,13,0.146341,0.196315,3302.633333,0,0
8581527,"Hünikon (Neftenbach), Vontobel",,0.00005,68,2,1,3,4187,4264,8451,8,0.253731,0.334944,44.361905,0,0
8573698,Rutschwil,,0.000021,68,1,1,2,6027,6017,12044,16,0.110993,0.141502,108,0,0
8580521,"Winterthur, Stadthaus",,0.000101,68,4,4,8,39988,38589,78577,12,0.168831,0.254471,7852.166667,0,0
8573703,"Flaach, Oberdorf",,0.000094,68,4,5,9,10237,10231,20468,12,0.161512,0.272325,1874.92381,0,0
8580691,"Buch am Irchel, Irchelhof",,0.000027,68,1,1,2,4239,4162,8401,9,0.211765,0.278924,0,0,0
8580290,"Buchberg, Kirche",,0.000051,68,2,1,3,9340,4109,13449,9,0.210526,0.292956,112,0,0
8581535,"Flaach, Unterdorf",,0.000088,68,3,2,5,9294,9194,18488,8,0.25,0.368492,209.028571,0,0
8573706,"Rüdlingen, Brückenwaage",,0.000039,68,2,1,3,4681,4677,9358,12,0.149466,0.18925,1505,0,0
8580289,"Buchberg, Engel",,0.000021,68,1,1,2,4683,4679,9362,10,0.182796,0.256279,34,0,0
8587349,"Zürich, Bahnhofquai/HB",,0.000047,85,7,13,20,285831,286907,572738,16,0.216011,0.2746,10856.924599,0.136844,1.412549
8591083,"Zürich, Grubenstrasse",,0.00002,85,1,1,2,20431,20445,40876,10,0.16763,0.183363,0,0.017263,0.002685
8591168,"Zürich, Guggachstrasse",,0.000082,85,4,5,9,102569,102581,205150,9,0.241667,0.277398,4037.394528,0.01136,0.162316
8591181,"Zürich, Heerenwiesen",,0.000028,85,2,2,4,53391,53434,106825,8,0.202742,0.223298,446.749189,0.012502,0.047114
8573716,"Stallikon, Tägerst",,0.000025,85,1,2,3,3907,3902,7809,21,0.109888,0.125721,324.366667,0.000243,0.000134
8573717,"Aeugstertal, Landhus",,0.000021,85,1,1,2,1930,1916,3846,21,0.109754,0.12452,0,0.000003,0.000131
8573720,"Arni AG, Stockacker",,0.000051,85,5,2,7,16223,16677,32900,21,0.111943,0.127532,6285.560317,0.006933,0
8573721,"Oberlunkhofen, Waldegg",,0.000033,85,1,1,2,14948,14979,29927,20,0.119765,0.13436,4930.694601,0,0
8583071,"Jonen, Radmühle",,0.000075,85,4,2,6,12149,3165,15314,18,0.116215,0.137695,3714.910962,0.02183,0.021285
8573730,"Bonstetten, Lärchenhof",,0.000046,85,3,2,5,2170,2127,4297,20,0.127775,0.152112,155.154493,0.002529,0.005759
8579497,"Wettswil a.A., Langächer",,0.000062,85,1,1,2,1624,1624,3248,19,0.13486,0.158413,6309,0,0.000064
8581666,"Bonstetten, Lätten",,0.000028,85,1,2,3,1813,1813,3626,11,0.169706,0.182507,336,0.000216,0.005525
8582723,"Affoltern a.A., Blitzgbach",,0.000042,85,1,1,2,2899,2894,5793,11,0.169285,0.180059,668,0,0.00082
8583206,"Islisberg, Räbacher",,0.000023,85,1,1,2,1729,1729,3458,11,0.169285,0.180059,0,0.000128,0.005397
8573733,"Aeugst am Albis, Höchweg",,0.000051,115,1,3,4,5135,5123,10258,19,0.133777,0.156303,2024.30873,0,0.000533
8574684,"Uitikon, Halde",,0.000041,85,1,1,2,2759,2768,5527,19,0.131209,0.14954,2100,0,0.000507
8579991,"Bonstetten, Sunnenberg",,0.000027,85,1,1,2,660,660,1320,9,0.173432,0.195681,0,0.000483,0.015156
8573732,"Aeugst am Albis, Müliberg",,0.000047,115,3,1,4,5138,5135,10273,20,0.118141,0.133227,1660.30873,0.004757,0
8580268,"Affoltern a.A., Bezirksspital",,0.000032,115,1,2,3,3164,3164,6328,9,0.172542,0.197785,434,0,0.000002
8581059,"Stallikon, Loomatt",,0.00006,85,3,3,6,5938,5903,11841,8,0.207589,0.2431,2106.541239,0.015156,0.000031
8582763,"Affoltern a.A., Weinberg",,0.000025,115,1,1,2,1626,1626,3252,9,0.171004,0.189066,0,0,0.000002
8573734,"Affoltern a.A., Lilienberg",,0.000025,115,1,1,2,3164,3164,6328,10,0.148499,0.167545,682,0.000012,0
8573736,Schifflände,,0.000058,66,4,2,6,31802,31801,63603,13,0.157191,0.233943,1118.5,0,0
8573738,Rheinbühl,,0.000026,66,1,1,2,6820,6820,13640,5,0.288462,0.345556,321,0,0
8573739,Rheinhalde Grenze,,0.000033,66,1,2,3,6820,6820,13640,4,0.378378,0.458333,278,0,0
8573748,Dörflingen Laag,,0.000024,66,1,1,2,960,700,1660,2,0.571429,0.625,5.166667,0,0
8589950,Dörflingen Neuhus,,0.000043,66,2,1,3,5220,5220,10440,2,0.571429,0.625,17.5,0,0
8592571,Rebhangstrasse,,0.000038,66,1,1,2,5823,5823,11646,2,0.571429,0.625,4,0,0
8578399,"Stein am Rhein, Strandbad",,0.000043,65,1,3,4,13326,13326,26652,2,0.8,0.875,248,0,0
8578401,"Ramsen, Zoll",,0.000023,65,1,1,2,5156,5156,10312,2,0.666667,0.75,0,0,0
8592238,"Stein am Rhein, Schule",,0.000023,65,1,1,2,6697,6697,13394,2,0.666667,0.75,0,0,0
8592573,Rosentalgässchen,,0.000121,66,4,3,7,12643,11043,23686,1,1,1,249.333333,0,0
8573765,"Einsiedeln, Wissmüli",,0.000032,69,2,1,3,3771,4341,8112,20,0.093722,0.126098,79.666667,0,0
8573771,"Einsiedeln, Klosterplatz",,0.000022,69,1,2,3,16292,16201,32493,8,0.251534,0.32529,0,0,0
8573779,"Oberiberg, Oberjessenen",,0.00004,69,2,2,4,7282,7380,14662,7,0.277778,0.361048,37.84127,0,0
8573788,"Unteriberg, Twingi",,0.000048,69,1,1,2,1902,1749,3651,7,0.274725,0.341048,50,0,0
8573792,"Egg SZ, Eintracht",,0.000069,69,4,2,6,5957,2445,8402,5,0.391304,0.512963,203.361111,0,0
8573793,"Willerzell, Birchbühl",,0.00004,69,1,2,3,2085,2678,4763,5,0.4,0.535417,11.611111,0,0
8580858,"Einsiedeln, Birchli/Garage",,0.000106,69,4,2,6,10438,10822,21260,5,0.388889,0.540476,125.166667,0,0
8581977,"Einsiedeln, Eschbach",,0.000073,69,2,1,3,6893,1562,8455,3,0.5,0.583333,140,0,0
8573766,"Einsiedeln, Steig",,0.000049,69,2,3,5,7037,6470,13507,19,0.10241,0.14879,1652.154762,0,0
8580524,"Einsiedeln, Heidenbühl",,0.000057,69,3,1,4,3712,4197,7909,4,0.384615,0.483333,160.25,0,0
8573767,"Bennau, Kirche",,0.000025,91,1,1,2,2212,2212,4424,18,0.109426,0.137064,1663,0,0
8573769,"Bennau, Schwyzerbrugg",,0.000051,91,3,1,4,9251,9267,18518,16,0.137119,0.183174,2264.813492,0,0
8577483,"Sattel, Talstation",,0.000065,91,1,2,3,16269,16269,32538,6,0.322581,0.453333,2818,0,0
8577485,"Sattel-Aegeri, Bahnhof",,0.000039,91,1,1,2,6788,3510,10298,6,0.3,0.392593,0,0,0
8573773,"Gross, Nügüetli",,0.00002,69,1,1,2,9516,9134,18650,12,0.137809,0.178605,34,0,0
8573775,"Euthal, Drusberg",,0.000056,69,3,2,5,13851,13851,27702,10,0.179612,0.242214,380,0,0
8573776,"Unteriberg, vord.Schmalzgruben",,0.000035,69,1,1,2,9518,9518,19036,9,0.194969,0.238953,212.5,0,0
8573777,"Unteriberg, hint.Schmalzgruben",,0.00004,69,1,1,2,9518,9164,18682,8,0.234375,0.288452,205.5,0,0
8573780,"Willerzell, Tschuppmoos",,0.000035,69,1,1,2,4333,4333,8666,10,0.16763,0.213054,130.5,0,0
8573781,"Willerzell, Langen",,0.00004,69,1,1,2,4333,4333,8666,9,0.194444,0.243126,121.5,0,0
8573782,"Willerzell, Erlen",,0.000045,69,1,1,2,4333,4333,8666,8,0.232759,0.292725,110.5,0,0
8573785,"Unteriberg, Herti",,0.000039,69,2,1,3,1902,1902,3804,9,0.1875,0.232995,80,0,0
8573787,"Unteriberg, Boden",,0.000044,69,1,1,2,1902,1902,3804,8,0.222222,0.271932,66,0,0
8577050,"Gross, Rombüel",,0.000049,69,2,1,3,9518,9134,18652,6,0.307692,0.410417,4.111111,0,0
8573790,"Horgenberg b. Einsied., Grütli",,0.000032,69,1,2,3,7105,7105,14210,7,0.277778,0.380635,330,0,0
8573822,"Tuggen, Obstlager",,0.000042,67,1,3,4,8818,8818,17636,18,0.125551,0.160721,2404,0,0
8573834,"Siebnen, Schorrenstrasse",,0.00006,67,1,2,3,6089,6089,12178,20,0.100671,0.12906,2145,0,0
8574431,"Wangen SZ, Gätzibach",,0.000036,67,1,1,2,7246,7612,14858,20,0.100365,0.123201,0,0,0
8573796,"Vorderthal, Gfell",,0.000035,67,1,1,2,4412,4412,8824,3,0.5,0.611111,90,0,0
8573797,"Vorderthal, Schweizerhof",,0.00004,67,1,1,2,4412,4412,8824,2,0.666667,0.75,62,0,0
8573798,"Vorderthal, Bächweidstrasse",,0.000045,67,1,1,2,4412,4205,8617,1,1,1,32,0,0
8573800,"Pfäffikon SZ, Bahnhof",,0.000053,113,3,6,9,43856,66825,110681,30,0.063278,0.118071,2863,0,0
8576124,"Samstagern, Drei Eichen",,0.000071,113,1,1,2,8102,8096,16198,18,0.113433,0.166903,533,0,0
8577519,"Wollerau, Oswäldli",,0.000116,113,1,3,4,26462,26462,52924,15,0.15625,0.277279,1070,0,0
8577525,"Wollerau, Roos",,0.000058,113,1,1,2,18175,18175,36350,15,0.14218,0.225159,120,0,0
8581264,"Wollerau, Wächlen",,0.000101,113,3,3,6,31238,30764,62002,14,0.160221,0.292119,1072,0,0
8573802,"Pfäffikon SZ, Driesbüel",,0.000018,113,1,1,2,9723,9723,19446,15,0.113095,0.192586,627,0,0
8573803,"Pfäffikon SZ, Buchberg",,0.000027,113,1,1,2,9723,9723,19446,14,0.120805,0.20139,612,0,0
8573804,"Pfäffikon SZ, Wannenweid",,0.000033,113,1,1,2,9723,9723,19446,13,0.129771,0.211363,595,0,0
8573805,"Pfäffikon SZ, Luegeten",,0.000039,113,1,1,2,9723,9723,19446,12,0.140351,0.222845,576,0,0
8573806,"Pfäffikon SZ, Abzw. Etzelpass",,0.000044,113,1,1,2,9723,9250,18973,11,0.153061,0.236354,555,0,0
8573807,"Feusisberg, Riedhof",,0.000049,113,1,1,2,9250,9723,18973,10,0.168675,0.252749,532,0,0
8573808,"Feusisberg, Ried",,0.000052,113,1,1,2,9723,9723,19446,9,0.188406,0.273596,507,0,0
8573809,"Feusisberg, Feld",,0.000055,113,1,1,2,9723,9247,18970,8,0.214286,0.302183,480,0,0
8573810,"Feusisberg, Hotel Panorama",,0.000058,113,1,1,2,9247,9247,18494,7,0.25,0.347186,451,0,0
8573811,"Feusisberg, Kreuzstrasse",,0.00006,113,1,2,3,9247,9247,18494,6,0.30303,0.445,420,0,0
8573819,"Schindellegi-Feusisberg, Bhf.",,0.000062,113,2,1,3,9330,9571,18901,3,0.5,0.611111,18,0,0
8573812,"Schindellegi, Pauli",,0.000036,113,1,1,2,9095,9330,18425,8,0.219512,0.324206,258,0,0
8573813,"Schindellegi, Sihlegg",,0.000042,113,1,1,2,9330,9330,18660,7,0.25,0.355357,223,0,0
8573814,"Schindellegi, Schwandweg",,0.000046,113,1,1,2,9330,9330,18660,6,0.291667,0.397619,186,0,0
8573815,"Schindellegi, Aesch",,0.00005,113,1,1,2,9330,9330,18660,5,0.352941,0.463889,147,0,0
8573816,"Schindellegi, Sunnestrahl",,0.000054,113,1,2,3,9330,9330,18660,4,0.454545,0.616667,106,0,0
8573818,"Schindellegi, Kirche",,0.000034,113,1,1,2,4808,4808,9616,4,0.4,0.520833,0,0,0
8573821,"Tuggen, Egg",,0.000036,67,1,1,2,8818,8818,17636,19,0.112125,0.135481,2262,0,0
8573841,"Buttikon SZ, Oberstufenschule",,0.000063,67,1,3,4,10240,10240,20480,18,0.12481,0.161147,984,0,0
8574432,"Wangen SZ, Höfli",,0.000092,67,3,3,6,13885,13943,27828,19,0.110886,0.144928,4899,0,0
8574433,"Wangen SZ, Zentrum",,0.000067,67,3,3,6,11295,11295,22590,18,0.123112,0.158121,4778,0,0
8573823,"Pfäffikon SZ, Huob",,0.000018,113,1,1,2,6089,5937,12026,29,0.054907,0.06813,957,0,0
8573824,"Pfäffikon SZ, Schweizerhof",,0.000027,113,1,1,2,5937,5937,11874,28,0.057763,0.071051,1097,0,0
8573825,"Altendorf, Letzi",,0.000033,113,1,1,2,5937,6089,12026,27,0.06095,0.074367,1235,0,0
8573826,"Altendorf, Bahnhof",,0.000039,113,1,1,2,6089,5881,11970,26,0.064528,0.078172,1371,0,0
8573827,"Altendorf, Stoglen",,0.000044,67,1,1,2,5881,5937,11818,25,0.068576,0.082595,1505,0,0
8573828,"Altendorf, Bitzi",,0.000049,67,1,1,2,5937,6089,12026,24,0.073192,0.087826,1637,0,0
8573829,"Lachen SZ, Kirche",,0.000052,67,1,1,2,6089,6089,12178,23,0.078505,0.094154,1767,0,0
8573832,"Lachen SZ, Spital",,0.000055,67,1,1,2,6089,5937,12026,22,0.084686,0.102083,1895,0,0
8573833,"Galgenen, Diga",,0.000058,67,1,1,2,5937,6089,12026,21,0.091967,0.11265,2021,0,0
8573835,"Siebnen, Neudörfli",,0.000048,67,2,1,3,10240,10240,20480,24,0.073307,0.086899,186,0,0
8573836,"Siebnen, Bettnau",,0.000052,67,1,1,2,10240,10240,20480,23,0.078641,0.09278,324,0,0
8573837,"Schübelbach, Oberhöfli",,0.000055,67,1,1,2,10240,9764,20004,22,0.084848,0.099884,460,0,0
8573838,"Schübelbach, West",,0.000057,67,1,1,2,9764,9764,19528,21,0.092163,0.108692,594,0,0
8573839,"Schübelbach, Gramatt",,0.00006,67,1,1,2,9764,10240,20004,20,0.100912,0.120044,726,0,0
8573840,"Buttikon SZ, Mühlemoos",,0.000062,67,1,1,2,10240,10240,20480,19,0.111562,0.135692,856,0,0
8573842,"Uznach, St. Otmarsberg",,0.00002,67,1,1,2,5305,3690,8995,45,0.041016,0.059021,1013,0,0
8573844,"Ernetschwil, Dorf",,0.00007,67,4,3,7,4924,6538,11462,43,0.044603,0.073126,17943.707143,0,0
8574444,"Uetliburg SG, Berg-Sion-Str.",,0.000029,67,1,1,2,5755,5712,11467,16,0.15468,0.184199,57,0,0
8573845,"Ernetschwil, Hinterernetschwil",,0.000031,67,1,1,2,5704,5704,11408,44,0.042436,0.0615,51,0,0
8574440,"Uznach, Tor",,0.000121,67,5,3,8,19169,20627,39796,15,0.185057,0.238753,2782.447619,0,0
8574441,"Uznach, Speerblick",,0.000045,67,1,1,2,5892,5891,11783,16,0.15625,0.187516,0,0,0
8573852,"Uznach, Kreuzkirche",,0.000059,67,3,1,4,16951,16950,33901,49,0.036096,0.054794,413,0,0
8573853,"Uznach, Burgerfeld",,0.000061,67,1,1,2,16950,16951,33901,48,0.037415,0.060562,1509,0,0
8573854,"Uznach, St. Josef",,0.000063,67,1,3,4,16951,16951,33902,47,0.038836,0.069494,2603,0,0
8573879,"Benken SG, Zentrum",,0.000087,67,2,2,4,8323,10028,18351,15,0.183082,0.232211,2276,0,0
8574436,"Tuggen, Kapellhof",,0.000063,67,1,1,2,8412,8412,16824,15,0.180863,0.224877,8580,0,0
8574442,"Gommiswald, Gauenhof",,0.000112,67,4,3,7,12388,12769,25157,15,0.184028,0.237039,617.95,0,0
8574443,"Gommiswald, Breiten",,0.000043,67,1,2,3,7037,7065,14102,15,0.183082,0.232211,135,0,0
8574445,"Uetliburg SG, Brunnacker",,0.000055,67,2,2,4,5786,5834,11620,15,0.181818,0.229846,1890.492857,0,0
8573855,"Schmerikon, Brücke",,0.000029,67,1,1,2,6300,6300,12600,46,0.039126,0.053187,3176,0,0
8573856,"Schmerikon, Mürtschenstrasse",,0.000035,67,1,1,2,6300,6300,12600,45,0.040684,0.057141,4266,0,0
8573857,"Schmerikon, Lanzenmoosstrasse",,0.000041,67,1,1,2,6300,6300,12600,44,0.042372,0.06209,5354,0,0
8573858,"Schmerikon, Bahnhof",,0.000046,67,1,1,2,6300,6300,12600,43,0.044209,0.068603,6440,0,0
8573878,"Benken SG, Starrberg",,0.000077,67,1,1,2,5292,5292,10584,16,0.155577,0.185551,1932,0,0
8578538,"Eschenbach SG, Säge",,0.000048,67,1,2,3,22451,20007,42458,5,0.357143,0.47,831,0,0
8573861,"Uznach, Rotfarb",,0.000039,67,2,1,3,9712,9430,19142,17,0.132601,0.157808,1179.047619,0,0
8573864,"Kaltbrunn, Aeuli",,0.000035,67,1,1,2,5040,5038,10078,26,0.06383,0.077059,912,0,0
8573865,"Rufi, Wiesental",,0.000041,67,1,1,2,5038,5292,10330,25,0.067783,0.081325,1008,0,0
8573866,"Rufi, Sonne",,0.000046,67,1,1,2,5292,5292,10584,24,0.072284,0.086426,1102,0,0
8573867,"Rufi, Freihof",,0.00005,67,1,1,2,5292,4786,10078,23,0.077455,0.092853,1194,0,0
8573868,"Schänis, Mühlegasse",,0.000053,67,1,2,3,4786,5292,10078,22,0.083458,0.102411,1284,0,0
8573869,"Schänis, Gemeindehaus",,0.000033,67,1,1,2,2644,2644,5288,21,0.089967,0.10531,646.5,0,0
8573870,"Schänis, Rathausplatz",,0.000033,67,1,1,2,2648,2648,5296,21,0.089967,0.10531,646.5,0,0
8573871,"Schänis, Oberbirg",,0.000068,67,2,2,4,5292,5292,10584,20,0.098262,0.117277,1542,0,0
8573872,"Schänis, Windegg",,0.00004,67,1,1,2,2644,2644,5288,19,0.107641,0.123077,771,0,0
8573873,"Schänis, Winklen",,0.00004,67,1,1,2,2648,2648,5296,19,0.107641,0.123077,771,0,0
8573874,"Ziegelbrücke, Bahnhof Nord",,0.000078,67,2,1,3,5292,5292,10584,18,0.119881,0.137577,1782,0,0
8573877,"Kaltbrunn, Stiggleten",,0.000078,67,1,1,2,5292,5292,10584,17,0.135364,0.157179,1858,0,0
8573880,"Benken SG, Sand",,0.000048,67,1,1,2,5038,5038,10076,5,0.304348,0.397619,176,0,0
8573881,"Benken SG, Neubruch",,0.000051,67,1,1,2,5038,5038,10076,4,0.375,0.458333,94,0,0
8573882,"Benken SG, Giessen",,0.000055,67,1,1,2,5038,5292,10330,3,0.5,0.566667,10,0,0
8579933,"Uznach, Uznabergstrasse",,0.000092,67,3,2,5,10609,10651,21260,2,0.625,0.7,1818.6,0,0
8573884,"Oberurnen, Feuerwehrplatz",,0.00003,106,2,1,3,5955,9846,15801,16,0.124197,0.161695,10,0,0
8573885,"Näfels, Lintharena",,0.000036,106,1,1,2,9846,9846,19692,15,0.139364,0.183856,62,0,0
8573887,"Näfels-Mollis, Bahnhof",,0.000065,106,3,4,7,14631,20202,34833,13,0.185811,0.290628,430,0,0
8573892,"Filzbach, Garage",,0.000057,106,2,2,4,6616,6616,13232,14,0.128814,0.203904,257,0,0
8573901,"Mühlehorn, Bahnhof",,0.000064,106,1,2,3,6373,6105,12478,14,0.128319,0.222508,239.5,0,0
8579950,"Näfels, Post",,0.000105,106,2,3,5,19969,19510,39479,7,0.297297,0.404978,614.5,0,0
8573888,"Mollis, Kirchplatz",,0.000025,106,1,1,2,6114,6114,12228,18,0.091904,0.136238,80,0,0
8573889,"Mollis, Chapellenstutz",,0.000032,106,1,1,2,6114,6114,12228,17,0.098795,0.14478,111,0,0
8573890,"Mollis, Winden",,0.000038,106,1,1,2,6114,6114,12228,16,0.106952,0.156078,140,0,0
8573893,"Filzbach, Milchzentrale",,0.000035,106,1,1,2,6105,6105,12210,21,0.080435,0.136622,127.5,0,0
8573894,"Filzbach, Reutegg",,0.000041,106,1,1,2,6105,6105,12210,20,0.085106,0.146309,148.5,0,0
8573895,"Obstalden, Walenguflen",,0.000046,106,1,2,3,6105,6105,12210,19,0.090439,0.166587,167.5,0,0
8573896,"Obstalden, Bödeli",,0.00003,106,1,1,2,2837,3105,5942,19,0.088083,0.142075,0,0,0
8573897,"Mühlehorn, Beerenboden",,0.000056,106,2,1,3,6373,6373,12746,18,0.09375,0.149103,199.5,0,0
8573898,"Mühlehorn, Hohrain",,0.000058,106,1,1,2,6373,6373,12746,17,0.100313,0.157875,212.5,0,0
8573899,"Mühlehorn, Stutz",,0.000061,106,1,1,2,6373,6373,12746,16,0.108014,0.169567,223.5,0,0
8573900,"Mühlehorn, Oberdorf",,0.000062,106,1,1,2,6373,6373,12746,15,0.117188,0.18714,232.5,0,0
8587510,"Niederurnen, Ochsenplatz",,0.000079,106,1,3,4,10305,9846,20151,2,0.8,0.875,84.5,0,0
8573902,"Glarus, Bahnhof",,0.000025,106,1,4,5,9664,19253,28917,10,0.204819,0.317145,250,0,0
8573904,"Riedern GL, Schulhaus",,0.000016,106,1,1,2,4830,4611,9441,10,0.171233,0.221317,0,0,0
8573908,"Chamoson, Pierre-Olivier",,0.000024,39,1,1,2,7765,7765,15530,17,0.137234,0.167653,67,0,0
8573910,"Ovronnaz, Chevaley",,0.000027,39,2,1,3,2553,2553,5106,16,0.107143,0.194763,1056,0,0
8573911,"Wil SG, Pflegezentrum",,0.000019,20,1,1,2,91,91,182,35,0.060008,0.067564,3535,0,0
8573914,"Züberwangen, Schulhaus",,0.000051,20,2,1,3,7916,7916,15832,33,0.067961,0.077525,61619.562517,0,0
8573915,"Züberwangen, Weieren",,0.000054,20,1,1,2,7916,7916,15832,32,0.072797,0.083999,62062.562517,0,0
8573916,"Zuzwil SG, Grünegg",,0.000057,20,1,1,2,7916,7916,15832,31,0.078383,0.092042,62503.562517,0,0
8573917,"Zuzwil SG, Gemeindehaus",,0.000059,20,1,2,3,7916,7916,15832,30,0.08491,0.102798,62942.562517,0,0
8581128,"Zuckenriet, Bläuel",,0.000066,20,4,2,6,6555,6555,13110,20,0.0827,0.104707,3868.801801,0,0
8581427,"Oberbüren, Werkhof",,0.000077,71,3,2,5,9734,9790,19524,17,0.10687,0.131674,4326.384226,0,0
8573932,"Oberbüren, Glattfeld",,0.000024,20,1,1,2,153,91,244,21,0.076764,0.093793,3121.968467,0,0
8573920,"Niederhelfenschwil, Waldhof",,0.000033,20,2,1,3,182,182,364,26,0.061877,0.079177,750,0,0
8573921,"Niederhelfenschwil, Gemeinde",,0.000039,20,1,1,2,182,91,273,25,0.065679,0.086061,814,0,0
8573926,"Wil SG, Rapp",,0.000026,20,1,2,3,38418,38418,76836,25,0.06837,0.099725,8714.5,0,0
8578520,Lamperswil SG,,0.000082,20,1,1,2,23175,23175,46350,20,0.091566,0.184226,883,0,0
8573930,"Uzwil, Mühlehof",,0.000045,20,2,3,5,11479,11820,23299,23,0.074646,0.108739,1471,0,0
8573931,"Niederuzwil, Marienfried",,0.000046,20,2,3,5,1266,1266,2532,22,0.078146,0.110075,3124.968467,0,0
8573941,"Bichwil, Dorf",,0.00005,20,1,2,3,11337,11305,22642,10,0.212291,0.281965,4315,0,0
8580558,"Flawil, Bärenplatz",,0.000034,20,2,3,5,9055,9055,18110,7,0.324324,0.493849,992,0,0
8573937,"Oberuzwil, Drogerie",,0.000059,20,3,2,5,25748,25407,51155,14,0.133127,0.19846,5092,0,0
8573938,"Oberuzwil, Flawilerstrasse",,0.000036,20,1,1,2,11337,11337,22674,13,0.137124,0.174885,4756,0,0
8573939,"Oberuzwil, Rain",,0.000041,20,1,1,2,11337,11337,22674,12,0.155039,0.195368,4611,0,0
8573940,"Bichwil, Torackerstrasse",,0.000046,20,1,1,2,11337,11337,22674,11,0.178899,0.226171,4464,0,0
8573942,"Oberuzwil, Schützenhaus",,0.000036,20,1,1,2,14070,14573,28643,6,0.28,0.385714,9,0,0
8573944,"Henau, Kirchplatz",,0.000067,20,3,2,5,9563,9537,19100,4,0.4375,0.559524,1314,0,0
8581127,"Jonschwil, Sonne",,0.000071,20,1,2,3,14666,13672,28338,3,0.571429,0.708333,205,0,0
8573945,"Gossau SG, Bahnhof",,0.000098,71,7,3,10,78454,100930,179384,26,0.125516,0.169699,85288.380652,0,0
8577362,"Gossau SG, Falkenstrasse",,0.000048,71,5,3,8,49867,49579,99446,13,0.161097,0.1989,7606.530669,0,0
8581737,"Andwil SG, Linden",,0.000043,71,2,2,4,16412,16412,32824,16,0.118033,0.145373,3162.729669,0,0
8583596,"Sonnental, Schulhaus",,0.000044,71,1,1,2,6735,6488,13223,16,0.115894,0.136478,4072.550892,0,0
8587343,"St. Gallen, Fürstenlandbrücke",,0.000109,71,5,6,11,179721,179692,359413,12,0.19692,0.258893,5615.208763,0,0
8573955,"Andwil SG, Otmarsegg",,0.000037,71,3,3,6,16419,16476,32895,31,0.086246,0.115336,331.289286,0,0
8578304,"Gossau SG, Walter Zoo",,0.00002,71,1,1,2,5444,5444,10888,4,0.416667,0.516667,0,0,0
8587329,"Arnegg, Restaurant Ilge",,0.000059,71,1,1,2,16412,16380,32792,1,1,1,4,0,0
8588496,"Gossau SG, Mooswies",,0.000057,71,1,3,4,49578,48124,97702,14,0.146067,0.179954,5687.284998,0,0
8573956,"Andwil SG, Grünau",,0.000034,71,2,1,3,16409,16412,32821,30,0.083944,0.100179,2855.833333,0,0
8573963,"Bernhardzell, Dorf",,0.000059,71,3,1,4,9046,9046,18092,27,0.108479,0.135384,6862.270331,0,0
8574256,"Wittenbach, Gemeindehaus",,0.000079,71,1,4,5,42162,42162,84324,16,0.193591,0.24332,4342.535714,0,0
8574220,"Häggenschwil, Scheidweg",,0.00004,71,1,1,2,5021,5021,10042,19,0.123401,0.137354,598,0,0
8574240,"Kronbühl, Bruggbach",,0.000028,71,2,3,5,41760,41760,83520,18,0.139954,0.17511,5911.166667,0,0
8574253,"Kronbühl, Kantonalbank",,0.000028,71,2,2,4,21172,21171,42343,16,0.188525,0.231392,442.666667,0,0
8573966,"Wittenbach, Zentrum",,0.000027,71,1,1,2,37289,37289,74578,26,0.120252,0.156387,271,0,0
8574202,"Flawil, Badstrasse",,0.000038,20,1,3,4,7560,7561,15121,8,0.288889,0.465476,351,0,0
8583062,"Niederuzwil, Gaswerk",,0.000061,20,1,1,2,11490,11149,22639,2,0.666667,0.75,222,0,0
8573979,"Bütschwil, Bahnhof",,0.000051,70,3,3,6,18261,23978,42239,43,0.043386,0.065248,119274.566667,0,0
8573984,"Mosnang, Dorf",,0.000048,70,1,2,3,10711,10346,21057,6,0.305556,0.430303,1004,0,0
8573980,"Bütschwil, Pflegeheim",,0.000025,70,1,1,2,10711,10706,21417,10,0.166667,0.244974,1600,0,0
8573981,"Mosnang, Schreinersberg",,0.000032,70,1,1,2,10706,10711,21417,9,0.186667,0.265249,1454,0,0
8573982,"Mosnang, Weiher",,0.000038,70,1,1,2,10711,10711,21422,8,0.213115,0.293132,1306,0,0
8573983,"Mosnang, Grütli",,0.000044,70,1,1,2,10711,10711,21422,7,0.25,0.336905,1156,0,0
8573985,"Mosnang, Winkeln",,0.000031,70,1,1,2,5372,5372,10744,5,0.333333,0.456667,825,0,0
8573986,"Dreien, Tüfi",,0.000037,70,1,1,2,5372,5372,10744,4,0.4,0.520833,664,0,0
8573987,"Dreien, Hauptstrasse",,0.000043,70,1,1,2,5372,5372,10744,3,0.5,0.611111,501,0,0
8573988,"Dreien, Freihof",,0.000047,70,1,1,2,5372,5372,10744,2,0.666667,0.75,336,0,0
8573989,"Mühlrüti, Mühle",,0.000051,70,1,1,2,5372,5371,10743,1,1,1,169,0,0
8573994,"Libingen, Lindenboden",,0.000046,70,2,1,3,5333,5361,10694,4,0.4,0.520833,660,0,0
8573995,"Libingen, Vorderhofen",,0.00005,70,1,1,2,5361,5361,10722,3,0.5,0.611111,498,0,0
8573996,"Libingen, Hinterhofen",,0.000053,70,1,1,2,5361,4974,10335,2,0.666667,0.75,334,0,0
8573997,"Mosnang, Aufeld",,0.000056,70,1,1,2,4974,4974,9948,1,1,1,168,0,0
8574000,"Bütschwil, Au",,0.000022,70,1,1,2,12820,12821,25641,7,0.226667,0.288936,1987,0,0
8574001,"Ganterschwil, Hirschen",,0.000029,70,1,1,2,12821,12821,25642,6,0.275862,0.347917,1842,0,0
8578594,"Ebnat, Wier",,0.000085,97,2,4,6,23112,12100,35212,5,0.395349,0.518627,2234,0,0
8580480,"Bazenheid, Hochhaus",,0.000043,20,2,2,4,7411,7411,14822,6,0.32,0.422917,422,0,0
8574002,"Lichtensteig, Bahnhof",,0.00002,97,1,1,2,3582,3582,7164,46,0.037952,0.048901,32,0,0
8574003,"Lichtensteig, Rest. Bahnhöfli",,0.000028,97,1,1,2,3582,3582,7164,45,0.039414,0.051888,1135,0,0
8574004,"Lichtensteig, Gurtbergwald",,0.000035,97,1,1,2,3582,3582,7164,44,0.040994,0.055452,2236,0,0
8574005,"Krinau, Mühle",,0.00004,97,1,1,2,3582,3582,7164,43,0.042708,0.059839,3335,0,0
8578521,"Kirchberg SG, Fetzhof",,0.000091,20,2,4,6,37457,37823,75280,19,0.098143,0.245278,2405.5,0,0
8578581,"Wattwil, Schmidenbach",,0.000055,97,1,1,2,21074,17831,38905,14,0.107692,0.161824,612,0,0
8574011,"Wattwil, ev. Kirche",,0.000017,97,1,1,2,4053,4053,8106,38,0.058665,0.073418,39638.333333,0,0
8574012,"Wattwil, Wanne",,0.000025,97,1,1,2,4053,4053,8106,37,0.062142,0.078711,39699.333333,0,0
8574013,"Wattwil, Untereggberg",,0.000032,97,1,1,2,4053,4053,8106,36,0.066068,0.085092,39758.333333,0,0
8574014,"Heiterswil, Krummbach",,0.000038,97,1,1,2,4053,3605,7658,35,0.070538,0.092976,39815.333333,0,0
8574015,"Heiterswil, Weier",,0.000044,97,1,1,2,3605,3605,7210,34,0.075671,0.103052,39870.333333,0,0
8574016,"Hemberg, Dietschwil",,0.000048,97,1,1,2,3605,3605,7210,33,0.081628,0.116607,39923.333333,0,0
8574018,"Nesslau-Neu St.Johann, Bahnhof",,0.000082,73,6,2,8,18022,17606,35628,38,0.041819,0.064867,156689.866667,0,0
8574019,"Nesslau, Dicken",,0.000046,73,1,1,2,11881,11880,23761,37,0.039583,0.046283,123699,0,0
8574020,"Nesslau, Germen",,0.00005,73,1,1,2,11880,11883,23763,36,0.041147,0.048258,124017,0,0
8574021,"Stein SG, Breitenau",,0.000053,73,1,1,2,11883,11883,23766,35,0.042843,0.050476,124333,0,0
8574022,"Stein SG, Mühlewies",,0.000056,73,1,1,2,11883,11883,23766,34,0.044688,0.053,124647,0,0
8574024,Starkenbach,,0.000059,73,1,1,2,11883,11883,23766,33,0.046702,0.055916,124959,0,0
8574025,"Alt St. Johann, Horb",,0.000061,73,1,1,2,11883,11883,23766,32,0.04891,0.059361,125269,0,0
8574026,"Unterwasser, Stofel",,0.000062,73,1,1,2,11883,11883,23766,31,0.05134,0.063571,125577,0,0
8574027,"Unterwasser, Wäldli",,0.000064,73,1,1,2,11883,11883,23766,30,0.05403,0.069025,125883,0,0
8574029,"Wildhaus, Dusi",,0.000042,73,2,1,3,11399,12154,23553,29,0.054926,0.061197,125298,0,0
8574030,"Wildhaus, Bären",,0.000047,73,1,1,2,12154,12157,24311,28,0.058022,0.06478,125598,0,0
8574031,"Wildhaus, Tobelsäge",,0.00005,73,1,1,2,12157,12157,24314,27,0.061495,0.068896,125896,0,0
8574032,"Gams, Schutzgunten",,0.000054,73,1,1,2,12157,12157,24314,26,0.065415,0.073681,126192,0,0
8574033,Zollhaus b. Gams,,0.000057,73,1,1,2,12157,12157,24314,25,0.069878,0.079325,126486,0,0
8574034,"Gams, Chrezibach",,0.000059,73,1,1,2,12157,12157,24314,24,0.075003,0.086107,126778,0,0
8574036,"Gams, Widen",,0.000066,73,2,1,3,12635,12635,25270,22,0.087933,0.105065,127404,0,0
8574408,"Balzers, Schlossweg",,0.000093,73,2,3,5,6609,6609,13218,20,0.096579,0.130059,2768.47619,0,0
8576317,"Grabs, Feldgatter",,0.00003,73,2,1,3,12292,12635,24927,28,0.088939,0.113384,31202.733333,0,0
8580497,"Grabs, Spital",,0.000055,73,1,2,3,15269,9975,25244,24,0.132488,0.193808,30530.733333,0,0
8581988,"Buchs SG, EW",,0.000066,73,3,4,7,22642,17044,39686,23,0.149803,0.236741,52755.133333,0,0
8587566,"Salez, Löwen",,0.000082,73,3,3,6,20170,20184,40354,13,0.176301,0.25605,4387.119048,0,0
8587408,"Sevelen, Rathaus",,0.000124,73,4,4,8,18917,18917,37834,10,0.203774,0.288323,71540.6,0,0
8587568,"Grabs, Industrie",,0.000056,73,3,3,6,28838,29305,58143,12,0.189274,0.261581,16608.414286,0,0
8585406,"Dietfurt, Feldeck",,0.000055,20,1,2,3,87,87,174,4,0.4,0.520833,36,0,0
8574043,"Neu St. Johann, Stocken",,0.000022,73,1,1,2,4374,4375,8749,3,0.5,0.611111,999,0,0
8574044,"Ennetbühl, Gillsäge",,0.00003,73,1,1,2,4375,2871,7246,2,0.666667,0.75,668,0,0
8574045,"Ennetbühl, Bernhalde/Lutert.",,0.000036,73,1,1,2,2871,2871,5742,1,1,1,335,0,0
8574047,"Urnäsch, Bahnhof",,0.00004,73,1,1,2,2172,2172,4344,4,0.416667,0.516667,50,0,0
8574049,"Urnäsch, Anker",,0.000045,73,1,2,3,2172,2172,4344,3,0.571429,0.708333,44,0,0
8574050,"Urnäsch, Frohsinn",,0.00003,73,1,1,2,1084,1084,2168,3,0.5,0.611111,0,0,0
8574051,"Urnäsch, Hüsli",,0.000056,73,2,1,3,2172,2172,4344,2,0.666667,0.75,26,0,0
8574066,"Teufen AR, Bahnhof",,0.000035,71,1,1,2,265,336,601,28,0.065709,0.073496,340.5,0,0
8574068,"Teufen AR, Vorderhaus",,0.000041,71,1,1,2,336,336,672,27,0.070154,0.078553,716.5,0,0
8574069,"Teufen AR, Gählern",,0.000045,71,1,1,2,336,336,672,26,0.075257,0.08454,1090.5,0,0
8574070,"Teufen AR, Abzw. Obertobel",,0.00005,71,1,1,2,336,336,672,25,0.081176,0.091772,1462.5,0,0
8574071,"Teufen AR,Steinegg Feuerwehrh.",,0.000053,71,1,1,2,336,336,672,24,0.088123,0.100755,1832.5,0,0
8574072,"Speicher, Sitz",,0.000056,71,1,1,2,336,336,672,23,0.096394,0.112417,2200.5,0,0
8574073,"Speicher, Almenweg",,0.000058,71,1,2,3,336,336,672,22,0.106406,0.129028,2566.5,0,0
8574074,"Speicher, Reutenen",,0.000036,71,1,1,2,194,194,388,22,0.106163,0.126801,0,0,0
8574159,"Trogen, Landsgemeindeplatz",,0.000082,71,2,1,3,6551,6551,13102,22,0.106163,0.126801,16486.533333,0,0
8574078,"Heiden, Dunant-Museum",,0.000032,71,2,1,3,13981,14009,27990,43,0.052468,0.07736,513.5,0,0
8574079,"Heiden, Waldegg Heiden",,0.000038,71,1,1,2,14009,14009,28018,42,0.055323,0.086298,1595.5,0,0
8574080,"Heiden, Hirschli",,0.000043,71,1,1,2,14009,14009,28018,41,0.058511,0.098605,2675.5,0,0
8574083,"Wolfhalden, Wüschbach",,0.000036,71,2,1,3,8975,8759,17734,38,0.059081,0.077044,4934.507143,0,0
8574084,"Wolfhalden, Luchten",,0.000041,71,1,3,4,8759,8793,17552,37,0.062734,0.08563,6006.507143,0,0
8574087,Bruggmühle AR,,0.000036,71,1,3,4,6396,6242,12638,37,0.062999,0.086725,2659,0,0
8574088,"Lutzenberg, Hellbüchel",,0.000021,71,1,1,2,3793,3793,7586,37,0.062334,0.082287,0,0,0
8574085,"Wolfhalden, Friedberg",,0.000023,71,1,1,2,6270,6213,12483,39,0.056043,0.071273,525,0,0
8574086,"Wolfhalden, Lindenberg",,0.00003,71,1,1,2,6213,6396,12609,38,0.059316,0.077836,1593,0,0
8574099,"Walzenhausen, Ledi Schwimmbad",,0.000048,72,1,1,2,2636,2636,5272,43,0.040448,0.048769,2913,0,0
8574089,"Lutzenberg, Brenden",,0.000051,71,3,2,5,4754,4782,9536,36,0.066418,0.091551,10705.507143,0,0
8574090,"Lutzenberg, Altersheim",,0.000033,71,1,1,2,3793,3793,7586,36,0.066361,0.090726,0,0,0
8574091,"Lutzenberg, Friedegg",,0.00006,71,2,1,3,4782,4782,9564,35,0.071014,0.102319,12823.507143,0,0
8574265,"Goldach, Untereggerstrasse",,0.000049,72,1,2,3,7168,7168,14336,20,0.124658,0.14731,6426.083333,0,0
8574272,"Rorschach, Signalstrasse",,0.000076,72,2,3,5,49693,49693,99386,18,0.130982,0.159168,5169.602381,0,0
8574280,"Rorschach, Fuchsschwanz",,0.000042,72,2,3,5,34231,34231,68462,19,0.102318,0.125461,2713.75,0,0
8580718,"Goldach, Bahnhof",,0.000126,72,4,3,7,50650,50323,100973,14,0.191176,0.346214,14002.5,0,0
8580917,"Rorschacherberg, Wilenrain",,0.000073,72,3,2,5,22695,22709,45404,14,0.185185,0.320062,225,0,0
8581126,"Rorschacherberg, Swissair",,0.000077,72,1,1,2,15384,14387,29771,14,0.174242,0.282677,23,0,0
8574160,"Trogen, Bahnhof",,0.000136,71,3,5,8,6887,6887,13774,21,0.118469,0.151246,19874.033333,0,0
8574190,"Waldstatt, Adler",,0.000042,71,1,1,2,4623,4623,9246,21,0.119513,0.136813,14796.266667,0,0
8574239,"St. Gallen, Schützengarten",,0.000039,71,4,4,8,108111,108108,216219,19,0.163659,0.229941,1837.46328,0,0
8574247,"Arbon, Bergli",,0.000061,71,2,2,4,24028,24028,48056,17,0.161131,0.191771,3039.703571,0,0
8574249,"Arbon, Stahelplatz",,0.000051,71,2,1,3,25827,25827,51654,17,0.160449,0.188643,714,0,0
8574214,"Niederteufen, Schwanen",,0.000039,71,1,2,3,5758,5758,11516,17,0.19219,0.238965,21722.88022,0,0
8574251,"Arbon, Bahnhof",,0.000089,71,3,8,11,56091,56005,112096,16,0.190578,0.243841,20396.422619,0,0
8574276,"Horn, Grünau",,0.00003,71,2,1,3,8121,8153,16274,20,0.116436,0.132041,90,0,0
8574285,"Rorschacherberg, Rosenegg",,0.000072,72,3,1,4,29020,29020,58040,20,0.097281,0.108682,1234.5,0,0
8574229,"Engelburg, Freihof",,0.000036,71,1,5,6,32034,32034,64068,26,0.116791,0.176869,1111.169444,0,0
8574237,"Engelburg, Chapf",,0.000017,71,1,3,4,16363,16363,32726,26,0.115249,0.169391,0,0,0
8574154,"Wald AR, Schweizerbund",,0.000068,71,5,3,8,5941,6103,12044,27,0.081148,0.103712,8295.475211,0,0
8574449,"Grub AR, Riemen",,0.000064,71,1,2,3,11071,11071,22142,23,0.093109,0.1086,2829.416667,0,0
8574460,"St. Gallen, Unterschachen",,0.00011,71,4,1,5,18173,18159,36332,19,0.140317,0.165629,7829.435714,0,0
8574469,"St. Gallen, Theater",,0.000116,71,6,2,8,177843,177836,355679,16,0.189153,0.232422,7750.435317,0,0
8574470,"St. Gallen, Achslen",,0.00006,71,1,1,2,57426,57426,114852,16,0.188617,0.229729,0,0,0
8580242,"St. Gallen, Hochwacht",,0.000034,71,2,5,7,49736,49736,99472,11,0.208183,0.261724,12656.02954,0,0
8589557,"St. Gallen St. Fiden, Bahnhof",,0.000034,71,1,3,4,42449,42449,84898,12,0.203463,0.248295,1162.30811,0,0
8589560,"St. Gallen, Blumenberg",,0.00004,71,5,4,9,54057,54057,108114,13,0.17744,0.228416,4765.629664,0,0
8589561,"St. Gallen, Blumenwies",,0.00005,71,3,4,7,68767,68767,137534,13,0.180628,0.232876,2477.036805,0,0
8574096,"Wolfhalden, Schönenbühl",,0.000032,72,2,1,3,2523,2523,5046,46,0.036175,0.042087,150,0,0
8574097,"Walzenhausen, Lachen",,0.000038,72,1,1,2,2523,2523,5046,45,0.037494,0.043949,1073,0,0
8574098,"Walzenhausen, Moos",,0.000043,72,1,1,2,2523,2636,5159,44,0.038914,0.046113,1994,0,0
8574100,"Walzenhausen, Bahnhof",,0.000071,72,3,3,6,5113,5238,10351,42,0.04211,0.052629,4875.6,0,0
8574103,"Walzenhausen, Bild",,0.000043,72,1,3,4,4250,4222,8472,39,0.047978,0.061235,7383,0,0
8574106,"Walzenhausen, Gaismoos",,0.000029,72,1,3,4,3139,3139,6278,36,0.049275,0.067626,8969.7,0,0
8574111,"St. Margrethen SG, Bahnhof",,0.000062,72,4,3,7,19027,19027,38054,32,0.060587,0.089844,32356.5,0,0
8574101,"Walzenhausen, Güetli",,0.000031,72,1,1,2,4250,4250,8500,41,0.043862,0.052695,5559,0,0
8574102,"Walzenhausen, Hasenbrunnen",,0.000037,72,1,1,2,4250,4250,8500,40,0.045827,0.056232,6472,0,0
8574107,"St. Margrethen SG, Gletscherh",,0.000019,72,1,1,2,2280,2280,4560,35,0.05158,0.067344,9318.9,0,0
8574108,"St. Margrethen SG,Schäflisberg",,0.000027,72,1,2,3,2280,2280,4560,34,0.054294,0.07369,9850.9,0,0
8574109,"St. Margrethen SG, Apfelberg",,0.000022,72,1,1,2,1127,1127,2254,34,0.054207,0.072125,0,0,0
8579513,"Sion, Maragnénaz",,0.000078,39,2,2,4,7020,7020,14040,20,0.115789,0.161405,2230,0,0
8580267,"Praz-Jean VS, Stand Mourty",,0.000059,39,2,2,4,2555,2555,5110,19,0.120666,0.163324,2241,0,0
8574114,"Zelg (Wolfhalden), Mühltobel",,0.000077,72,5,1,6,2602,2449,5051,5,0.333333,0.456667,268,0,0
8574115,"Zelg (Wolfhalden), Zelg",,0.000076,72,1,1,2,2449,2449,4898,4,0.4,0.520833,205,0,0
8574116,"Zelg (Wolfhalden), Gemsli",,0.000076,72,1,1,2,2449,2306,4755,3,0.5,0.611111,140,0,0
8574117,"Zelg (Wolfhalden), Hueb",,0.000075,72,1,1,2,2306,2449,4755,2,0.666667,0.75,73,0,0
8574118,"Walzenhausen, Sonnenberg",,0.000075,72,1,1,2,2449,495,2944,1,1,1,4,0,0
8574477,"Wolfhalden, Lippenreute",,0.000076,72,1,1,2,2523,494,3017,1,1,1,69,0,0
8574124,"Oberegg AI, Wässern",,0.000044,71,1,1,2,5834,5835,11669,38,0.052468,0.066426,2571.5,0,0
8574128,"Reute AR, Dorf",,0.000092,71,5,4,9,6241,6731,12972,36,0.055902,0.073182,12395.6,0,0
8574129,"Reute AR, Brücke",,0.00003,71,1,1,2,3746,3746,7492,36,0.055405,0.068043,0,0,0
8574149,"Oberegg AI, St. Anton",,0.000062,71,2,2,4,1934,1384,3318,24,0.091737,0.107662,8858,0,0
8578478,"Trogen, Hüttschwendi",,0.000034,73,1,1,2,1071,1071,2142,16,0.098712,0.142788,4921.266667,0,0
8574130,"Oberegg AI, Sonderegg",,0.000056,71,2,2,4,4488,4609,9097,35,0.058592,0.074319,12598.4,0,0
8574140,"Mohren, Sturzenhard",,0.000042,71,1,1,2,1595,1595,3190,35,0.057604,0.071216,1812,0,0
8574133,"Berneck, Schlossbrücke",,0.000049,73,2,1,3,18199,18199,36398,34,0.053594,0.069735,2223,0,0
8574134,"Berneck, Rosenberg",,0.000053,73,1,1,2,18199,18199,36398,33,0.056532,0.075822,2734,0,0
8574135,"Heerbrugg, Waldegg",,0.000056,73,1,1,2,18199,18199,36398,32,0.059817,0.083719,3243,0,0
8574144,"Lüchingen, Sportanlagen/GESA",,0.00005,71,1,1,2,1464,1464,2928,31,0.060926,0.084426,11809.9,0,0
8578432,"Heerbrugg, Neuwies",,0.000053,73,1,1,2,16747,16747,33494,7,0.272727,0.364683,60,0,0
8574138,"Reute AR, Steinegacht",,0.00003,71,1,1,2,1595,1595,3190,37,0.051759,0.061644,136,0,0
8574139,"Reute AR, Bellevue",,0.000037,71,1,1,2,1595,1595,3190,36,0.054524,0.065965,975,0,0
8574141,Mohren,,0.000071,71,2,2,4,2458,2327,4785,34,0.061058,0.078078,15552.4,0,0
8574148,"Oberegg AI, Eugst",,0.000025,71,1,1,2,1071,1071,2142,25,0.084224,0.096196,3015.5,0,0
8574142,"Mohren, Grütli",,0.000041,71,1,1,2,1464,1464,2928,33,0.05449,0.070354,10859.9,0,0
8574143,"Marbach SG, Bruggtobel",,0.000046,71,1,1,2,1464,1464,2928,32,0.057525,0.076475,11335.9,0,0
8574176,"Montlingen, Bitziweg",,0.000032,73,1,1,2,7337,7104,14441,30,0.062963,0.087386,1072,0,0
8578445,"Diepoldsau, Hennemoos",,0.00005,73,1,2,3,28259,28259,56518,33,0.054514,0.083996,690,0,0
8578447,"Diepoldsau, Schweizer Zoll",,0.000038,73,1,1,2,27856,27033,54889,33,0.053712,0.073166,123,0,0
8578463,"Altstätten SG, Depot",,0.000074,73,1,2,3,17821,17303,35124,22,0.112903,0.172288,1904,0,0
8578464,"Altstätten SG, Stadt",,0.000072,73,3,3,6,29220,18501,47721,22,0.113613,0.179195,2067.25,0,0
8578466,"Altstätten SG, Klosterguet",,0.000077,73,3,3,6,44935,44935,89870,21,0.119701,0.195153,5510.166667,0,0
8574150,"Oberegg AI, Haggen",,0.000037,71,1,1,2,1014,1071,2085,23,0.096196,0.111429,9035,0,0
8574158,"Trogen, Schopfacker",,0.000047,71,1,1,2,5480,5480,10960,23,0.096196,0.111429,6983.533333,0,0
8574459,"Rehetobel, Robach",,0.000073,71,1,2,3,8689,8689,17378,22,0.099661,0.11888,2300.5,0,0
8574472,"St. Gallen, Grütli",,0.000018,71,1,3,4,57426,56458,113884,18,0.169986,0.213922,897.759524,0,0
8574155,"Wald AR, Unterdorf",,0.00003,71,1,1,2,5480,5480,10960,26,0.075138,0.084248,6662.533333,0,0
8574156,"Wald AR, Grunholz",,0.000037,71,1,1,2,5480,5480,10960,25,0.081037,0.09137,6771.533333,0,0
8574157,"Trogen, Bleiche",,0.000042,71,1,1,2,5480,5480,10960,24,0.087959,0.100164,6878.533333,0,0
8574170,"Kriessern, Dorf",,0.000016,73,1,1,2,7337,7337,14674,32,0.056112,0.072109,8,0,0
8574171,"Kriessern, Baggersee",,0.000024,73,1,1,2,7337,7337,14674,31,0.059337,0.078642,541,0,0
8580498,"Haag (Rheintal), Dorf",,0.000033,73,1,1,2,16623,16623,33246,20,0.091376,0.124776,1371,0,0
8587469,"Rüthi (Rheintal), Dorf",,0.000064,73,2,2,4,16225,16225,32450,18,0.106784,0.150857,2451,0,0
8587487,"Oberriet SG, Eichenwies",,0.000043,73,1,1,2,16389,16389,32778,18,0.104666,0.13642,83,0,0
8587488,"Oberriet SG, Sekundarschule",,0.000086,73,3,2,5,20022,20022,40044,17,0.115493,0.157697,3894,0,0
8574180,"Brunnadern, Alters-und Pflegeh",,0.00004,97,1,1,2,7497,7497,14994,30,0.083292,0.105691,17946.697424,0,0
8574181,"Brunnadern, Spreitenbach",,0.000045,97,1,1,2,7497,7497,14994,29,0.09059,0.119324,17980.697424,0,0
8574184,"St. Peterzell, Rüti",,0.000043,97,2,1,3,5221,5221,10442,27,0.085422,0.100331,15360.5,0,0
8574185,"St. Peterzell, Schönenbühl",,0.000047,97,1,1,2,5221,5221,10442,26,0.093121,0.111372,15388.5,0,0
8574186,"St. Peterzell, Stafel",,0.000051,97,1,1,2,5221,5221,10442,25,0.102374,0.126134,15414.5,0,0
8574189,"Schwellbrunn, Rotschwendi",,0.000037,71,1,1,2,4623,4623,9246,22,0.107049,0.120548,14783.266667,0,0
8581102,"Trogne, d'Enhaut",,0.000039,39,2,1,3,1719,1772,3491,21,0.099548,0.131586,8,0,0
8574194,"Herisau, Langelen",,0.000079,71,3,1,4,10381,39950,50331,20,0.135316,0.159619,30181.934953,0,0
8574196,"St. Peterzell, Bächlistrasse",,0.000122,71,6,2,8,7454,6546,14000,13,0.171001,0.20974,32526.102015,0,0
8574206,"Herisau, Müli",,0.000062,71,3,2,5,13696,29600,43296,13,0.170751,0.209553,2999.053366,0,0
8574208,"Herisau, Bruggeregg",,0.000043,71,1,3,4,13716,13716,27432,13,0.170111,0.210733,526,0,0
8574211,"Schwellbrunn, Halden",,0.000023,71,1,1,2,5279,5563,10842,13,0.169182,0.203898,0,0,0
8574259,"Lustmühle, Bahnhof",,0.000025,71,2,1,3,5493,5493,10986,13,0.169182,0.203898,1003.49325,0,0
8578506,"Herisau, Rietwis",,0.000019,71,2,2,4,16898,16898,33796,13,0.172191,0.210372,8290.739008,0,0
8574197,"Bächli, Wies",,0.000063,71,1,1,2,2232,2232,4464,3,0.5,0.611111,1401,0,0
8574198,"Hemberg, Schwandsbrugg",,0.000064,71,1,1,2,2232,2233,4465,2,0.666667,0.75,936,0,0
8574199,"Hemberg, Rütelirank",,0.000065,71,1,1,2,2233,2226,4459,1,1,1,469,0,0
8574200,"Degersheim, Post",,0.000061,20,3,1,4,11067,11067,22134,10,0.215909,0.29363,1669,0,0
8574201,"Degersheim, Bahnhof",,0.000063,20,1,2,3,11067,10939,22006,9,0.26087,0.379387,1463,0,0
8580559,"Flawil, Lindengut",,0.000031,20,2,1,3,5938,5938,11876,3,0.5,0.583333,0,0,0
8574203,"Glattfelden, Aarüti",,0.000011,83,0,1,1,0,6179,6179,5,0.296296,0.383333,0,0,0
8574204,"Hoffeld, Säge-Waldbach",,0.000038,20,1,1,2,3379,3379,6758,3,0.5,0.611111,678,0,0
8574205,"Dicken b Dgh, Freihof",,0.000043,20,1,1,2,3379,3379,6758,2,0.666667,0.75,454,0,0
8574207,"Herisau, Schloss",,0.000037,71,1,1,2,13716,13716,27432,14,0.145961,0.170024,624,0,0
8578507,"Herisau, Bahnhof",,0.000199,71,10,13,23,100364,149106,249470,12,0.202677,0.275622,49834.992014,0,0
8581722,"Schwellbrunn, Tobelacker",,0.000024,71,1,1,2,1035,1035,2070,13,0.145623,0.168819,0,0,0
8587121,"Schwellbrunn, Sommertal",,0.000024,71,1,1,2,4754,4736,9490,13,0.145623,0.168819,0,0,0
8574213,"Stein AR, Schachen",,0.000033,71,1,1,2,5758,5758,11516,18,0.161637,0.188746,21873.88022,0,0
8574215,"Niederteufen, Sternen b. T.",,0.000034,71,1,1,2,71,71,142,2,0.666667,0.75,652,0,0
8574216,"Häggenschwil-Winden, Bahnhof",,0.000027,71,1,1,2,5021,5021,10042,21,0.099537,0.109366,432,0,0
8574219,"Lömmenschwil, Schöntal",,0.000034,71,1,1,2,5021,5021,10042,20,0.110173,0.12154,516,0,0
8574277,"Horn, Bahnhof",,0.000045,71,2,2,4,8217,8217,16434,19,0.131331,0.153423,1126.166667,0,0
8574279,"Horn, Rütiwiese",,0.000036,71,1,1,2,8153,8153,16306,19,0.13061,0.149323,291,0,0
8574288,"Rorschacherberg, Z-Friedhof",,0.000079,72,1,3,4,29856,29856,59712,17,0.135797,0.163268,2846.5,0,0
8574304,"Rorschacherberg, Burg",,0.000036,72,1,3,4,16321,16321,32642,16,0.138046,0.167357,819.166667,0,0
8574462,"St. Gallen, Favrestrasse",,0.000119,71,4,3,7,86965,86958,173923,18,0.162661,0.20432,12576.599211,0,0
8574464,"Speicherschwendi, Sonne",,0.00005,71,1,1,2,8608,8609,17217,19,0.13061,0.149323,1700.083333,0,0
8574467,"St. Gallen, Kantonsspital",,0.000189,71,3,4,7,166369,166364,332733,17,0.174863,0.218585,10130.626984,0,0
8574468,"St. Gallen, Schaugenhof",,0.000051,71,1,1,2,8609,8609,17218,17,0.159533,0.184868,0,0,0
8581402,"Herisau, Kaserne",,0.00006,71,1,4,5,32711,32711,65422,12,0.181287,0.228171,4972.101401,0,0
8581773,"Engelburg, Abzw. Spisegg",,0.000024,71,1,1,2,14104,14510,28614,15,0.134058,0.152488,0,0,0
8589568,"St. Gallen, Dierauerstrasse",,0.000046,71,5,5,10,65675,65674,131349,13,0.179916,0.236001,7861.074362,0,0
8588966,"Abtwil SG, Gemeindehaus",,0.000058,71,1,3,4,31015,31015,62030,11,0.226667,0.274069,539.875187,0,0
8589587,"St. Gallen, Hölzli",,0.000053,71,3,2,5,41815,41843,83658,11,0.215726,0.265569,2093.645949,0,0
8589596,"St. Gallen, Lerchenfeld",,0.000103,71,1,5,6,82451,82451,164902,11,0.234649,0.309806,1357.736751,0,0
8589599,"St. Gallen, Moosweiher",,0.000092,71,6,5,11,66482,66470,132952,11,0.225877,0.302905,1123.949302,0,0
8589600,"St. Gallen, Mövenstrasse",,0.000028,71,1,2,3,40269,40347,80616,11,0.218062,0.275582,2.1,0,0
8589605,"St. Gallen, Olma Messen",,0.000093,71,4,5,9,117027,108108,225135,11,0.240964,0.31827,25652.741053,0,0
8589606,"St. Gallen, Ostfriedhof",,0.000054,71,3,3,6,41314,41261,82575,11,0.221477,0.287029,132.873179,0,0
8589607,"St. Gallen, Pelikanstrasse",,0.000038,71,2,3,5,42449,42449,84898,11,0.232323,0.29975,505.564339,0,0
8589609,"St. Gallen, Poststrasse",,0.000141,71,9,5,14,122735,122644,245379,11,0.227378,0.302543,7835.755174,0,0
8574224,"St. Gallen, Stahl",,0.000021,71,2,1,3,27359,27359,54718,19,0.129508,0.147027,1682,0,0
8574225,"St. Gallen, Sömmerli",,0.000029,71,1,1,2,27359,27359,54718,18,0.14833,0.173714,1730,0,0
8581774,"Abtwil SG, Säntispark",,0.000056,71,5,2,7,82720,82368,165088,14,0.153975,0.180992,906.359524,0,0
8574227,"Engelburg, Ebnet",,0.000022,71,2,1,3,32033,32034,64067,28,0.09517,0.1226,1029.169444,0,0
8574228,"Engelburg, Lindenwies",,0.000029,71,1,1,2,32034,32034,64068,27,0.104862,0.142812,1071.169444,0,0
8580210,"Eggersriet, Oestran",,0.000018,71,1,1,2,10991,8428,19419,15,0.120474,0.138485,404.5,0,0
8580542,"Heiden, Rosengarten",,0.000041,71,2,3,5,13059,14009,27068,15,0.120927,0.146689,1456.039496,0,0
8574231,"Waldkirch, Locherhof",,0.000026,71,1,1,2,2609,2609,5218,4,0.4,0.520833,64,0,0
8574232,"Waldkirch, Hohfirst",,0.000033,71,1,1,2,2609,2609,5218,3,0.5,0.611111,51,0,0
8574233,"Waldkirch, Obergrimm",,0.000039,71,1,1,2,2609,2609,5218,2,0.666667,0.75,36,0,0
8574234,"Waldkirch, Niederwil",,0.000044,71,1,1,2,2609,2609,5218,1,1,1,19,0,0
8574236,"Seuzach, Gemeindehaus",,0.000022,68,1,1,2,3244,3845,7089,15,0.122257,0.157043,158.333333,0,0
8589570,"St. Gallen, Etzelbünt",,0.000047,71,1,2,3,44814,44814,89628,14,0.149867,0.18206,266.414286,0,0
8589573,"St. Gallen, Friedhof Bruggen",,0.000055,71,2,6,8,91155,91142,182297,12,0.219966,0.29011,6496.500021,0,0
8574242,"Wittenbach, Hofen",,0.000019,71,1,1,2,8915,8915,17830,22,0.090144,0.098314,2164,0,0
8574243,"Wittenbach, Gommenschwil",,0.000027,71,1,1,2,8915,8915,17830,21,0.098802,0.108049,2240,0,0
8574244,"Roggwil TG, Ochsen",,0.000034,71,1,1,2,8915,8349,17264,20,0.109333,0.120314,2314,0,0
8587137,"Salmsach, Seestrasse",,0.00002,71,1,1,2,14514,14514,29028,15,0.126384,0.145379,0,0,0
8587141,"Amriswil, Hemmerswil",,0.000036,71,1,1,2,16803,16803,33606,15,0.126384,0.145379,27193,0,0
8587153,"Arbon, Seemoosholz",,0.000069,71,1,2,3,31413,31007,62420,13,0.166461,0.202325,28662,0,0
8574254,"Wittenbach, Im Grüntal",,0.000082,71,4,1,5,42161,42162,84323,18,0.140301,0.158878,4354.535714,0,0
8574255,"Wittenbach, Sportanlagen",,0.00008,71,1,1,2,42162,42162,84324,17,0.162651,0.190364,4349.535714,0,0
8589566,"St. Gallen, Bruggen",,0.000071,71,4,5,9,40388,40823,81211,11,0.205172,0.263983,4651.029753,0,0
8589585,"St. Gallen, Heiligkreuz",,0.000047,71,3,2,5,75022,75018,150040,13,0.172308,0.209463,1993.770798,0,0
8574258,"St. Gallen, Riethüsli",,0.000024,71,2,2,4,49891,49715,99606,12,0.174837,0.206932,1345.745622,0,0
8589612,"St. Gallen, Röteli",,0.000044,71,2,2,4,22437,21273,43710,5,0.37037,0.486667,4034.097704,0,0
8589633,"St. Gallen, Storchenstrasse",,0.000105,71,5,5,10,108260,107081,215341,11,0.22449,0.317834,11349.863997,0,0
8574260,"Untereggen, Hinterhof",,0.00002,72,1,1,2,7168,7168,14336,25,0.077716,0.086419,6251.083333,0,0
8574261,"Untereggen, Mittlerhof",,0.000028,72,1,1,2,7168,7168,14336,24,0.084005,0.093484,6290.083333,0,0
8574262,"Untereggen, Vorderhof",,0.000035,72,1,1,2,7168,7168,14336,23,0.091425,0.102105,6327.083333,0,0
8574263,"Untereggen, Vogelherd",,0.00004,72,1,1,2,7168,7168,14336,22,0.100312,0.112922,6362.083333,0,0
8574264,"Goldach, Sonnental",,0.000045,72,1,1,2,7168,7168,14336,21,0.11115,0.127085,6395.083333,0,0
8574301,"Staad SG, Schönenbach",,0.000057,72,1,3,4,7325,7325,14650,17,0.131745,0.160735,1760,0,0
8574454,"Eggersriet, Ebne Eggersriet",,0.000048,71,1,1,2,10991,10991,21982,20,0.12342,0.141394,2295.416667,0,0
8574266,"Goldach, Raiffeisenbank",,0.000041,72,2,3,5,7436,20892,28328,22,0.087315,0.102645,4925.5,0,0
8574267,"Goldach, Sternen",,0.000023,72,1,2,3,7450,7450,14900,22,0.087064,0.099815,0,0,0
8574270,"Rorschach, Löwengarten",,0.000074,72,3,1,4,36229,36229,72458,20,0.104354,0.118493,5111.166667,0,0
8574278,"Horn, evang. Kirche",,0.00003,71,1,1,2,8153,8153,16306,20,0.115873,0.130091,300,0,0
8574281,"Rorschach, Spital",,0.000023,72,1,1,2,13464,13464,26928,22,0.081918,0.09105,352,0,0
8574283,"Rorschacherberg, Pflegeheim",,0.000033,72,1,1,2,15337,15324,30661,22,0.081918,0.09105,583,0,0
8574286,"Rorschacherberg, Bleichi",,0.000082,72,2,1,3,29856,29856,59712,19,0.107402,0.121139,2864.5,0,0
8574287,"Rorschacherberg, Gemeindehaus",,0.00008,72,1,1,2,29856,29856,59712,18,0.119919,0.137912,2856.5,0,0
8580689,"St. Gallen, Neudorf/R'str.",,0.000155,71,5,9,14,159583,159600,319183,17,0.197715,0.266571,15490.142913,0,0
8574294,"Rheineck, National",,0.000032,72,2,1,3,7786,7786,15572,23,0.074694,0.083552,1790,0,0
8574295,"Rheineck, Asylstrasse",,0.000038,72,1,1,2,7786,7786,15572,22,0.080454,0.089932,1790,0,0
8574296,"Thal, Löwen",,0.000043,72,1,1,2,7786,7325,15111,21,0.087199,0.097632,1788,0,0
8574298,"Thal, Linde",,0.000048,72,1,1,2,7325,7325,14650,20,0.095207,0.107153,1784,0,0
8574299,"Staad SG, Nagelstein",,0.000051,72,1,1,2,7325,7325,14650,19,0.10487,0.119328,1778,0,0
8574300,"Staad SG, Risegg",,0.000055,72,1,1,2,7325,7325,14650,18,0.116759,0.135758,1770,0,0
8574302,"Rorschacherberg, Wilen",,0.000045,72,2,2,4,29763,29763,59526,18,0.11015,0.129988,1269.583333,0,0
8574303,"Rorschacherberg, Bernerhüsli",,0.00003,72,1,1,2,16321,16321,32642,17,0.121667,0.14058,835.166667,0,0
8574305,"Gams, Gamschol",,0.000056,73,3,1,4,8030,8030,16060,35,0.047569,0.057313,1262,0,0
8574306,"Sax, Farnen",,0.000059,73,1,1,2,8030,8030,16060,34,0.049853,0.060611,1780,0,0
8574307,"Sax, Rofisbach",,0.000061,73,1,1,2,8030,8030,16060,33,0.052372,0.064457,2296,0,0
8574308,"Sax, Schlössli",,0.000063,73,1,1,2,8030,8030,16060,32,0.055164,0.069028,2810,0,0
8574309,"Sax, Hueb",,0.000064,73,1,1,2,8030,8030,16060,31,0.058277,0.074606,3322,0,0
8574310,"Frümsen, Stig",,0.000065,73,1,1,2,8030,8030,16060,30,0.061768,0.081703,3832,0,0
8574312,"Frümsen, Frol",,0.000039,73,1,1,2,4002,4002,8004,30,0.061574,0.080454,31,0,0
8574314,"Sennwald, Äugstisriet",,0.00011,73,5,2,7,25027,24560,49587,28,0.06995,0.101553,62721.021429,0,0
8574317,"Grabs, Kohlplatz",,0.000014,73,1,1,2,3428,3428,6856,8,0.1875,0.274603,288,0,0
8574319,"Grabs, Forst",,0.000023,73,1,1,2,3428,3428,6856,7,0.211538,0.297186,275,0,0
8574320,"Grabs, Abzw. Leversberg",,0.00003,73,1,1,2,3428,3428,6856,6,0.243902,0.326667,260,0,0
8574321,"Grabserberg, Winnewies",,0.000037,73,1,1,2,3428,3428,6856,5,0.290323,0.368519,243,0,0
8574322,"Grabserberg, Schluss",,0.000042,73,1,1,2,3428,3428,6856,4,0.363636,0.4375,224,0,0
8574323,"Grabserberg, Boden",,0.000047,73,1,2,3,3428,3428,6856,3,0.5,0.595238,203,0,0
8574326,"Grabserberg, Eggenberg",,0.000024,73,1,1,2,676,676,1352,4,0.384615,0.483333,3,0,0
8574324,"Grabserberg, Lehn",,0.000031,73,1,2,3,2752,2752,5504,4,0.461538,0.597222,90,0,0
8574329,"Grabserberg, Höhi",,0.000054,73,1,2,3,1352,1352,2704,2,0.75,0.833333,37,0,0
8574330,"Grabserberg, Rogghalm",,0.000034,73,1,1,2,676,676,1352,2,0.666667,0.75,0,0,0
8574328,"Grabserberg, Madang",,0.000051,73,2,1,3,1352,1352,2704,3,0.5,0.583333,66,0,0
8574334,"Azmoos, Gatina",,0.000042,73,2,1,3,5818,5818,11636,22,0.07744,0.09318,1660,0,0
8574336,"Oberschan, alte Post",,0.000047,73,1,2,3,5818,5818,11636,21,0.083738,0.104945,2070,0,0
8574410,"Trübbach, Post",,0.000047,73,2,3,5,23415,23343,46758,20,0.090749,0.117639,7577.990033,0,0
8574341,"Schaan, Bierkeller",,0.000017,73,1,1,2,3929,3929,7858,29,0.058333,0.07695,24,0,0
8574351,"Schaanwald, Industrie",,0.000023,73,1,1,2,6162,6162,12324,27,0.063225,0.080719,2206.833333,0,0
8574370,"Ruggell, Kreuzstrasse",,0.000047,73,4,2,6,6125,5980,12105,26,0.067906,0.097613,2801.416667,0,0
8574382,"Gamprin, Bühl",,0.000069,73,3,4,7,5069,5069,10138,26,0.067486,0.102643,2375.5,0,0
8574396,"Triesen, Maschlina",,0.000067,73,2,5,7,9588,10685,20273,21,0.091701,0.129515,57783.346775,0,0
8576755,"Nendeln, Bahnhof",,0.000062,73,1,5,6,5386,5386,10772,7,0.280423,0.363252,1540.922619,0,0
8579677,"Gamprin, Jedergass",,0.000068,73,1,3,4,3485,3558,7043,7,0.27439,0.342804,332,0,0
8579678,"Mauren FL, Fallsgass",,0.000128,73,5,3,8,6736,6736,13472,7,0.285714,0.355605,12099.751325,0,0
8579683,"Gamprin, Michel-Oehri",,0.000049,73,3,2,5,2538,2538,5076,7,0.245902,0.299683,66.5,0,0
8574347,"Eschen, Kohlplatz",,0.000018,73,1,1,2,6736,6700,13436,27,0.06308,0.078924,4850,0,0
8574348,"Mauren FL, Wegacker",,0.000026,73,1,1,2,6700,6736,13436,26,0.067185,0.087127,4869,0,0
8574352,"Schaanwald, Waldstrasse",,0.000045,73,2,1,3,8967,8967,17934,26,0.067348,0.089803,2403.25,0,0
8574360,"Schaan, Duxgass/Kresta",,0.000017,73,1,1,2,767,767,1534,27,0.061892,0.076367,72,0,0
8574361,"Schaan, Kinderheim",,0.000025,73,1,1,2,767,767,1534,26,0.065831,0.083748,505,0,0
8580201,"Triesen, Schule",,0.000102,73,4,2,6,7142,7142,14284,8,0.235294,0.300923,1929.854849,0,0
8574375,"Schellenberg, Widum",,0.000028,73,1,1,2,2135,2135,4270,28,0.059812,0.079287,485,0,0
8574371,"Ruggell, Oberwiler",,0.000031,73,1,1,2,5664,5664,11328,26,0.067199,0.08997,1901,0,0
8574373,"Ruggell, Kirche",,0.000021,73,1,2,3,2531,2531,5062,27,0.063815,0.091281,1020.333333,0,0
8574376,"Schellenberg, Tannwald",,0.000051,73,2,2,4,4673,4673,9346,27,0.063479,0.089514,1892.166667,0,0
8574380,"Schellenberg, Eschner Rütte",,0.000033,73,1,1,2,2538,2538,5076,27,0.063349,0.087521,0,0,0
8574374,"Schellenberg, Loch",,0.00002,73,1,1,2,2135,2135,4270,29,0.056553,0.07233,496,0,0
8574377,"Mauren FL, Krummenacker",,0.000028,73,2,1,3,2268,2268,4536,10,0.164751,0.199049,1002.583333,0,0
8574378,"Mauren FL, Auf Berg",,0.000034,73,1,1,2,2268,2268,4536,9,0.192661,0.232407,584.583333,0,0
8574379,"Schellenberg, Egerta",,0.00004,73,1,2,3,2268,2268,4536,8,0.232955,0.292538,164.583333,0,0
8580200,"Bendern, Widagass",,0.000122,73,6,6,12,9005,9029,18034,6,0.316547,0.410985,14983.062767,0,0
8580206,"Gamprin, Waldeck",,0.000049,73,2,1,3,2526,2538,5064,8,0.224044,0.264082,6,0,0
8580207,Hinterschellenberg,,0.000102,73,4,3,7,3928,3928,7856,7,0.28169,0.351071,5545.197619,0,0
8580490,"Eschen, Haldengasse",,0.000091,73,3,3,6,6621,6583,13204,6,0.316667,0.382018,2659.098395,0,0
8574384,"Buchs SG, Rheinau",,0.000018,73,1,1,2,5755,5755,11510,27,0.061849,0.076529,13390.247161,0,0
8574385,"Schaan, Rheindenkmal",,0.000026,73,1,1,2,5755,5755,11510,26,0.065782,0.084041,13514.247161,0,0
8581000,"Vaduz, Städtle",,0.00015,73,5,6,11,8692,8370,17062,6,0.392857,0.540909,2497.736799,0,0
8574388,"Schaan, Laurentiusbad",,0.000034,73,1,1,2,6718,6718,13436,27,0.06193,0.079214,1450,0,0
8574389,"Vaduz, Hofkellerei",,0.000039,73,1,1,2,6718,6718,13436,26,0.065871,0.088113,1413,0,0
8579680,"Schaan, Theater",,0.000085,73,2,4,6,4503,3667,8170,8,0.25,0.354443,1863.5956,0,0
8580529,"Schaan, Ivoclar",,0.000112,73,3,3,6,7181,6588,13769,7,0.308642,0.408381,560.612681,0,0
8580602,"Triesen, Messina",,0.000128,73,5,3,8,10658,10422,21080,7,0.311688,0.418452,2584.290736,0,0
8580811,"Schaan, Rosengarten",,0.000047,73,1,1,2,3134,3134,6268,7,0.291139,0.356936,0,0,0
8574393,"Vaduz, Au",,0.000084,73,3,2,5,15402,14137,29539,23,0.078238,0.099555,63286.888889,0,0
8574399,"Triesen, Gartnetschhof",,0.00002,73,1,1,2,6100,6100,12200,21,0.087423,0.105492,492,0,0
8574407,"Balzers, Rheinstrasse",,0.000082,73,2,1,3,6970,6399,13369,21,0.088266,0.11078,2080,0,0
8574403,"Balzers, Alter Pfarrhof",,0.000074,73,3,1,4,9186,9186,18372,23,0.075635,0.090604,2452,0,0
8574404,"Balzers, Höfle",,0.000073,73,1,2,3,9186,9186,18372,22,0.081629,0.101389,2362,0,0
8574406,"Balzers, Brückle",,0.000047,73,1,1,2,7791,5575,13366,22,0.081287,0.098278,417,0,0
8574405,"Balzers, Mälsnerdorf",,0.000042,73,1,1,2,7791,7791,15582,23,0.075342,0.089044,511,0,0
8574425,"Eschen, Sportpark",,0.00012,73,8,2,10,5844,5960,11804,8,0.235808,0.287875,3143.528706,0,0
8574411,"Sargans, Vild",,0.000024,73,1,1,2,17349,17349,34698,19,0.092948,0.108731,2876,0,0
8574414,"Triesenberg, Samina",,0.000026,73,1,2,3,1114,1114,2228,4,0.461538,0.597222,120,0,0
8574416,"Gaflei, Matu",,0.000029,73,1,1,2,860,860,1720,4,0.4,0.520833,4,0,0
8574415,"Masescha, Foppa",,0.000022,73,1,1,2,860,860,1720,5,0.333333,0.456667,21,0,0
8574417,"Vaduz, Schwefel",,0.000058,73,2,1,3,4949,4949,9898,15,0.103512,0.138525,7365,0,0
8574418,"Triesen, Meierhof",,0.00006,73,1,1,2,4949,4949,9898,14,0.113402,0.152736,6929,0,0
8574419,"Triesen, Matschils",,0.000062,73,1,2,3,4949,4949,9898,13,0.125581,0.177796,6491,0,0
8574420,"Triesenberg, Täscherloch",,0.000037,73,1,1,2,3907,3907,7814,8,0.222222,0.339732,3952,0,0
8574421,"Triesenberg, Rütelti",,0.000043,73,1,1,2,3907,3907,7814,7,0.25,0.370408,3465,0,0
8574422,"Triesenberg, Obergufer",,0.000047,73,1,1,2,3907,3907,7814,6,0.285714,0.408333,2976,0,0
8574423,"Triesenberg, Steinort",,0.000051,73,1,1,2,3907,3907,7814,5,0.333333,0.456667,2485,0,0
8574424,"Triesenberg, Guferwald",,0.000054,73,1,1,2,3907,1691,5598,4,0.4,0.520833,1992,0,0
8574426,"Triesen, Feldstrasse",,0.000037,73,1,1,2,1042,1042,2084,12,0.129412,0.162917,1605,0,0
8574427,"Triesen, Vanetscha",,0.000043,73,1,1,2,1042,1042,2084,11,0.14527,0.179311,1154,0,0
8574428,"Triesen, Langgasse",,0.000047,73,1,1,2,1042,1042,2084,10,0.166008,0.202183,701,0,0
8574429,"Triesen, Poska",,0.000051,73,1,1,2,1042,1042,2084,9,0.194313,0.23706,246,0,0
8574480,"Lachen SZ, Spreite",,0.000046,67,1,2,3,5603,6089,11692,2,0.666667,0.75,18,0,0
8574485,"Reichenburg, Bahnhof",,0.00006,67,1,1,2,10240,7789,18029,3,0.5,0.583333,16,0,0
8581712,"Lachen SZ, Schlössliweg",,0.000053,67,1,1,2,7612,7246,14858,3,0.5,0.583333,8,0,0
8574434,"Wangen SZ, Lochgasse",,0.00006,67,3,1,4,8818,8818,17636,17,0.134188,0.155193,8380,0,0
8574435,"Tuggen, Rüschenzopf",,0.000062,67,1,1,2,8818,8412,17230,16,0.153998,0.182175,8481,0,0
8574446,"Grub AR, Ebne Grub",,0.000054,71,4,2,6,10948,11071,22019,25,0.079185,0.092279,2919.416667,0,0
8574447,Grub SG,,0.000034,71,1,1,2,6368,6368,12736,25,0.078947,0.089313,0,0,0
8574448,"Grub AR, Halten",,0.000063,71,2,1,3,11071,11071,22142,24,0.085434,0.097424,2861.416667,0,0
8574450,"Rehetobel, Säntis",,0.000073,71,4,1,5,8648,8689,17337,26,0.07205,0.08156,2476.5,0,0
8574451,"Eggersriet, Wiesen",,0.000038,71,1,1,2,10991,10991,21982,22,0.099561,0.111286,2385.416667,0,0
8574452,"Rehetobel, Schulhaus",,0.000073,71,1,1,2,8689,8689,17378,25,0.077384,0.08774,2435.5,0,0
8574453,"Eggersriet, Tannacker",,0.000043,71,1,1,2,10991,10991,21982,21,0.110195,0.12423,2341.416667,0,0
8574455,"Rehetobel, Sonder",,0.000073,71,1,1,2,8689,8689,17378,24,0.083592,0.095313,2392.5,0,0
8574457,"Rehetobel, Midegg",,0.000073,71,1,1,2,8689,8689,17378,23,0.090909,0.105016,2347.5,0,0
8574461,"Rehetobel, Hörnlirank",,0.000042,71,1,1,2,8609,8609,17218,21,0.104159,0.115861,1804.083333,0,0
8574465,"St. Gallen, Grossacker",,0.000172,71,7,2,9,138957,141841,280798,18,0.149716,0.177726,6782.083333,0,0
8574466,"Speicherschwendi, Bären",,0.000084,71,1,1,2,8609,8609,17218,18,0.149277,0.174881,0,0,0
8580688,"St. Gallen, Remishueb / Klinik",,0.000069,71,1,1,2,9113,9113,18226,18,0.165689,0.201228,452,0,0
8574463,Zweibrücken (Rehetobel),,0.000046,71,1,1,2,8609,8608,17217,20,0.115873,0.130091,1753.083333,0,0
8580686,"Mörschwil, Riederen",,0.000058,71,2,1,3,900,900,1800,20,0.125344,0.14268,122,0,0
8580682,"Rorschach, Bodan",,0.000064,72,4,2,6,36202,36229,72431,15,0.174699,0.293157,1468.166667,0,0
8580685,"Goldach, TZM/Kellen",,0.000043,72,1,1,2,15337,15337,30674,15,0.165644,0.259317,27,0,0
8580693,"Rorschacherberg, Rosenacker",,0.000052,72,1,1,2,14300,14300,28600,15,0.165644,0.259317,525.166667,0,0
8580866,"Tübach, Schulstrasse",,0.000033,71,1,3,4,8217,8217,16434,13,0.16625,0.207101,2168.5,0,0
8581777,"Abtwil SG, Wiesenbach/Cinedome",,0.000056,71,2,2,4,82368,82774,165142,13,0.166667,0.204095,412.51767,0,0
8582227,"St. Gallen, Arena",,0.000083,71,5,3,8,64574,64328,128902,12,0.185072,0.229822,7718.923618,0,0
8582243,"Gossau SG, Bruggwis",,0.000034,71,1,1,2,39524,39527,79051,13,0.165289,0.198029,0,0,0
8588499,"Gossau SG, Schoretshuebstr.",,0.000078,71,3,3,6,48335,48326,96661,13,0.168016,0.210002,5493.793656,0,0
8588500,"St. Gallen, Russen",,0.000063,71,3,3,6,114720,114728,229448,12,0.187927,0.232083,4630.083307,0,0
8589550,"St. Gallen, Aetschberg",,0.000039,71,2,2,4,41673,41744,83417,13,0.175862,0.212338,1490.087387,0,0
8589597,"St. Gallen, Lindenstrasse",,0.000081,71,3,4,7,61495,61495,122990,12,0.206693,0.270613,691.858396,0,0
8589604,"St. Gallen, Oberstrasse",,0.000138,71,7,6,13,141731,141731,283462,12,0.20911,0.28551,5999.781558,0,0
8589608,"St. Gallen, Post St. Georgen",,0.000046,71,2,2,4,44810,44814,89624,12,0.187146,0.231121,193.25,0,0
8576150,"Wald AR, Hopsbermoos",,0.000089,71,4,3,7,6085,6103,12188,16,0.108623,0.132796,2305.191877,0,0
8578561,"Ermenswil, Hirschen",,0.000091,67,2,2,4,18006,16965,34971,8,0.271186,0.385491,779.033333,0,0
8578565,"Rüti ZH, Löwen",,0.000052,67,2,2,4,17764,10107,27871,6,0.342857,0.454167,741.033333,0,0
8578504,"Atzmännig, Atzmännigstrasse",,0.000041,67,2,1,3,5903,5903,11806,3,0.454545,0.533333,54.783333,0,0
8583055,"Schmerikon, Seeblick",,0.000083,67,3,2,5,6300,3063,9363,1,1,1,372.133333,0,0
8574475,"Wolfhalden, Falken",,0.000077,72,5,1,6,2608,2523,5131,3,0.5,0.611111,201,0,0
8574476,"Wolfhalden, Hinteregg",,0.000076,72,1,1,2,2523,2523,5046,2,0.666667,0.75,136,0,0
8574478,"Lachen SZ, Bahnhof",,0.000082,67,3,2,5,13717,13231,26948,3,0.470588,0.5625,234,0,0
8581892,"Wangen SZ, alte Post",,0.000192,67,6,2,8,22379,6315,28694,2,0.75,0.833333,480,0,0
8574481,"Reichenburg, Altersheim",,0.000049,67,2,1,3,10240,10240,20480,7,0.235294,0.34494,624,0,0
8574482,"Reichenburg, Dorf",,0.000053,67,1,1,2,10240,10240,20480,6,0.269231,0.378571,475,0,0
8574483,"Reichenburg, Kreuzwies",,0.000056,67,1,1,2,10240,10240,20480,5,0.315789,0.422222,324,0,0
8574484,"Reichenburg, Allmeind",,0.000058,67,1,1,2,10240,10240,20480,4,0.384615,0.483333,171,0,0
8574487,"Grüsch, Bahnhof",,0.000042,75,2,1,3,1467,1493,2960,6,0.285714,0.408333,24,0,0
8574593,"Summaprada, Abzw. Hotel Reich",,0.000103,109,2,2,4,3300,3388,6688,27,0.103803,0.129313,3018,0,0
8574494,"Chur, St. Antönierrank",,0.000035,109,1,1,2,3474,3693,7167,31,0.079444,0.091795,500,0,0
8574495,"Chur, Araschgerrank",,0.000041,109,1,1,2,3693,3693,7386,30,0.086084,0.100797,849,0,0
8574659,"Lenzerheide/Lai, Gravas",,0.000025,131,1,1,2,2001,2001,4002,6,0.285714,0.408333,0,0,0
8574517,"Scheid, Resgia",,0.000011,111,0,1,1,0,1585,1585,10,0.194805,0.275265,0,0,0
8574518,Oberscheid,,0.00002,111,1,1,2,1585,1585,3170,9,0.225806,0.317545,14,0,0
8574524,"Tumegl/Tomils, Rofna",,0.000028,111,1,2,3,1585,1694,3279,8,0.270833,0.407784,26,0,0
8574529,"Trans, Dorf",,0.000042,111,1,1,2,780,820,1600,8,0.236842,0.35754,27,0,0
8574526,"Trans, Vegs",,0.000023,111,1,1,2,820,946,1766,11,0.169014,0.268323,9,0,0
8574527,"Trans, Acla",,0.00003,111,1,1,2,946,946,1892,10,0.186441,0.288997,17,0,0
8574528,"Trans, Ramons",,0.000037,111,1,1,2,946,780,1726,9,0.208333,0.31623,23,0,0
8574530,Obermutten,,0.000011,109,0,1,1,0,670,670,28,0.091309,0.10845,0,0,0
8574531,"Sils im Domleschg, Campi",,0.00002,109,1,1,2,670,1245,1915,27,0.100242,0.12304,414,0,0
8574534,"Mutten, Stafel",,0.000019,109,1,1,2,670,670,1340,28,0.099253,0.120148,0,0,0
8574554,"Rothenbrunnen, Dorf",,0.000035,109,1,1,2,86,86,172,28,0.099253,0.120148,8647.666667,0,0
8574540,"Guarda, staziun",,0.00002,138,1,1,2,2355,4697,7052,1,1,1,1,0,0
8574543,"Pratval, Rietberg",,0.000013,109,1,1,2,1544,1544,3088,29,0.086728,0.101154,4,0,0
8574544,Almens,,0.000022,109,1,1,2,1544,1544,3088,28,0.094724,0.112771,397,0,0
8574549,"Tumegl/Tomils, Curschiglias",,0.000059,111,2,2,4,1694,1680,3374,7,0.275862,0.449107,56,0,0
8577111,"Scheid, Giudem vitg",,0.000036,111,1,1,2,1571,1585,3156,7,0.25,0.370408,0,0,0
8574558,"Valens, Klinik",,0.00008,109,4,2,6,6154,6229,12383,32,0.069862,0.094078,2106.666667,0,0
8574571,"Pfäfers, Klinik",,0.000045,109,1,2,3,4540,4227,8767,32,0.069592,0.092249,18,0,0
8574575,"Gigerwald, Restaurant",,0.00003,109,1,1,2,382,382,764,32,0.069301,0.088142,0,0,0
8574560,"St. Margrethenberg, Tristeli",,0.000044,109,2,1,3,2517,2498,5015,2,0.666667,0.75,25,0,0
8579694,"Malans, Valära",,0.000052,109,2,2,4,6542,6546,13088,30,0.078324,0.098512,6121.433333,0,0
8579820,"Malans, Bahnhof",,0.000047,109,2,3,5,6497,6330,12827,29,0.084552,0.108947,5770.2,0,0
8574567,"Malans, Karlihof",,0.000028,109,1,1,2,6468,6476,12944,19,0.110026,0.130667,14,0,0
8574708,"Untervaz, Giesacker",,0.000039,109,4,3,7,11724,11724,23448,24,0.142487,0.192852,1540.4,0,0
8575119,"Schiers, Bahnhof",,0.000212,112,8,7,15,9434,9479,18913,24,0.132194,0.192453,28257.55,0,0
8575114,"Bad Ragaz, Bahnhof",,0.000101,109,4,3,7,10738,11047,21785,31,0.074124,0.100228,6028.666667,0,0
8574577,"Sils i. D., Cumparduns",,0.000038,109,1,1,2,86,86,172,30,0.080014,0.094217,402,0,0
8574578,"Scharans, St. Agatha",,0.000043,109,1,1,2,86,86,172,29,0.086603,0.102734,580,0,0
8574581,"Fürstenau, Fürstenaubruck",,0.000048,109,1,1,2,86,86,172,28,0.094408,0.113702,756,0,0
8574592,"Präz, Dorf",,0.00006,109,1,1,2,3215,3214,6429,28,0.094408,0.113702,1864,0,0
8574584,"Tartar, Hof Foppa",,0.000028,109,1,1,2,3288,3288,6576,32,0.069985,0.084392,478,0,0
8574586,"Tartar, Dorf",,0.000035,109,1,2,3,3288,3288,6576,31,0.074937,0.092889,714,0,0
8574588,"Sarn, Abzw. Lescha",,0.000026,109,1,2,3,3132,3064,6196,31,0.074669,0.091171,4,0,0
8574589,"Sarn, Lescha",,0.000022,109,1,1,2,2401,2328,4729,31,0.074378,0.08732,0,0,0
8574587,"Zweidlen, Zweidlergraben",,0.00002,83,1,1,2,6179,6803,12982,4,0.368421,0.452381,7,0,0
8574590,"Präz, Dalin",,0.000055,109,3,1,4,3147,3229,6376,30,0.080014,0.094217,1410,0,0
8574591,"Präz, Curscheglias",,0.000058,109,1,1,2,3229,3215,6444,29,0.086603,0.102734,1638,0,0
8574594,"Summaprada, Schauenberg",,0.000054,109,1,1,2,3302,3288,6590,28,0.094461,0.115646,469.5,0,0
8574595,"Tartar, Sorts",,0.000057,109,1,1,2,3288,3288,6576,27,0.103841,0.130825,619.5,0,0
8574598,"Versam, Grosshus",,0.00002,110,1,2,3,2491,2491,4982,5,0.324675,0.378,25,0,0
8575120,"Ilanz, Bahnhof/Post",,0.00024,110,12,11,23,19989,16877,36866,3,0.655172,0.77193,956.833333,0,0
8574610,"Uitikon, Wängi",,0.000022,85,1,1,2,2767,2723,5490,22,0.094477,0.102534,954,0.000054,0
8574821,"Mels, Huob",,0.000049,73,3,1,4,21647,21647,43294,28,0.099396,0.121995,1035.376374,0,0
8581003,"Triesen, Argweg",,0.000032,73,1,2,3,5782,6100,11882,3,0.545455,0.638889,567,0,0
8581152,"Balzers, Sportplatz",,0.000025,73,1,1,2,3477,3477,6954,3,0.5,0.566667,0,0,0
8574615,"Uitikon, Gläseren",,0.000029,85,1,1,2,2723,2760,5483,21,0.104185,0.11418,1338,0,0
8574617,"Wangs, Parkhotel",,0.000019,73,1,1,2,15366,15366,30732,29,0.087846,0.101996,2152,0,0
8574618,"Wangs, Sternen",,0.000027,73,1,1,2,15366,15366,30732,28,0.09589,0.112024,1845,0,0
8574619,"Wangs, Pizolbahn",,0.000034,73,1,1,2,15366,15366,30732,27,0.105601,0.124851,1536,0,0
8574622,"Vilters, Oberdorf",,0.00004,73,1,1,2,15366,15366,30732,26,0.117556,0.141978,1225,0,0
8574624,"Vilters, Härtistrasse",,0.000045,73,1,1,2,15366,15366,30732,25,0.132635,0.166461,912,0,0
8579698,"Sargans, Markthalle",,0.000046,73,2,2,4,17349,17349,34698,24,0.151798,0.200259,41476.468861,0,0
8579884,"Mels, Feldackerstrasse",,0.000053,73,2,2,4,14754,14754,29508,25,0.134371,0.172689,36480.912883,0,0
8579885,"Mels, Bahnhof",,0.000053,73,2,2,4,14761,14761,29522,25,0.134182,0.172571,20131.706441,0,0
8574635,Brail,,0.000021,30,1,1,2,2458,2458,4916,8,0.197531,0.279464,160,0,0
8574636,Prazet,,0.000029,30,1,2,3,2458,2088,4546,7,0.230769,0.345714,165,0,0
8582204,"Zernez, scoula",,0.000023,30,1,1,2,984,847,1831,7,0.21875,0.29898,0,0,0
8587890,"S-chanf, Chesa cumünela",,0.000051,30,1,2,3,9099,9099,18198,6,0.269231,0.378571,256.5,0,0
8574637,Laschadura,,0.000021,30,1,1,2,3285,3285,6570,13,0.124031,0.213582,58,0,0
8574638,Ova Spin,,0.000029,30,1,1,2,3285,3285,6570,12,0.132743,0.224052,63,0,0
8574639,Champlönch P1,,0.000035,30,1,1,2,3285,3285,6570,11,0.142857,0.235835,66,0,0
8574640,Vallun Chafuol P3,,0.000041,30,1,1,2,3285,3285,6570,10,0.154762,0.249237,67,0,0
8574641,Stabelchod P8,,0.000046,30,1,1,2,3285,3285,6570,9,0.169014,0.264683,66,0,0
8574644,"Tschierv, Biosfera",,0.000065,30,2,1,3,3371,3371,6742,7,0.208333,0.304524,85,0,0
8574646,"Fuldera, Daint",,0.000066,30,1,1,2,3371,3371,6742,6,0.236842,0.331481,78,0,0
8574648,"Sta. Maria Val Müstair, scoula",,0.00008,30,2,1,3,3490,3490,6980,4,0.333333,0.416667,103,0,0
8574649,"Sta. Maria Val Müstair, Sielva",,0.000079,30,1,1,2,3490,3490,6980,3,0.428571,0.5,90,0,0
8574658,"Uitikon, Roracher",,0.000036,85,1,1,2,2760,2759,5519,20,0.116137,0.129211,1720,0,0
8574660,"Lenzerheide/Lai, Resgia",,0.000046,131,2,1,3,4003,4005,8008,5,0.333333,0.456667,55,0,0
8574661,"Lenzerheide/Lai, Neuhof",,0.00005,131,1,1,2,4005,4005,8010,4,0.4,0.520833,48,0,0
8574662,"Vaz/Obervaz, Lain",,0.000053,131,1,1,2,4005,4005,8010,3,0.5,0.611111,39,0,0
8574663,"Vaz/Obervaz, Tranter Moira",,0.000056,131,1,1,2,4005,4005,8010,2,0.666667,0.75,28,0,0
8574664,"Vaz/Obervaz, Muldain",,0.000059,131,1,1,2,4005,4005,8010,1,1,1,15,0,0
8574666,"Chur, Brambrüeschbahn",,0.000079,109,2,1,3,45217,45220,90437,26,0.106195,0.127622,2863.433333,0,0
8574667,"Chur, Kaserne/Kornquader",,0.000078,109,1,1,2,45220,45219,90439,25,0.118291,0.146095,3021.433333,0,0
8581896,"Chur, Giacomettistrasse",,0.000046,109,4,4,8,22081,21662,43743,3,0.583333,0.738095,12,0,0
8574671,"Domat/Ems, Plarenga",,0.000034,109,1,1,2,16303,16304,32607,29,0.085408,0.100534,455,0,0
8574672,"Domat/Ems, Unterdorf",,0.00004,109,1,1,2,16304,16305,32609,28,0.092965,0.110226,603,0,0
8574673,"Domat/Ems, Post",,0.000044,109,1,1,2,16305,16303,32608,27,0.102031,0.122613,749,0,0
8574674,"Domat/Ems, Tuma Platta",,0.000049,109,1,1,2,16303,16294,32597,26,0.113111,0.139129,893,0,0
8574675,"Domat/Ems, Padrusa",,0.000052,109,1,1,2,16294,16301,32595,25,0.126957,0.162627,1035,0,0
8580450,"Sils im Domleschg, Oberdorf",,0.000067,109,2,2,4,1331,1331,2662,24,0.139001,0.185632,62944,0,0
8574680,"Flims Dorf, Bergbahnen",,0.000034,110,2,1,3,658,768,1426,12,0.139842,0.169184,74,0,0
8574681,"Flims Waldhaus, Promenada",,0.00004,110,1,1,2,768,768,1536,11,0.159509,0.191087,118,0,0
8574682,"Flims Waldhaus, Camping",,0.000044,110,1,1,2,768,768,1536,10,0.186131,0.223965,160,0,0
8579811,"Sagogn, Storta pintga",,0.000029,110,1,3,4,4175,4175,8350,2,0.666667,0.75,0,0,0
8574694,"Chur, Rigahaus",,0.000103,109,10,1,11,38985,40353,79338,16,0.099319,0.108904,85470.064103,0,0
8574695,"Chur, Kreuzgasse",,0.000099,109,1,1,2,40353,40537,80890,15,0.109928,0.121154,84415.064103,0,0
8574696,"Chur, Weinbergstrasse",,0.000095,109,1,1,2,40537,40060,80597,14,0.123118,0.137128,83358.064103,0,0
8574697,"Chur, Heiligkreuz",,0.000092,109,1,1,2,40060,40341,80401,13,0.139965,0.159012,82299.064103,0,0
8574698,"Chur, Weisstorkel",,0.000089,109,1,1,2,40341,40453,80794,12,0.162231,0.191441,81238.064103,0,0
8579697,"Weite, Lonna/Heuwiese",,0.000027,73,1,1,2,17320,17320,34640,25,0.132293,0.163842,18459.435528,0,0
8574700,"Chur, Oldtimer",,0.000023,109,1,1,2,17346,17041,34387,13,0.154301,0.183857,4116,0,0
8574704,"Trimmis, Gargällis",,0.000049,109,1,1,2,17495,17495,34990,12,0.160978,0.191534,65779.333333,0,0
8577226,"Landquart, Ringstrasse",,0.000087,109,6,3,9,16667,16668,33335,25,0.126736,0.169642,25332.233333,0,0
8574702,"Trimmis, Churweg",,0.00004,109,5,1,6,17440,17496,34936,14,0.122475,0.137273,67979.333333,0,0
8574703,"Trimmis, Saliet",,0.000045,109,1,1,2,17496,17495,34991,13,0.139079,0.159064,66880.333333,0,0
8579817,"Landquart, Im Lux",,0.00005,109,2,3,5,2436,2436,4872,25,0.124928,0.164841,9623.4,0,0
8580198,"Untervaz, Gaidla",,0.000043,109,3,2,5,8493,7576,16069,24,0.138925,0.183238,6444.5,0,0
8574724,"Ferrera, Schmelzi",,0.000044,109,1,1,2,2118,2118,4236,15,0.116438,0.20424,266,0,0
8574725,"Ferrera, Punt Martegn",,0.000048,109,1,1,2,2118,2118,4236,14,0.124031,0.213639,260,0,0
8574726,"Avers, Abzw. Valle di Lei",,0.000052,109,1,1,2,2118,2118,4236,13,0.132743,0.22413,252,0,0
8574727,"Avers, Campsut",,0.000055,109,1,1,2,2118,2118,4236,12,0.142857,0.235944,242,0,0
8574728,"Avers, Cröt",,0.000057,109,1,1,2,2118,2118,4236,11,0.154762,0.249392,230,0,0
8574729,"Avers, Lezibrücke",,0.00006,109,1,1,2,2118,2118,4236,10,0.169014,0.264914,216,0,0
8574730,"Avers, Pürt",,0.000062,109,1,1,2,2118,2118,4236,9,0.186441,0.283153,200,0,0
8574731,"Avers, Am Bach",,0.000063,109,1,1,2,2118,2118,4236,8,0.208333,0.305119,182,0,0
8574732,"Avers, Juppa",,0.000065,109,1,1,2,2118,2118,4236,7,0.236842,0.33254,162,0,0
8574733,"Avers, Rufana",,0.000066,109,1,1,2,2118,2118,4236,6,0.275862,0.36875,140,0,0
8574734,"Avers, Podestats Haus",,0.000067,109,1,1,2,2118,2118,4236,5,0.333333,0.421429,116,0,0
8574737,"Strada i. E., San Niclà",,0.000028,74,1,1,2,3174,1588,4762,1,1,1,2,0,0
8574741,"Valzeina, Geissgaden",,0.000047,75,1,1,2,1493,1414,2907,5,0.333333,0.456667,25,0,0
8574742,"Valzeina, Ammengaden",,0.000051,75,1,1,2,1414,1493,2907,4,0.4,0.520833,24,0,0
8574743,"Valzeina, Boden",,0.000054,75,1,1,2,1493,1493,2986,3,0.5,0.611111,21,0,0
8574744,"Valzeina, Engisch Gada",,0.000057,75,1,1,2,1493,1386,2879,2,0.666667,0.75,16,0,0
8574749,"Fajauna, Bodenrank",,0.00002,112,1,1,2,1963,1962,3925,30,0.076063,0.089685,245,0,0
8574750,"Stels, Prodavos",,0.000028,112,1,1,2,1962,1963,3925,29,0.081989,0.097242,488,0,0
8574751,"Fajauna, alte Post",,0.000035,112,1,1,2,1963,1961,3924,28,0.088946,0.106674,729,0,0
8574752,"Stels, Hof de Planis",,0.00004,112,1,1,2,1961,1963,3924,27,0.097228,0.118901,968,0,0
8574753,"Stels, Mottis",,0.000045,112,1,1,2,1963,1963,3926,26,0.107254,0.135733,1205,0,0
8574758,"Schiers, Unterpusserein",,0.00006,112,3,3,6,2397,2397,4794,25,0.118474,0.161465,965,0,0
8574759,"Schuders, Dorf",,0.000028,112,1,3,4,1043,979,2022,25,0.11809,0.160025,6,0,0
8574761,"Schiers, Molla",,0.000049,112,2,1,3,1478,1486,2964,25,0.117203,0.152815,233,0,0
8575078,"Pragg, Unterjarella",,0.000067,112,1,1,2,1804,1561,3365,25,0.117203,0.152815,1631,0,0
8575081,"Küblis, Bahnhof",,0.000113,112,5,4,9,10326,13938,24264,15,0.14184,0.192038,32854.7,0,0
8575116,"Davos Platz, Bahnhof",,0.000115,131,5,7,12,40683,40972,81655,14,0.152605,0.21044,21700.533333,0,0
8574755,"Schiers, Montagna",,0.000041,112,2,2,4,1111,2354,3465,26,0.107079,0.139868,281,0,0
8574756,"Schiers, Maria",,0.000028,112,1,2,3,1443,1445,2888,26,0.106726,0.138355,9,0,0
8574757,"Schiers, Pusserein",,0.000023,112,1,1,2,1257,1298,2555,26,0.106326,0.134719,0,0,0
8574760,"Schiers, Bazolis",,0.000036,112,2,1,3,1271,1298,2569,26,0.105311,0.130748,6,0,0
8574768,"Flumserberg Saxli, Stegen",,0.00003,124,1,1,2,502,502,1004,15,0.109375,0.164324,46,0,0
8574769,"Flumserberg Saxli, Hof",,0.000037,124,1,1,2,502,502,1004,14,0.118421,0.173337,69,0,0
8574770,"Flumserberg Saxli, Mutten",,0.000042,124,1,1,2,502,502,1004,13,0.129353,0.184358,90,0,0
8574771,"Flumserberg Saxli, Rutz",,0.000047,124,1,1,2,502,502,1004,12,0.142857,0.198352,109,0,0
8574772,"Flumserberg Portels, Höfli",,0.000051,124,1,1,2,502,502,1004,11,0.16,0.217082,126,0,0
8574773,"Flumserberg Portels, Richtersr",,0.000054,124,1,1,2,502,502,1004,10,0.18254,0.244186,141,0,0
8578567,"Walenstadt, Bahnhof",,0.00004,124,2,3,5,11326,30495,41821,8,0.26087,0.406151,114,0,0
8574777,"Flums, Rathaus",,0.000031,124,1,1,2,1004,318,1322,1,1,1,12,0,0
8574780,"Ringlikon, Dorf",,0.000043,22,1,1,2,2768,2768,5536,15,0.114541,0.121993,1439.200577,0.002825,0
8574796,"Poschiavo, Stazione",,0.000011,76,0,1,1,0,287,287,9,0.2,0.31433,0,0,0
8574797,"S. Carlo (Poschiavo), Austrini",,0.00002,76,1,1,2,287,287,574,8,0.222222,0.339732,8,0,0
8574798,"S. Carlo (Poschiavo), Fermata",,0.000028,76,1,1,2,287,287,574,7,0.25,0.370408,14,0,0
8574801,"Percosta, Val dal Teo",,0.000035,76,1,1,2,287,287,574,6,0.285714,0.408333,18,0,0
8574802,"Pozzulasc, Fermata",,0.00004,76,1,1,2,287,287,574,5,0.333333,0.456667,20,0,0
8574803,"Sfazù, Fermata",,0.000045,76,1,1,2,287,287,574,4,0.4,0.520833,20,0,0
8574805,La Rösa,,0.000049,76,1,1,2,287,287,574,3,0.5,0.611111,18,0,0
8574806,"Li Mason, Fermata",,0.000053,76,1,1,2,287,287,574,2,0.666667,0.75,14,0,0
8574807,"La Motta, Dogana",,0.000056,76,1,1,2,287,287,574,1,1,1,8,0,0
8574814,"Donat, vischnànca",,0.000026,109,2,2,4,2600,2599,5199,6,0.309524,0.415385,191.7,0,0
8574818,"Lohn GR, spv. Lohn",,0.000042,109,1,2,3,2542,2034,4576,5,0.375,0.494444,83,0,0
8574820,"Wergenstein, Lavanos",,0.000035,109,1,1,2,2541,2551,5092,5,0.333333,0.421429,7,0,0
8574815,"Donat, Pazen",,0.000022,109,1,1,2,2542,2542,5084,8,0.210526,0.291766,140,0,0
8574816,"Donat, Farden",,0.00003,109,1,1,2,2542,2542,5084,7,0.244444,0.325108,123,0,0
8574817,"Lohn GR, Val Vins",,0.000036,109,1,1,2,2542,2542,5084,6,0.294118,0.378333,104,0,0
8574819,"Lohn GR, Dorf",,0.000029,109,1,1,2,1870,2541,4411,6,0.275862,0.36875,32,0,0
8574822,"Mels, Post",,0.000065,73,2,4,6,28496,28496,56992,27,0.10992,0.143836,62987.119324,0,0
8579881,"Heiligkreuz (Mels), Staatsstr.",,0.000032,73,1,1,2,7912,7912,15824,27,0.107029,0.128426,236,0,0
8579882,"Mels, Altersheim",,0.000052,73,2,2,4,14754,14754,29508,26,0.11935,0.148779,18577.706441,0,0
8574823,"Mels, Steigs",,0.000025,73,1,1,2,6893,6893,13786,7,0.25,0.370408,3780,0,0
8574824,"Mels, Schurs",,0.000032,73,1,1,2,6893,6893,13786,6,0.285714,0.408333,3246,0,0
8574825,"Schwendi i. W., Mühleboden",,0.000038,73,1,1,2,6893,6893,13786,5,0.333333,0.456667,2710,0,0
8574827,"Schwendi i. W., Tschudi",,0.000043,73,1,1,2,6893,6893,13786,4,0.4,0.520833,2172,0,0
8574828,"Weisstannen, Holzbrücke",,0.000048,73,1,1,2,6893,6893,13786,3,0.5,0.611111,1632,0,0
8574829,"Weisstannen, Gemse",,0.000051,73,1,1,2,6893,6893,13786,2,0.666667,0.75,1090,0,0
8574831,"Davos Platz, Crestannes",,0.000037,131,2,1,3,17956,17657,35613,21,0.079641,0.091161,154,0,0
8574832,"Davos Platz, Islen",,0.000042,131,1,1,2,17657,17657,35314,20,0.086237,0.099339,435,0,0
8574833,"Davos Frauenkirch, Gadenstatt",,0.000047,131,1,1,2,17657,17657,35314,19,0.094053,0.109617,714,0,0
8574834,"Davos Glaris, ARA",,0.000051,131,1,1,2,17657,17903,35560,18,0.103461,0.123058,991,0,0
8574835,"Davos Glaris, Bahnhof",,0.000054,131,1,1,2,17903,17903,35806,17,0.115002,0.141773,1266,0,0
8574837,"Davos Glaris, EW",,0.000035,131,1,1,2,3623,3623,7246,23,0.065874,0.075486,136,0,0
8574838,"Davos Glaris, Ardüsch",,0.000041,131,1,1,2,3623,3623,7246,22,0.070243,0.080175,373,0,0
8574839,"Davos Monstein, Schmelzboden",,0.000045,131,1,1,2,3623,3623,7246,21,0.075253,0.08567,608,0,0
8574840,"Davos Wiesen, Valldanna",,0.00005,131,1,1,2,3623,3623,7246,20,0.081055,0.092209,841,0,0
8574841,"Davos Wiesen, Schluocht",,0.000053,131,1,1,2,3623,3623,7246,19,0.087854,0.100141,1072,0,0
8574842,"Schmitten (Albula), Innerdorf",,0.000056,131,1,1,2,3623,3623,7246,18,0.095932,0.110004,1301,0,0
8574844,"Alvaneu Dorf, Crappa Naira",,0.000058,131,1,1,2,3623,3623,7246,17,0.105688,0.122693,1528,0,0
8574845,"Brienz/Brinzauls, Belfort",,0.000061,131,1,1,2,3623,3623,7246,16,0.117703,0.139853,1753,0,0
8575063,"Schiers, Schälleria",,0.000042,112,4,1,5,2613,2584,5197,17,0.113294,0.137714,903.933333,0,0
8574849,"Davos Dorf, Stilli",,0.000019,131,1,2,3,14637,14709,29346,15,0.133658,0.169783,1710,0,0
8574851,"Susch, staziun",,0.000027,131,1,2,3,619,619,1238,15,0.133082,0.168163,247,0,0
8574871,"Schmitten (Albula), Chappali",,0.000062,131,1,1,2,3623,3623,7246,15,0.132867,0.165127,1976,0,0
8580921,"Lantsch/Lenz, Barbatschauns",,0.000032,131,1,1,2,3623,3623,7246,15,0.152074,0.239034,268.516667,0,0
8587441,"Davos Dischma, Teufi",,0.000019,131,1,2,3,7110,7059,14169,16,0.14978,0.255608,4236,0,0
8581178,"Davos Frauenkirch, Landhaus",,0.000046,131,2,4,6,17903,17903,35806,14,0.173913,0.324218,1669.516667,0,0
8582985,"Zizers, Schule Feld",,0.000096,109,3,2,5,11976,4060,16036,20,0.111511,0.23904,28175.735897,0,0
8592592,"Davos Laret, Unter Laret",,0.000031,131,1,1,2,5396,5396,10792,18,0.104869,0.166319,9844.717949,0,0
8592593,"Davos Laret, Ober Laret",,0.000031,131,1,1,2,7014,7014,14028,18,0.104869,0.166319,9844.717949,0,0
8588890,"Davos Dorf, Seehofseeli",,0.000041,131,3,3,6,25271,25161,50432,15,0.157895,0.284682,15846,0,0
8592597,"Davos Dorf, Flüelakreuzung",,0.000086,131,1,2,3,14748,13450,28198,14,0.149068,0.256943,14172.516667,0,0
8592605,"Davos Platz, Postplatz",,0.000079,131,1,4,5,41279,31897,73176,7,0.301887,0.471429,8555,0,0
8574850,"Susch, Plaz",,0.000019,131,1,1,2,619,619,1238,16,0.117871,0.141063,1412,0,0
8574852,"Tschierv, Süsom Tschierv",,0.000044,30,1,1,2,3370,3371,6741,3,0.444444,0.541667,22,0,0
8579686,"Dietfurt, Bahnhof",,0.000075,97,3,1,4,7969,3901,11870,1,1,1,330.833333,0,0
8575010,"Schluein, Caglia Liunga",,0.000039,110,1,3,4,5498,5498,10996,4,0.433962,0.5,68,0,0
8575012,"Sagogn, Vitg dadens",,0.00003,110,1,2,3,4501,4501,9002,4,0.42,0.47619,21,0,0
8574880,"Chur, Vorder Araschgen",,0.000045,109,1,1,2,3693,3693,7386,29,0.093957,0.112296,1196,0,0
8574881,"Chur, Hinter Araschgen",,0.00005,109,1,1,2,3693,3693,7386,28,0.103439,0.12773,1541,0,0
8574883,"Passugg, Schluocht",,0.000033,109,1,1,2,2930,2930,5860,31,0.079,0.09107,220,0,0
8574884,"Passugg, Abzw. Grida",,0.000039,109,1,1,2,2930,2930,5860,30,0.085559,0.099831,559,0,0
8574885,"Ausserpraden, Krone",,0.000044,109,1,1,2,2930,2769,5699,29,0.093327,0.110944,896,0,0
8574886,"Ausserpraden, Hedwig",,0.000049,109,1,1,2,2769,2769,5538,28,0.102672,0.12566,1231,0,0
8574888,"Disentis/Mustér, staziun/posta",,0.000065,108,1,1,2,2004,2004,4008,2,0.6,0.666667,54,0,0
8574896,"Disentis/Mustér, Fontanivas",,0.000066,108,1,2,3,2004,2004,4008,1,1,1,38,0,0
8574897,Acla (Medel),,0.000039,108,1,1,2,715,715,1430,1,1,1,0,0,0
8574898,"Ringlikon, Gättern",,0.000048,22,1,1,2,2768,2768,5536,14,0.129032,0.138205,1489.200577,0,0
8574904,"Thusis, Altersheim",,0.000051,109,2,1,3,4998,5002,10000,27,0.103841,0.130825,90,0,0
8574936,"Pontresina, Post",,0.00004,30,4,2,6,12090,13011,25101,9,0.242063,0.298354,111.721825,0,0
8574940,"Pontresina, Godin",,0.000047,30,1,1,2,12669,12669,25338,9,0.233607,0.278356,171,0,0
8574937,"Pontresina, Schlossgarage",,0.000028,30,1,2,3,12669,12669,25338,11,0.165746,0.204234,42,0,0
8574938,"Pontresina, Rondo",,0.000023,30,1,1,2,4178,4178,8356,11,0.163435,0.190746,0,0,0
8574939,"Pontresina, Sportpavillon",,0.000042,30,2,1,3,12669,12669,25338,10,0.192053,0.223933,130,0,0
8574950,"St. Moritz Bad, Campingplatz",,0.000017,30,1,3,4,14034,14035,28069,10,0.237624,0.324297,68.471429,0,0
8574954,"Champfèr, Guardalej",,0.000035,30,2,8,10,15357,15358,30715,9,0.291925,0.430108,250.47619,0,0
8574949,"St. Moritz Bad, Via San Gian",,0.000054,30,5,7,12,21108,21133,42241,8,0.308176,0.425219,335.193651,0,0
8574957,"Sils/Segl Maria, Seglias",,0.000024,30,2,5,7,6548,6527,13075,9,0.258824,0.36057,100.166667,0,0
8574956,"Surlej, Parkplatz",,0.000043,30,2,4,6,15417,15417,30834,8,0.314685,0.412275,151.8,0,0
8574960,"Maloja, Capolago",,0.000024,30,1,4,5,3234,3234,6468,8,0.291045,0.387241,44,0,0
8574973,"Bever, Bahnhof",,0.000061,30,1,2,3,6291,6291,12582,8,0.276423,0.353501,69.666667,0,0
8574943,"Celerina, Cresta Kulm",,0.000034,30,2,1,3,14545,14546,29091,11,0.168712,0.199121,38.444444,0,0
8574944,"Celerina, Cresta Palace",,0.00004,30,1,1,2,14546,14546,29092,10,0.199262,0.236611,73.444444,0,0
8583881,"Silvaplana, Kreisel Mitte",,0.000151,30,8,8,16,20562,14370,34932,7,0.357143,0.552762,440.738889,0,0
8589914,"Samedan, Golf",,0.000076,30,4,3,7,7018,6676,13694,3,0.529412,0.62963,209.738889,0,0
8590457,"St. Moritz, Caspar Badrutt",,0.00006,30,2,3,5,10431,10430,20861,2,0.8,0.875,11.166667,0,0
8590459,"St. Moritz, Klinik Gut",,0.000056,30,2,2,4,7067,6928,13995,2,0.75,0.833333,4.366667,0,0
8591849,"S-chanf, Pradels",,0.000059,30,2,1,3,8887,106,8993,2,0.6,0.666667,25.333333,0,0
8588804,"Samedan, Chesa Planta",,0.000059,30,3,4,7,6415,6310,12725,3,0.588235,0.683333,59.883333,0,0
8588805,"Samedan, Sper l'En",,0.000055,30,3,3,6,4645,4186,8831,4,0.470588,0.614583,24.45,0,0
8590453,"St. Moritz Bad, Kath. Kirche",,0.000103,30,7,3,10,20404,20402,40806,4,0.5,0.654762,105.5,0,0
8590455,"St. Moritz Bad, Via Aruons",,0.000075,30,4,3,7,20452,20454,40906,3,0.6,0.722222,34.8,0,0
8590456,"St. Moritz Bad, Via Salet",,0.0001,30,6,3,9,20254,20254,40508,3,0.625,0.766667,137.9,0,0
8594232,"Pontresina, Punt Ota Sur",,0.00015,30,6,2,8,8478,4071,12549,1,1,1,104.333333,0,0
8574952,"St. Moritz, Somplaz",,0.000022,30,1,1,2,6102,6102,12204,10,0.229665,0.292006,141.95,0,0
8574955,"Surlej, Brücke",,0.000033,30,3,1,4,12226,15392,27618,9,0.243386,0.292357,74.928571,0,0
8574981,"Bernina, Lagalbbahn",,0.000043,30,1,1,2,1257,1257,2514,9,0.228346,0.291899,87,0,0
8574974,"Samedan, Bahnhof",,0.000082,30,6,7,13,12292,12293,24585,7,0.362637,0.504618,865.744444,0,0
8574977,"Celerina, Trais Fluors",,0.000045,30,1,5,6,8341,8341,16682,8,0.30303,0.445079,33.5,0,0
8580216,"St. Moritz, Segantini Museum",,0.000069,30,5,3,8,6124,6102,12226,8,0.285714,0.39949,158.833333,0,0
8580585,"Samedan, Post",,0.000038,30,2,3,5,6415,6415,12830,7,0.320988,0.428938,37.266667,0,0
8580593,"Samedan, Quadratscha",,0.000029,30,2,2,4,3119,3119,6238,7,0.313253,0.403297,8.666667,0,0
8580786,"Sils/Segl, San Lurench",,0.000057,30,5,2,7,3722,3742,7464,8,0.278351,0.377249,54.266667,0,0
8581577,"Morteratsch, Abzweigung",,0.000055,30,2,1,3,1256,1257,2513,8,0.270833,0.353297,0,0,0
8574958,Plaun da Lej,,0.000015,30,1,1,2,3234,3234,6468,9,0.229885,0.280377,37,0,0
8574969,Spino,,0.000042,77,1,1,2,3757,3757,7514,2,0.666667,0.75,8,0,0
8574970,"Promontogno, Ospedale Flin",,0.000046,77,1,1,2,3757,78,3835,1,1,1,5,0,0
8574971,"Bever, Dorfzentrum",,0.000056,30,5,1,6,6247,6291,12538,10,0.185567,0.225452,65.666667,0,0
8574972,"Samedan, Spital",,0.000058,30,1,1,2,6291,6291,12582,9,0.221519,0.269478,68.666667,0,0
8574975,"Samedan, Central",,0.000047,30,2,2,4,6415,6415,12830,8,0.264463,0.336533,43.1,0,0
8587895,"S-chanf, Somvih",,0.000062,30,1,2,3,9099,9099,18198,4,0.384615,0.483333,180.5,0,0
8574976,"Samedan, Ariefa",,0.000041,30,2,1,3,8341,8341,16682,9,0.238462,0.308013,42.5,0,0
8587885,"Chamues-ch, plaz",,0.000074,30,1,3,4,14866,14866,29732,5,0.365385,0.464035,127.5,0,0
8574978,"Pontresina, Palü",,0.000024,30,3,1,4,1257,1257,2514,12,0.145455,0.189449,102,0,0
8574979,"Bernina Suot, Bahnhof",,0.000031,30,1,1,2,1257,1257,2514,11,0.164894,0.210371,99,0,0
8574980,"Bernina Diavolezza, Bahnhof",,0.000037,30,1,1,2,1257,1257,2514,10,0.191083,0.241098,94,0,0
8574983,"Vattiz, Surval",,0.000017,78,1,1,2,77,70,147,4,0.4,0.520833,3,0,0
8575092,Strada im Oberland,,0.000034,110,2,2,4,4464,4467,8931,5,0.390625,0.451333,99.75,0,0
8574991,"Ilanz, Obertor",,0.000025,110,1,1,2,1072,1906,2978,7,0.20339,0.245933,100,0,0
8574992,"Ilanz, Sogn Martin",,0.000032,110,1,1,2,1906,2028,3934,6,0.244681,0.287681,98,0,0
8575006,"Luven, Quadras",,0.000039,110,1,2,3,2028,2028,4056,5,0.309859,0.366667,94,0,0
8575007,Tegia alva,,0.000027,110,1,1,2,1072,1072,2144,5,0.3,0.336508,0,0,0
8575008,"Luven, vitg",,0.00005,110,2,1,3,2028,2028,4056,4,0.408163,0.45,80,0,0
8575009,"Ilanz, Spital",,0.000067,110,6,2,8,8391,8405,16796,4,0.421053,0.472222,466.416667,0,0
8575015,"Laax GR, Fau",,0.000044,110,3,2,5,3510,3510,7020,4,0.425532,0.483333,25.833333,0,0
8575045,"Ilanz, Punt dal Glogn",,0.000019,110,1,2,3,2281,4846,7127,4,0.40678,0.461806,40,0,0
8575048,"Sevgein, vitg",,0.000027,110,1,2,3,2565,2854,5419,4,0.423077,0.477273,28,0,0
8575049,"Sevgein, Curschetta",,0.000022,110,1,2,3,2168,2168,4336,4,0.42,0.47619,5,0,0
8575050,"Riein, vitg",,0.00002,110,1,1,2,2045,1756,3801,4,0.408163,0.45,0,0,0
8575097,"Siat, Bual",,0.000055,110,1,1,2,2104,2104,4208,4,0.408163,0.45,80,0,0
8575011,"Schluein, Falerin",,0.000022,110,1,1,2,4501,4501,9002,5,0.305556,0.343939,27,0,0
8575014,"Uitikon Waldegg, Bahnhof",,0.000051,22,1,1,2,2768,2636,5404,13,0.147774,0.160304,1537.200577,0,0.000001
8590786,"Schlieren, Bahnhof",,0.00004,22,4,2,6,34755,34767,69522,13,0.148218,0.163595,772.039536,0.000175,0.000035
8575017,"Schleinikon, Dachsleren",,0.000019,79,1,1,2,2047,2048,4095,3,0.5,0.611111,4,0,0
8575023,"Morissen, Padrus",,0.000017,78,1,1,2,1060,3028,4088,3,0.5,0.611111,6,0,0
8575024,"Morissen, Mulin",,0.000025,78,1,1,2,3028,3028,6056,2,0.666667,0.75,5,0,0
8575026,"Degen, Rumein",,0.000039,78,2,1,3,1206,1205,2411,2,0.666667,0.75,10,0,0
8575027,"Schleinikon, Wasen",,0.000027,79,1,1,2,2048,2048,4096,2,0.666667,0.75,4,0,0
8575047,"Sevgein, Plaun Gera",,0.000019,110,1,1,2,2565,2565,5130,5,0.306667,0.343478,9,0,0
8575057,"Waltensburg/Vuorz, Demvitg",,0.000034,110,1,1,2,2884,2884,5768,8,0.227586,0.263672,179.5,0,0
8575058,"Waltensburg/Vuorz, Sumvitg",,0.00004,110,1,1,2,2884,2884,5768,7,0.285714,0.331548,182.5,0,0
8579976,"Andiast, S. Clau",,0.000037,110,2,2,4,1392,1392,2784,2,0.666667,0.75,5.416667,0,0
8580605,"Rueun, Las Dretgs",,0.000045,110,2,2,4,2265,2265,4530,2,0.75,0.833333,51.333333,0,0
8575062,"Dardin, Patnasa",,0.000052,110,3,2,5,4271,2301,6572,2,0.75,0.833333,99,0,0
8581166,"Breil/Brigels, Pundual",,0.000033,110,1,1,2,1092,1092,2184,2,0.666667,0.75,0,0,0
8575071,"Pragg, Bänkli",,0.00004,112,3,1,4,1804,1804,3608,30,0.075543,0.089518,9947,0,0
8575072,"Furna, Abzw. Platta",,0.000045,112,1,1,2,1804,1804,3608,29,0.081376,0.097169,8765,0,0
8575073,"Furna, Abzw. Hasenhaus",,0.000049,112,1,1,2,1804,1804,3608,28,0.088213,0.106984,7581,0,0
8575074,"Furna, Kirche",,0.000053,112,1,2,3,1804,1804,3608,27,0.096341,0.120987,6395,0,0
8575076,"Furna, Gärbi",,0.000039,112,1,1,2,1324,1324,2648,27,0.095645,0.115634,235,0,0
8575075,"Furna, Rasitsch",,0.000033,112,1,1,2,1324,1324,2648,28,0.087635,0.10436,1425,0,0
8575077,"Pragg, Katzenboden",,0.000067,112,2,1,3,1804,1804,3608,26,0.105311,0.130748,2825,0,0
8575079,"Fideris, Au",,0.000037,112,2,1,3,3848,3848,7696,16,0.121622,0.146207,2350.066667,0,0
8575082,"Luzein, Maris",,0.000035,112,1,1,2,3659,3649,7308,4,0.333333,0.416667,10009,0,0
8575087,"St. Antönien, Meierhof",,0.00006,112,3,1,4,2614,1846,4460,2,0.666667,0.75,27,0,0
8575088,"Küblis, Dorfplatz",,0.000035,112,1,2,3,7165,7165,14330,27,0.082546,0.1223,4892.583333,0,0
8581194,"Klosters, Dorf",,0.000026,112,1,1,2,6827,6562,13389,27,0.081967,0.115548,0,0,0
8575093,"Rueun, Grava",,0.00004,110,2,1,3,2104,2104,4208,8,0.172662,0.217659,132,0,0
8575094,"Rueun, Chiglina",,0.000045,110,1,1,2,2104,2104,4208,7,0.2,0.242133,122,0,0
8575095,"Siat, Schischiu",,0.000049,110,1,1,2,2104,2104,4208,6,0.23913,0.27803,110,0,0
8575096,"Siat, Glix",,0.000052,110,1,1,2,2104,2104,4208,5,0.3,0.336508,96,0,0
8575099,"Vella, Sumsiaras",,0.000044,78,1,1,2,1205,1206,2411,1,1,1,6,0,0
8581436,"Pfäfers, Wiesli",,0.00004,109,1,1,2,4540,4480,9020,3,0.5,0.611111,0,0,0
8579816,"Schiers, Salginatobelbrücke",,0.000037,112,1,1,2,1091,1043,2134,4,0.357143,0.466667,0,0,0
8581173,"Fideris, Arieschbach",,0.000042,112,1,2,3,3626,2970,6596,24,0.105263,0.149572,1608,0,0
8581174,"Fideris, Strahlegg",,0.000029,112,1,1,2,1408,2064,3472,24,0.104538,0.14298,0,0,0
8582761,"Jenaz, Altersheim",,0.000044,112,1,2,3,4688,3969,8657,2,0.75,0.833333,5536.666667,0,0
8580715,"Laax GR, See/Lag",,0.000056,110,3,3,6,3510,3510,7020,2,0.8,0.875,32.416667,0,0
8580859,"Laax GR, Staderas",,0.000059,110,3,2,5,768,660,1428,2,0.666667,0.75,20.5,0,0
8581171,"Valendas, Carrera",,0.000048,110,1,2,3,2491,2491,4982,2,0.75,0.833333,8,0,0
8581911,"Sagogn, Carnetg",,0.000078,110,1,1,2,4501,4501,9002,2,0.666667,0.75,2,0,0
8575121,"Wil ZH, Breitenmatt",,0.000024,68,2,1,3,5937,5933,11870,8,0.25,0.330893,1104,0,0
8575123,"Bellinzona, Isolabella",,0.000022,108,1,1,2,22183,22183,44366,63,0.046513,0.06935,412,0,0
8575124,"Giubiasco, Bivio Pedevilla",,0.00003,108,1,1,2,22183,22183,44366,62,0.048712,0.075537,1083,0,0
8575127,"Giubiasco, Sottomontagna",,0.000031,108,1,1,2,8578,8578,17156,19,0.086897,0.116307,460,0,0
8575128,"Giubiasco, Sasso Piatto",,0.000037,108,1,1,2,8578,8578,17156,18,0.093656,0.12339,499,0,0
8575129,"Giubiasco, Lôro",,0.000043,108,1,1,2,8578,8578,17156,17,0.101667,0.132115,536,0,0
8575130,"Pianezzo, Carabella",,0.000047,108,1,1,2,8578,8578,17156,16,0.111317,0.143218,571,0,0
8575131,"Pianezzo, Paese",,0.000051,108,1,1,2,8578,8578,17156,15,0.123173,0.158017,604,0,0
8575132,"Pianezzo, Tremozza",,0.000054,108,1,1,2,8578,8578,17156,14,0.138095,0.179298,635,0,0
8575133,"Pianezzo, Giro del Fée",,0.000057,108,1,2,3,8578,8578,17156,13,0.157459,0.215665,664,0,0
8575151,Carena,,0.000067,108,1,1,2,8491,8491,16982,11,0.162362,0.207108,528,0,0
8575134,"Pianezzo, Sabbione",,0.000035,108,1,1,2,8491,8491,16982,23,0.063854,0.099504,360,0,0
8575135,"Pianezzo, Ghezz",,0.000041,108,1,1,2,8491,8491,16982,22,0.066991,0.102525,385,0,0
8575136,"Pianezzo, Giro del Boschetto",,0.000046,108,1,1,2,8491,8491,16982,21,0.070496,0.105885,408,0,0
8575137,"Pianezzo, Giaghen",,0.00005,108,1,1,2,8491,8491,16982,20,0.074438,0.109658,429,0,0
8575138,"Pianezzo, Mondella",,0.000053,108,1,1,2,8491,8491,16982,19,0.078907,0.11394,448,0,0
8575139,"Paudo, Paese",,0.000056,108,1,1,2,8491,8491,16982,18,0.08402,0.118858,465,0,0
8575145,"Paudo, Giro Trebbie",,0.000058,108,1,1,2,8491,8491,16982,17,0.089928,0.124593,480,0,0
8575146,Vellano,,0.000061,108,1,1,2,8491,8491,16982,16,0.096838,0.131395,493,0,0
8575147,S. Antonio (Morob.),,0.000062,108,1,1,2,8491,8491,16982,15,0.105033,0.139641,504,0,0
8575148,"S. Antonio (Morob.), Bolla",,0.000064,108,1,1,2,8491,8491,16982,14,0.114914,0.149908,513,0,0
8575149,"S. Antonio (Morob.), Melirolo",,0.000065,108,1,1,2,8491,8491,16982,13,0.127072,0.163147,520,0,0
8575150,Melera,,0.000066,108,1,1,2,8491,8491,16982,12,0.142405,0.181061,525,0,0
8575152,"Bellinzona, Viale Portone",,0.000052,108,3,2,5,94917,111357,206274,59,0.055962,0.106317,17299.041667,0,0
8575157,"Monte Carasso, Urènn/Funivia",,0.000049,108,4,1,5,32707,42469,75176,33,0.069102,0.079997,3634,0,0
8575158,"Sementina, Via Locarno",,0.000052,108,1,2,3,42469,42469,84938,32,0.07408,0.08784,4085,0,0
8575159,"Sementina, Scuole",,0.000033,108,1,1,2,24468,24468,48936,31,0.081514,0.095299,1642,0,0
8575160,"Sementina, Rotonda",,0.000039,108,1,1,2,24468,24468,48936,30,0.088522,0.105282,1995,0,0
8575161,"Sementina, Mondasce",,0.000044,108,1,1,2,24468,24468,48936,29,0.09687,0.118309,2346,0,0
8575162,"Sementina, Ponte sul Ticino",,0.000048,108,1,1,2,24468,24468,48936,28,0.106986,0.13637,2695,0,0
8575163,"Sementina, Sud",,0.000033,108,1,1,2,18001,18001,36002,38,0.057326,0.064363,2854,0,0
8575164,"Sementina, Motto",,0.000039,108,1,1,2,18001,18001,36002,37,0.060686,0.06818,3297,0,0
8575166,"Gudo, Chiesa",,0.000057,108,2,1,3,18503,18503,37006,35,0.068772,0.077699,4469.6,0,0
8575167,"Gudo, Progero",,0.00006,108,1,1,2,18503,18503,37006,34,0.073697,0.083758,4906.6,0,0
8575168,"Gudo, Serta",,0.000062,108,1,1,2,18503,18503,37006,33,0.079394,0.091053,5341.6,0,0
8575169,"Gudo, Pian Marnino",,0.000063,108,1,1,2,18503,18503,37006,32,0.08606,0.100043,5774.6,0,0
8575170,"Cugnasco, Massarescio",,0.000065,108,1,1,2,18503,18503,37006,31,0.093966,0.111472,6205.6,0,0
8575171,"Cugnasco, Posta",,0.000066,108,1,1,2,18503,18503,37006,30,0.103493,0.12669,6634.6,0,0
8578948,"Gordola, Nord",,0.000092,101,2,2,4,18766,18766,37532,29,0.099848,0.126339,36355.22619,0,0
8578949,"Gordola, Gaggiole",,0.00005,101,1,1,2,18085,18085,36170,29,0.09962,0.124116,0,0,0
8581105,"S. Antonino, Posta",,0.000075,108,3,2,5,23392,23119,46511,12,0.200924,0.248153,25789.5,0,0
8575179,"Bellinzona, Via Mirasole",,0.000022,108,1,1,2,16509,16509,33018,63,0.023637,0.028991,5456,0,0
8575180,"Bellinzona, Via Lepori",,0.000029,108,1,1,2,16509,16509,33018,62,0.024166,0.029506,5979,0,0
8575181,Carasso,,0.000036,108,1,1,2,16509,16509,33018,61,0.02472,0.030047,6500,0,0
8575182,"Bellinzona, Lusanico",,0.000041,108,1,1,2,16509,16509,33018,60,0.025301,0.030615,7019,0,0
8575183,"Bellinzona, Bivio Galbisio",,0.000046,108,1,1,2,16509,16509,33018,59,0.025911,0.031214,7536,0,0
8575184,"Bellinzona, Parco Giochi",,0.00005,108,1,1,2,16509,16509,33018,58,0.026552,0.031844,8051,0,0
8575185,"Bellinzona, S. Anna",,0.000053,108,1,1,2,16509,16509,33018,57,0.027227,0.03251,8564,0,0
8575186,"Gorduno, alla Rivetta",,0.000056,108,1,1,2,16509,16509,33018,56,0.027938,0.033215,9075,0,0
8575187,"Gorduno, Burgaio",,0.000059,108,1,1,2,16509,16509,33018,55,0.028689,0.033961,9584,0,0
8575188,"Gorduno, San Carpoforo",,0.000061,108,1,1,2,16509,16509,33018,54,0.029483,0.034753,10091,0,0
8575190,"Gnosca, Centro",,0.000063,108,1,1,2,16509,16509,33018,53,0.030323,0.035594,10596,0,0
8575191,"Gnosca, Cusnà",,0.000064,108,1,1,2,16509,16509,33018,52,0.031214,0.036491,11099,0,0
8575192,"Preonzo, Bivio per Claro",,0.000065,108,1,1,2,16509,16509,33018,51,0.032161,0.037449,11600,0,0
8575194,"Preonzo, Piazza",,0.000066,108,1,1,2,16509,16509,33018,50,0.033169,0.038474,12099,0,0
8575195,"Preonzo, Paese",,0.000067,108,1,1,2,16509,16509,33018,49,0.034244,0.039574,12596,0,0
8575196,"Preonzo, Nord",,0.000068,108,1,1,2,16509,16509,33018,48,0.035393,0.040758,13091,0,0
8575197,Moleno,,0.000069,108,1,1,2,16509,16509,33018,47,0.036624,0.042036,13584,0,0
8575198,"Prosito, Sud",,0.000069,108,1,1,2,16509,16949,33458,46,0.037946,0.043421,14075,0,0
8575199,"Prosito, Paese",,0.00007,108,1,1,2,16949,16509,33458,45,0.03937,0.044929,14564,0,0
8575200,"Prosito, Nord",,0.00007,108,1,1,2,16509,16509,33018,44,0.040908,0.046579,15051,0,0
8575201,"Lodrino, Sud",,0.000071,108,1,1,2,16509,16509,33018,43,0.042573,0.048397,15536,0,0
8575202,"Lodrino, Bivio per Cresciano",,0.000071,108,1,1,2,16509,16509,33018,42,0.044384,0.050418,16019,0,0
8575203,"Lodrino, Posta",,0.000071,108,1,1,2,16509,16509,33018,41,0.046359,0.052702,16500,0,0
8575204,"Lodrino, Paese",,0.000071,108,1,1,2,16509,16509,33018,40,0.048522,0.055379,16979,0,0
8575205,"Lodrino, Cave Bignasca",,0.000072,108,1,2,3,16509,16509,33018,39,0.050901,0.058963,17456,0,0
8575206,"Lodrino, Rongei",,0.000041,108,1,1,2,8438,8438,16876,39,0.05081,0.057198,0,0,0
8575207,"Lodrino, Balma",,0.000076,108,2,1,3,16509,16509,33018,38,0.05343,0.060195,18404,0,0
8575208,"Lodrino, Rodaglio",,0.000076,108,1,1,2,16509,16509,33018,37,0.05634,0.063632,18875,0,0
8575209,"Iragna, Blono",,0.000076,108,1,1,2,16509,16509,33018,36,0.059591,0.067686,19344,0,0
8575211,"Iragna, Ponte dei Ladri",,0.000075,108,1,2,3,16509,16509,33018,35,0.063247,0.072938,19811,0,0
8575212,"Iragna, Nord",,0.000043,108,1,1,2,8438,8438,16876,35,0.063135,0.071182,0,0,0
8575213,"Iragna, Buscerina",,0.000079,108,2,1,3,16509,16509,33018,34,0.067262,0.076212,20739,0,0
8575214,"Iragna, Cave Mairano",,0.000078,108,1,1,2,16509,16509,33018,33,0.071976,0.082165,21200,0,0
8575215,"Iragna, Mairano Nord",,0.000077,108,1,1,2,16509,16509,33018,32,0.077411,0.089343,21659,0,0
8575216,"Iragna, Prealberto",,0.000077,108,1,1,2,16509,16509,33018,31,0.083746,0.09821,22116,0,0
8575217,"Biasca, Quaresima",,0.000076,108,1,1,2,16509,16509,33018,30,0.091226,0.109528,22571,0,0
8575218,"Biasca, Monda del Turco",,0.000075,108,1,1,2,16509,16509,33018,29,0.100192,0.124684,23024,0,0
8578837,"Olivone, Petullo",,0.000058,108,3,4,7,16421,16421,32842,11,0.19398,0.288459,2021.8,0,0
8578853,"Semione, Cantonetto",,0.000049,108,2,1,3,6902,6763,13665,11,0.186667,0.243113,128,0,0
8581574,"Bellinzona, Espocentro",,0.000033,108,1,2,3,41417,41417,82834,10,0.218182,0.287136,9427,0,0
8581713,"Faido, Birreria",,0.000061,108,1,1,2,12397,12752,25149,11,0.186667,0.243113,2014,0,0
8581714,"Biasca, Centro/Borgo",,0.000188,108,7,4,11,51203,35651,86854,10,0.224044,0.32559,11965.016667,0,0
8575222,"Bellinzona, Officina FFS",,0.000055,108,4,1,5,44311,47578,91889,28,0.10776,0.139011,979.5,0,0
8580087,"Castaneda, Alla Leura",,0.000045,17,1,2,3,2963,2963,5926,10,0.179641,0.253717,60,0,0
8580100,"Buseno, Botteghe",,0.000058,17,1,1,2,2138,1867,4005,10,0.178571,0.23705,120,0,0
8575241,"Mesocco, Nord",,0.000066,109,1,1,2,2029,2027,4056,27,0.11355,0.144862,204,0,0
8575260,"Figino, Dogana",,0.00006,102,1,2,3,9435,9435,18870,14,0.151862,0.186503,1253,0,0
8575272,"Pambio-Noranco, Posta",,0.000078,102,1,2,3,31147,31147,62294,14,0.155695,0.185624,1774,0,0
8575300,"Barbengo, Cà Rosa",,0.000064,102,1,1,2,6284,6284,12568,14,0.153094,0.17688,987,0,0
8575309,"Carona, Bellavista",,0.000057,102,1,1,2,12764,12764,25528,13,0.177003,0.207786,1096,0,0
8575541,"Paradiso, la Sguancia",,0.000104,102,3,2,5,74315,74780,149095,13,0.179487,0.216429,2671,0,0
8577047,"Barbengo, Via Balconi",,0.00006,102,1,1,2,23370,23370,46740,13,0.177003,0.207786,274,0,0
8579004,"Canobbio, Ganna",,0.000083,102,3,5,8,46415,54000,100415,12,0.228304,0.290715,978.863919,0,0
8575248,"Melide, Piazza Moretti",,0.000023,102,2,1,3,9540,13125,22665,25,0.075883,0.089706,459,0,0
8575249,"Melide, Cantine",,0.000031,102,1,1,2,13125,13125,26250,24,0.081642,0.096277,599,0,0
8575250,"Melide, Villa Magnolia",,0.000037,102,1,1,2,13125,13125,26250,23,0.088386,0.104394,737,0,0
8575252,"Olivella, Lago",,0.000053,102,2,2,4,13437,15402,28839,21,0.106051,0.130379,1046,0,0
8575253,"Morcote, Casa per Anziani",,0.000034,102,1,1,2,9435,9540,18975,21,0.075868,0.088458,406,0,0
8575254,"Morcote, Parco Scherrer",,0.000039,102,1,1,2,9540,9435,18975,20,0.081602,0.094413,533,0,0
8575255,"Morcote, Arbostora",,0.000044,102,1,1,2,9435,9435,18870,19,0.088314,0.101548,658,0,0
8575256,"Morcote, Vedo",,0.000049,102,1,1,2,9435,9435,18870,18,0.096279,0.110275,781,0,0
8575257,"Morcote, Burò",,0.000052,102,1,1,2,9435,9435,18870,17,0.105882,0.12124,902,0,0
8575258,"Morcote, la Canva",,0.000055,102,1,1,2,9435,9435,18870,16,0.11769,0.13555,1021,0,0
8575259,"Morcote, Cantine",,0.000058,102,1,1,2,9435,9435,18870,15,0.13256,0.15538,1138,0,0
8579022,"Lugano, Piazza Luini",,0.000181,102,6,5,11,132307,132076,264383,12,0.213501,0.270688,6875.204754,0,0
8575261,"Casoro, Paese",,0.000042,102,2,2,4,31042,31042,62084,18,0.100254,0.123444,847,0,0
8575262,"Barbengo, Tassera",,0.000029,102,1,1,2,23265,23370,46635,17,0.108834,0.126431,817,0,0
8575265,"Garaverio, Paese",,0.000041,102,1,1,2,7777,7777,15554,17,0.108834,0.126431,308,0,0
8575263,"Barbengo, la Cava",,0.000029,102,1,1,2,7777,7777,15554,19,0.090382,0.104513,94,0,0
8575264,"Cernesio, Paese",,0.000035,102,1,1,2,7777,7777,15554,18,0.098726,0.114006,202,0,0
8575266,"Grancia, Paese",,0.00007,102,2,2,4,31147,31147,62294,16,0.121332,0.144785,1382,0,0
8575269,"Grancia, Molini di Grancia",,0.000046,102,1,1,2,23370,23370,46740,16,0.120032,0.136768,151,0,0
8575267,"Barbengo, Scuole",,0.000041,102,1,1,2,23370,23370,46740,17,0.107801,0.122613,52,0,0
8575271,"Scairolo, Bivio",,0.00008,102,2,1,3,31147,31147,62294,15,0.135501,0.156109,1679,0,0
8575273,"Lugano, Stazione Via Sorengo",,0.000024,102,1,1,2,17835,17835,35670,13,0.154686,0.172068,473.468182,0,0
8575274,"Sorengo, Clinica S. Anna",,0.000031,102,1,1,2,17835,17835,35670,12,0.181916,0.206521,612.468182,0,0
8575285,"Bigogno, Paese",,0.000061,102,1,2,3,13239,12514,25753,11,0.222535,0.260925,1422,0,0
8575377,"Castagnola, Posta",,0.000014,102,1,4,5,36124,60580,96704,11,0.230552,0.279653,140.640476,0,0
8575381,"Massagno, Cinque Vie",,0.000033,102,2,2,4,61374,61374,122748,11,0.227338,0.267395,796.133333,0,0
8575388,"Cademario, Cetta",,0.000054,102,1,2,3,8218,8218,16436,11,0.224432,0.263502,1736.166667,0,0
8577231,"Gravesano, Posta",,0.000082,102,4,7,11,23252,23135,46387,11,0.234375,0.292367,4428.068651,0,0
8578999,"Lugano, Ospedale Civico",,0.000053,102,2,3,5,22477,22737,45214,11,0.229249,0.270498,1813.202381,0,0
8579007,"Savosa, Valgersa",,0.000049,102,3,4,7,71520,71565,143085,11,0.225714,0.272529,5896.185642,0,0
8575276,"Gentilino, Rubiana",,0.000022,102,1,1,2,13239,13239,26478,20,0.076711,0.088125,297,0,0
8575277,"Gentilino, Posta",,0.000029,102,1,1,2,13239,13239,26478,19,0.082587,0.093911,430,0,0
8575278,"Gentilino, S. Abbondio",,0.000036,102,1,1,2,13239,13239,26478,18,0.089479,0.100779,561,0,0
8575279,"Certenago, Paese",,0.000041,102,1,1,2,13239,13239,26478,17,0.097677,0.109066,690,0,0
8575280,"Montagnola, Poporino",,0.000046,102,1,1,2,13239,13239,26478,16,0.107591,0.11927,817,0,0
8575281,"Montagnola, Bellevue",,0.00005,102,1,1,2,13239,13239,26478,15,0.119822,0.132154,942,0,0
8575282,"Montagnola, Paese",,0.000053,102,1,1,2,13239,13239,26478,14,0.135294,0.14897,1065,0,0
8575283,"Montagnola, Il Maggio",,0.000056,102,1,1,2,13239,13239,26478,13,0.155491,0.171935,1186,0,0
8575284,"Bigogno, Cappella di Bigogno",,0.000059,102,1,1,2,13239,13239,26478,12,0.182969,0.205496,1305,0,0
8575286,"Lugano, Stazione Piazza Besso",,0.000011,102,0,3,3,0,69946,69946,12,0.191194,0.224733,0,0,0
8575291,"Breganzona, Prevagno",,0.000037,102,1,1,2,8628,8628,17256,13,0.162462,0.181778,483,0,0
8575292,"Muzzano, Paese",,0.000045,102,2,2,4,17255,17255,34510,12,0.192771,0.222857,652.033333,0,0
8575288,"Cortivallo, Paese",,0.000014,102,1,1,2,8572,8628,17200,16,0.110811,0.122858,3,0,0
8575289,"Cortivallo, Casa Anziani",,0.000023,102,1,1,2,8628,8628,17256,15,0.12386,0.136892,165,0,0
8575290,"Cremignone, Paese",,0.00003,102,1,1,2,8628,8628,17256,14,0.140503,0.155538,325,0,0
8575293,"Piodella, Brusada",,0.000044,102,1,1,2,6284,6284,12568,21,0.076446,0.089756,392,0,0
8575294,Cantonetto di Gentilino,,0.000049,102,1,1,2,6284,6284,12568,20,0.082215,0.095548,483,0,0
8575295,"Montagnola, Pianroncate",,0.000052,102,1,1,2,6284,6284,12568,19,0.08897,0.102446,572,0,0
8575296,"Montagnola, Ghiera",,0.000055,102,1,1,2,6284,6284,12568,18,0.09699,0.110811,659,0,0
8575297,"Carabietta, Paese",,0.000058,102,1,1,2,6284,6284,12568,17,0.106667,0.121184,744,0,0
8575298,"Barbengo, Casaccia",,0.00006,102,1,1,2,6284,6284,12568,16,0.118574,0.134427,827,0,0
8575299,"Barbengo, Campagnore",,0.000062,102,1,1,2,6284,6284,12568,15,0.133584,0.152024,908,0,0
8575301,"Paradiso, Calprino",,0.000017,102,1,1,2,12764,12764,25528,21,0.076076,0.08953,264,0,0
8575302,"Pazzallo, Morchino",,0.000025,102,1,1,2,12764,12764,25528,20,0.081772,0.095204,375,0,0
8575303,"Pazzallo, Paese",,0.000032,102,1,1,2,12764,12764,25528,19,0.088435,0.101945,484,0,0
8575304,"Pazzallo, ai Ronchi",,0.000038,102,1,1,2,12764,12764,25528,18,0.096336,0.110092,591,0,0
8575305,"Carabbia, al Canvetto",,0.000043,102,1,1,2,12764,12764,25528,17,0.105856,0.120149,696,0,0
8575306,"Carabbia, Paese",,0.000048,102,1,1,2,12764,12764,25528,16,0.117548,0.132903,799,0,0
8575307,"Carona, Ciona",,0.000052,102,1,1,2,12764,12764,25528,15,0.132255,0.149669,900,0,0
8575308,"Carona, Nodivra",,0.000055,102,1,1,2,12764,12764,25528,14,0.151316,0.172875,999,0,0
8575342,"Porza, Tavesio",,0.000042,102,1,1,2,15979,15979,31958,40,0.09267,0.142198,1148,0,0
8575314,"Vezia, Paese",,0.000036,102,4,1,5,63714,64356,128070,41,0.072791,0.100664,538,0,0
8575316,"Cadempino, Ronchetto",,0.000037,102,3,1,4,64753,64747,129500,39,0.083245,0.12314,1290.383333,0,0
8575332,"Gravesano, Grumo",,0.000065,102,4,3,7,31001,31312,62313,37,0.088349,0.134283,7375.685714,0,0
8575331,"Torricella, Naravazz",,0.000043,102,1,3,4,16340,2416,18756,38,0.088696,0.153634,678.266667,0,0
8577314,"Lamone, Ostarietta V.Cantonale",,0.000085,102,4,4,8,17773,16963,34736,14,0.155481,0.201273,6425,0,0
8579977,"Ponte Capriasca, Nogo Sopra",,0.000076,102,5,3,8,24156,23158,47314,13,0.176084,0.225382,1003.137662,0,0
8575320,"Lamone, Paese",,0.000021,102,1,1,2,31850,31836,63686,39,0.079107,0.109482,54,0,0
8575322,"Gravesano, Bivio per Bedano",,0.000029,102,2,1,3,23710,23531,47241,43,0.060166,0.074796,273,0,0
8575323,"Bedano, Via Mara",,0.000036,102,1,1,2,23531,23531,47062,42,0.063848,0.080426,593,0,0
8575324,"Bedano, S. Rocco",,0.000041,102,1,1,2,23531,23531,47062,41,0.068021,0.087261,911,0,0
8575325,"Bedano, Casa per Anziani",,0.000046,102,1,1,2,23531,23531,47062,40,0.072791,0.095804,1227,0,0
8575328,"Taverne, Carvina",,0.000062,102,5,1,6,28949,29190,58139,41,0.077925,0.116424,2042.814286,0,0
8575329,"Taverne, Vignascia",,0.000064,102,1,2,3,29190,29190,58380,40,0.084282,0.136727,2350.814286,0,0
8575408,"Taverne, Via Pureca",,0.000083,102,3,1,4,9256,9359,18615,14,0.155072,0.180623,2865.133333,0,0
8575330,"Torricella, Chiesa",,0.000038,102,1,1,2,16340,16340,32680,39,0.081673,0.126696,374.266667,0,0
8575409,"Taverne-Torricella, Stazione",,0.000108,102,2,4,6,22209,22195,44404,13,0.182676,0.227152,5268.680952,0,0
8575333,"Manno, Uovo di Manno",,0.000051,102,3,3,6,74327,74270,148597,37,0.103398,0.167016,5228.584921,0,0
8575382,"Bioggio, Paese",,0.000067,102,3,3,6,12342,12579,24921,17,0.106707,0.135593,1476,0,0
8575400,"Vernate, Bivio per Cimo",,0.000077,81,2,2,4,11255,9515,20770,18,0.088643,0.115038,1364,0,0
8575334,"Manno, Paese",,0.000044,102,2,1,3,23107,23107,46214,36,0.101156,0.143738,4629.391667,0,0
8575338,"Savosa, Posta",,0.000014,102,1,1,2,15979,15979,31958,44,0.06839,0.089538,148,0,0
8575339,"Savosa, Roncaccio",,0.000023,102,1,1,2,15979,15979,31958,43,0.073158,0.097863,401,0,0
8575340,"Savosa, Paese",,0.00003,102,1,1,2,15979,15979,31958,42,0.078661,0.108431,652,0,0
8575341,"Porza, Paese",,0.000037,102,1,1,2,15979,15979,31958,41,0.085081,0.122418,901,0,0
8575345,"Vezia, Marnigo",,0.000042,102,2,1,3,29202,29202,58404,40,0.083139,0.114509,236.45,0,0
8575347,"Cureglia, Paese",,0.000045,102,2,1,3,16139,16139,32278,38,0.074435,0.090877,1136,0,0
8575348,"Cureglia, Grotti",,0.000049,102,1,1,2,16139,15723,31862,37,0.080136,0.099434,1356,0,0
8575349,"Carnago, Deca",,0.000053,102,1,2,3,15723,15723,31446,36,0.086809,0.111216,1574,0,0
8575350,"Carnago, Paese",,0.000033,102,1,1,2,7952,8920,16872,36,0.086527,0.108042,0,0,0
8575352,"Ponte Capriasca, Nogo",,0.000091,102,4,2,6,25079,24844,49923,34,0.103848,0.14003,6978.666667,0,0
8575353,"Ponte Capriasca, Paese",,0.000049,102,1,1,2,23876,24382,48258,33,0.090999,0.11042,5031,0,0
8575354,"Ponte Capriasca, Crano",,0.000053,102,1,1,2,24382,24382,48764,32,0.099747,0.124005,5222,0,0
8575356,"Vaglio, Piccolo Vaglio",,0.00004,102,2,1,3,27770,27770,55540,30,0.100219,0.120195,5031,0,0
8575357,"Vaglio, Paese",,0.000045,102,1,1,2,27770,27770,55540,29,0.110976,0.136534,5216,0,0
8575361,"Arosio, Cimaronco",,0.00004,81,2,1,3,8521,8511,17032,28,0.089504,0.106698,3893,0,0
8575362,"Arosio, Cappella di Toma",,0.000045,81,1,1,2,8511,8533,17044,27,0.097908,0.11881,4073,0,0
8575687,"Croglio, Bivio di Luzzo",,0.000059,81,1,2,3,7715,7715,15430,17,0.111111,0.14062,1776,0,0
8575844,"Curio, Molino di Curio",,0.00006,81,1,1,2,16601,16097,32698,17,0.110696,0.13499,624,0,0
8575365,"Arosio, Paese",,0.000027,81,1,1,2,8283,8533,16816,30,0.074355,0.086905,360,0,0
8575366,"Mugena, Nava",,0.000034,81,1,1,2,8533,8533,17066,29,0.08,0.093695,532,0,0
8575367,"Mugena, Paese",,0.00004,81,1,1,2,8533,8533,17066,28,0.0866,0.101974,702,0,0
8575368,"Vezio, Busgnone",,0.000045,81,1,1,2,8533,8533,17066,27,0.094421,0.112335,870,0,0
8575369,"Vezio, Paese",,0.000049,81,1,1,2,8533,8533,17066,26,0.103835,0.125784,1036,0,0
8575850,"Miglieglia, Cassinelle",,0.000064,81,3,4,7,13276,13407,26683,15,0.136496,0.176397,3802,0,0
8575906,"Taverne, Superiore",,0.00007,102,2,2,4,12850,12850,25700,15,0.135922,0.169085,1680,0,0
8575373,"Breno, Crocevia per Breno",,0.000046,81,3,2,5,14030,13921,27951,22,0.098094,0.125319,3546.333333,0,0
8582392,"Bedigliora, Scuola Media",,0.000151,81,5,1,6,8856,566,9422,1,1,1,15,0,0
8580035,"Paradiso, Debarcadero",,0.000071,102,3,3,6,70231,69382,139613,12,0.207221,0.253764,773.253632,0,0
8580039,"Grancia, Centro Lugano Sud",,0.000073,102,3,2,5,31042,31147,62189,12,0.205975,0.248068,618.386966,0,0
8580748,"Morcote, Preda dei Buchi",,0.000034,102,1,1,2,9435,9193,18628,12,0.202532,0.236955,249,0,0
8575378,"Castagnola, Roncaccio",,0.000014,102,1,1,2,17841,17841,35682,14,0.121179,0.138119,1,0,0
8575379,"Gandria, Strada",,0.000014,102,1,1,2,6615,6615,13230,14,0.121179,0.138119,1,0,0
8575393,"Aranno, Prümé",,0.000037,81,1,2,3,8221,8221,16442,22,0.06832,0.092991,878,0,0
8575383,"Bioggio, Cuccarello",,0.00003,102,1,1,2,8218,8218,16436,16,0.108019,0.119703,1166.166667,0,0
8575384,"Bosco Luganese, Campolungo",,0.000036,102,1,1,2,8218,8218,16436,15,0.120357,0.132708,1284.166667,0,0
8575385,"Bosco Luganese, Chiesa",,0.000042,102,1,1,2,8218,8218,16436,14,0.13598,0.149703,1400.166667,0,0
8575386,"Cademario, S. Ambrogio",,0.000046,102,1,1,2,8218,8218,16436,13,0.156403,0.172951,1514.166667,0,0
8575387,"Cademario, Chiesa",,0.00005,102,1,1,2,8218,8218,16436,12,0.184241,0.207016,1626.166667,0,0
8575391,"Aranno, Flora",,0.000023,81,1,1,2,8221,8221,16442,24,0.060916,0.079546,774,0,0
8575392,"Aranno, Maestà",,0.00003,81,1,1,2,8221,8221,16442,23,0.064394,0.084646,827,0,0
8575394,"Agno, Posta / FLP",,0.000046,81,2,1,3,9526,9526,19052,22,0.067848,0.086222,208,0,0
8575395,"Agno, Chiesa",,0.000065,81,2,1,3,9693,9693,19386,21,0.072243,0.092011,1194,0,0
8575396,"Cassina d'Agno, Posta",,0.000066,81,1,1,2,9693,9693,19386,20,0.077283,0.099784,1232,0,0
8575397,"Neggio, Bivio per Neggio",,0.000067,81,1,2,3,9693,9666,19359,19,0.083122,0.112584,1268,0,0
8575399,"Vernate, Pianca",,0.000044,81,1,1,2,9693,9693,19386,19,0.082009,0.102702,129,0,0
8575398,"Vernate, Guasti di Vernate",,0.000039,81,1,1,2,8104,9693,17797,20,0.076336,0.094909,97,0,0
8575401,"Vernate, Bacino Acqua Potabile",,0.000044,81,1,1,2,8043,8221,16264,1,1,1,100,0,0
8575403,"Magliaso, Stazione",,0.000045,81,4,1,5,16583,16135,32718,20,0.092205,0.111508,2462,0,0
8575406,"Novaggio, alla Colombina",,0.000049,81,3,3,6,13387,13754,27141,16,0.124289,0.161296,1451.666667,0,0
8575407,"Breno, Ponte di Vello",,0.000025,81,1,2,3,5538,5538,11076,16,0.123577,0.155778,0,0,0
8575845,"Curio, Bivio",,0.000103,81,3,3,6,24201,20281,44482,16,0.123633,0.160086,2997.333333,0,0
8575411,"Tesserete, Resega",,0.00002,102,1,1,2,7940,7940,15880,18,0.095537,0.110666,460,0,0
8575412,"Pezzolo, Canvetto Tiratori",,0.000028,102,1,1,2,7940,7940,15880,17,0.104857,0.120864,504,0,0
8575413,"Pezzolo, Paese",,0.000035,102,1,1,2,7940,7940,15880,16,0.116279,0.133892,546,0,0
8575414,"Odogno, Paese",,0.000041,102,1,1,2,7940,7940,15880,15,0.130604,0.151215,586,0,0
8575415,"Odogno, Bivio per Bettagno",,0.000045,102,1,1,2,7940,7940,15880,14,0.149103,0.175641,624,0,0
8575416,"Lelgio, Paese",,0.000049,102,1,1,2,7940,7940,15880,13,0.173913,0.213645,660,0,0
8579006,"Lugano, Vignola",,0.000041,102,3,3,6,64276,64276,128552,12,0.195876,0.245883,195.88254,0,0
8580037,"Savosa, Liceo",,0.000083,102,5,2,7,15256,14373,29629,13,0.176235,0.222273,7846.976876,0,0
8580038,"Comano, Quattro Strade",,0.000055,102,3,2,5,15934,15979,31913,13,0.174142,0.217433,277.773052,0,0
8575422,"Tesserete, Al Ponte",,0.00002,102,1,2,3,12818,12818,25636,30,0.048035,0.067617,4500,0,0
8575423,"Tesserete, Campestro",,0.00002,80,1,1,2,6824,6824,13648,46,0.02821,0.040807,2325,0,0
8575424,"Lopagno, Paese",,0.000028,80,1,1,2,6824,6824,13648,45,0.028898,0.041475,2452,0,0
8575425,"Lopagno, Ronchetto",,0.000034,80,1,1,2,6824,6824,13648,44,0.029623,0.042184,2577,0,0
8575426,"Roveredo TI, Miera",,0.00004,80,1,1,2,6824,6824,13648,43,0.030388,0.042936,2700,0,0
8575427,"Roveredo TI, Paese",,0.000045,80,1,1,2,6824,6824,13648,42,0.031196,0.043737,2821,0,0
8575428,"Treggia, Paese",,0.000049,80,1,1,2,6824,6824,13648,41,0.032052,0.044592,2940,0,0
8575429,"Bidogno, Bivio per Carusio",,0.000053,80,1,1,2,6824,6824,13648,40,0.03296,0.045509,3057,0,0
8575430,"Bidogno, Paese",,0.000056,80,1,1,2,6824,6824,13648,39,0.033925,0.046498,3172,0,0
8575431,"Bidogno, Bivio per Somazzo",,0.000058,80,1,1,2,6824,6824,13648,38,0.034952,0.047568,3285,0,0
8575432,"Bidogno, Ventiga",,0.00006,80,1,1,2,6824,6941,13765,37,0.036048,0.048735,3396,0,0
8575433,"Bidogno, ai Mulini",,0.000062,80,1,1,2,6941,6941,13882,36,0.03722,0.050019,3505,0,0
8575434,"Corticiasca, Puffino",,0.000064,80,1,1,2,6941,6941,13882,35,0.038476,0.051449,3612,0,0
8575435,"Corticiasca, Paese",,0.000065,80,1,1,2,6941,6808,13749,34,0.039825,0.053071,3717,0,0
8575436,"Corticiasca, Vecchia",,0.000066,80,1,1,2,6808,6808,13616,33,0.041278,0.054963,3820,0,0
8575437,"Insone, ai Corte",,0.000067,80,1,1,2,6808,6808,13616,32,0.042848,0.057281,3921,0,0
8575438,"Insone, Bivio per Insone",,0.000068,80,1,1,2,6808,13616,20424,31,0.04455,0.060418,4020,0,0
8575439,"Insone, Stella",,0.000069,80,1,2,3,13616,13046,26662,30,0.046401,0.065979,4117,0,0
8575448,"Bogno, Paese",,0.000064,80,1,2,3,6705,6705,13410,21,0.074102,0.091997,4832,0,0
8575458,"Maglio di Colla, Paese",,0.000087,80,2,2,4,12212,12299,24511,20,0.079494,0.097179,8104,0,0
8575440,"Insone, Paese",,0.00004,80,1,1,2,5431,6808,12239,29,0.048011,0.059486,4144,0,0
8575441,"Scareglia, Paese",,0.000045,80,1,1,2,6808,6808,13616,28,0.050185,0.061654,4237,0,0
8575442,"Signôra, Paese",,0.000049,80,1,1,2,6808,6808,13616,27,0.052577,0.064076,4328,0,0
8575443,"Signôra, Crana",,0.000053,80,1,1,2,6808,6808,13616,26,0.05522,0.066807,4417,0,0
8575444,"Colla, Paese",,0.000056,80,1,1,2,6808,6808,13616,25,0.058156,0.069926,4504,0,0
8575445,"Colla, Chiesa",,0.000058,80,1,1,2,6808,6705,13513,24,0.061439,0.073556,4589,0,0
8575446,"Cozzo, Paese",,0.00006,80,1,1,2,6705,6705,13410,23,0.065132,0.07791,4672,0,0
8575447,"Bogno, Cappella di Bogno",,0.000062,80,1,1,2,6705,6705,13410,22,0.069317,0.083467,4753,0,0
8575457,Malpensata (Valcolla),,0.000058,80,1,1,2,6022,6022,12044,21,0.07399,0.087915,3044,0,0
8575449,"Cagiallo, Paese",,0.00002,80,1,1,2,5994,5994,11988,29,0.047966,0.059318,2220,0,0
8575450,"Cagiallo, S. Matteo",,0.000028,80,1,1,2,5994,5994,11988,28,0.050136,0.061449,2330,0,0
8575451,"Oggio, Fornaci",,0.000034,80,1,1,2,5994,5994,11988,27,0.052522,0.063819,2438,0,0
8575452,"Oggio, Paese",,0.00004,80,1,1,2,5994,5994,11988,26,0.055159,0.066475,2544,0,0
8575453,"Oggio, Fiume bello",,0.000045,80,1,1,2,5994,5994,11988,25,0.058089,0.069482,2648,0,0
8575454,"Curtina, Posta Vecchia",,0.000049,80,1,1,2,5994,5994,11988,24,0.061363,0.072928,2750,0,0
8575455,"Curtina, Paese",,0.000053,80,1,1,2,5994,6022,12016,23,0.065046,0.076948,2850,0,0
8575456,"Piandera, Molini",,0.000056,80,1,1,2,6022,6022,12044,22,0.06922,0.081775,2948,0,0
8575459,"Bogno, Ponte del Morel",,0.000104,80,3,1,4,14409,13087,27496,3,0.5,0.611111,387,0,0
8575460,"Certara, Cardaiolo",,0.0001,80,1,1,2,13087,5458,18545,2,0.666667,0.75,260,0,0
8575461,"Certara, Paese",,0.000096,80,1,1,2,5458,6279,11737,1,1,1,131,0,0
8575462,"Piandera, Bivio per Cimadera",,0.000048,80,1,1,2,6020,4801,10821,19,0.084369,0.094473,7758,0,0
8575463,"Cimadera, Paese",,0.000052,102,1,1,2,4801,5764,10565,18,0.091659,0.101831,7818,0,0
8575464,"Piandera, Bivio per Piandera",,0.000055,102,1,1,2,5764,5764,11528,17,0.100374,0.110767,7876,0,0
8575465,"Cimadera, Treciò",,0.000058,102,1,1,2,5764,5764,11528,16,0.110979,0.121859,7932,0,0
8575466,"Sonvico, Mugnai",,0.00006,102,1,1,2,5764,5764,11528,15,0.124166,0.136014,7986,0,0
8575467,"Sonvico, Madonna d'Arla",,0.000062,102,1,1,2,5764,5764,11528,14,0.141006,0.154758,8038,0,0
8575469,"Sonvico, Sassello",,0.000087,102,2,1,3,25730,25730,51460,12,0.194062,0.220527,8689.4,0,0
8578998,"Porza, Belvedere",,0.000032,102,1,1,2,16680,16692,33372,12,0.187366,0.210279,817.202381,0,0
8580697,"Tesserete, Scuole",,0.000173,102,7,7,14,35841,35597,71438,12,0.208931,0.28732,11184.982395,0,0
8588290,"Massagno, Vicolo Vecchio",,0.000088,102,5,5,10,57607,49815,107422,9,0.278443,0.348007,1778.293038,0,0
8588973,"Lugano, Autosilo",,0.000092,102,5,3,8,69164,73377,142541,9,0.269006,0.326428,1690.213492,0,0
8575471,Zilacher b. Rosshäusern,,0.000052,44,2,1,3,2677,2677,5354,3,0.5,0.611111,48,0,0
8578974,"Locarno, S. Antonio Chiesa",,0.000048,101,2,1,3,17316,17316,34632,22,0.072569,0.088235,1040.5,0,0
8575476,"Tegna, Paese (bus)",,0.000024,101,1,1,2,428,428,856,33,0.082643,0.099144,84,0,0
8575477,"Verscio, Paese (bus)",,0.000032,101,1,1,2,428,428,856,32,0.089888,0.110847,490,0,0
8575479,"Cresmino, Funivia",,0.00004,101,2,1,3,5370,5370,10740,54,0.031788,0.03817,1160,0,0
8575480,"Cresmino, Cratolo",,0.000045,101,1,1,2,5370,5370,10740,53,0.032763,0.039217,1599,0,0
8575481,"Auressio, Paese",,0.000049,101,1,1,2,5370,5370,10740,52,0.033802,0.040347,2036,0,0
8575482,"Loco, Chiesa / CSO",,0.000052,101,1,1,2,5370,5370,10740,51,0.034912,0.041574,2471,0,0
8575483,"Berzona, Salei",,0.000055,101,1,1,2,5370,5370,10740,50,0.036099,0.042914,2904,0,0
8575484,Berzona (Onsernone),,0.000058,101,1,1,2,5370,5370,10740,49,0.037372,0.044388,3335,0,0
8575485,"Mosogno, Chiosso",,0.00006,101,1,1,2,5370,5370,10740,48,0.038741,0.046026,3764,0,0
8575486,"Mosogno, Paese",,0.000062,101,1,1,2,5370,5370,10740,47,0.040218,0.047877,4191,0,0
8575487,"Mosogno, Barione",,0.000064,101,1,1,2,5370,5370,10740,46,0.041814,0.050027,4616,0,0
8575488,Russo,,0.000065,101,1,1,2,5370,7804,13174,45,0.043547,0.052668,5039,0,0
8575489,"Crana, Ponte Oscuro",,0.000066,101,1,2,3,7804,7804,15608,44,0.045433,0.056535,5460,0,0
8575490,"Crana, alle  Bolle",,0.000039,101,1,1,2,5370,5370,10740,43,0.04688,0.05397,5522,0,0
8575491,"Crana, Paese",,0.000044,101,1,1,2,5370,5370,10740,42,0.049079,0.056456,5932,0,0
8575492,Vocaglia,,0.000048,101,1,1,2,5370,5370,10740,41,0.0515,0.059244,6340,0,0
8575493,"Comologno, Dazio",,0.000052,101,1,1,2,5370,5370,10740,40,0.054178,0.062395,6746,0,0
8575494,Corbella,,0.000055,101,1,1,2,5370,5370,10740,39,0.057157,0.065991,7150,0,0
8575495,"Comologno, Paese",,0.000058,101,1,1,2,5370,5370,10740,38,0.06049,0.070139,7552,0,0
8575496,"Comologno, Cappellino",,0.00006,101,1,1,2,5370,5370,10740,37,0.064243,0.07499,7952,0,0
8575497,Spruga,,0.000062,101,1,1,2,5370,5370,10740,36,0.068503,0.080757,8350,0,0
8575498,"Vergeletto, alla Colletta",,0.000039,101,1,1,2,2434,2434,4868,5,0.3,0.413889,306,0,0
8575499,"Vergeletto, Villa Olandesi",,0.000044,101,1,1,2,2434,2434,4868,4,0.357143,0.466667,260,0,0
8575500,"Vergeletto, Bivio Gresso",,0.000048,101,1,1,2,2434,2918,5352,3,0.444444,0.541667,212,0,0
8575501,"Vergeletto, Chiesa",,0.000052,101,1,1,2,2918,2918,5836,2,0.6,0.666667,162,0,0
8575502,"Vergeletto, Piazza",,0.000055,101,1,2,3,2918,2332,5250,1,1,1,110,0,0
8575503,Gresso,,0.000034,101,1,1,2,2190,992,3182,1,1,1,0,0,0
8575505,"Contra, alle Zotte",,0.000036,101,1,1,2,11466,11466,22932,15,0.13301,0.151536,214,0,0
8575506,"Contra, al Ronco",,0.000042,101,1,1,2,11466,11466,22932,14,0.152296,0.175975,252,0,0
8578992,"Orselina, Caselle",,0.000051,101,1,1,2,6331,6331,12662,14,0.152296,0.175975,509,0,0
8575509,"Berzona (Verzasca), Fontöbbia",,0.000036,101,1,1,2,8355,8355,16710,40,0.053097,0.060663,882,0,0
8575510,"Vogorno, S. Antonio",,0.000042,101,1,1,2,8355,8355,16710,39,0.055952,0.063969,1239,0,0
8575511,"Corippo, Pontid",,0.000046,101,1,1,2,8355,8355,16710,38,0.059138,0.067748,1594,0,0
8575512,"Brione (Verzasca), Chiosetto",,0.00005,101,1,1,2,8355,8355,16710,37,0.062716,0.072115,1947,0,0
8575513,"Brione (Verzasca), Sottomuro",,0.000054,101,1,1,2,8355,8355,16710,36,0.066765,0.077231,2298,0,0
8575514,"Gerra (Verzasca), Predell",,0.000056,101,1,1,2,8355,8355,16710,35,0.071383,0.083323,2647,0,0
8575515,"Gerra (Verzasca), al Ponte",,0.000059,101,1,1,2,8355,8355,16710,34,0.0767,0.090738,2994,0,0
8575516,"Frasco, Torbola",,0.000061,101,1,1,2,8355,8355,16710,33,0.082887,0.100034,3339,0,0
8575517,"Frasco, Chiesa",,0.000063,101,1,1,2,8355,8355,16710,32,0.090177,0.112226,3682,0,0
8579876,"Savièse, Drône parking",,0.000057,39,2,1,3,1253,1336,2589,19,0.126253,0.163197,64,0,0
8575521,"Quartino, Scuole",,0.000039,108,3,1,4,12216,13966,26182,33,0.045893,0.06741,240,0,0
8575522,"Quartino, Stazione",,0.000044,108,1,1,2,13966,13966,27932,32,0.047752,0.070269,360,0,0
8575523,"Quartino, Bivio",,0.000049,108,1,1,2,13966,13966,27932,31,0.04978,0.073706,478,0,0
8575524,"Magadino, al Ponte",,0.000052,108,1,1,2,13966,13966,27932,30,0.052003,0.077997,594,0,0
8575526,"Magadino, Debarcadero",,0.000129,108,4,1,5,27179,27415,54594,28,0.057155,0.092105,2310,0,0
8575527,"Magadino-Vira, Stazione",,0.00012,108,1,3,4,27415,27415,54830,27,0.060164,0.108466,2413,0,0
8575534,"S. Nazzaro, Fontanella",,0.000044,108,1,1,2,4652,4652,9304,27,0.057313,0.08235,295,0,0
8575537,"Piazzogna, Belsito",,0.00008,108,1,3,4,12478,12478,24956,24,0.067441,0.114093,2757,0,0
8575528,"Vira (Gambarogno), la Riva",,0.000045,108,1,1,2,18618,18618,37236,27,0.057608,0.081021,186,0,0
8575529,"Vira (Gambarogno), Vignascia",,0.000049,108,1,1,2,18618,18618,37236,26,0.060663,0.087029,285,0,0
8575530,Alabardia,,0.000053,108,1,2,3,18618,18618,37236,25,0.064083,0.09731,382,0,0
8575532,"S. Nazzaro, Taverna",,0.000033,108,1,1,2,4652,4652,9304,29,0.052177,0.074213,113,0,0
8575533,"S. Nazzaro, 5 Fonti",,0.000039,108,1,1,2,4652,4652,9304,28,0.054616,0.077844,205,0,0
8575535,"Vairano, Bivio per S. Nazzaro",,0.000083,108,2,1,3,12714,11807,24521,26,0.060311,0.088286,2587,0,0
8575536,"Piazzogna, Parco Botanico",,0.000081,108,1,1,2,11807,12478,24285,25,0.063665,0.097031,2673,0,0
8575542,"Indemini, Pezze",,0.00007,108,1,2,3,2528,2528,5056,24,0.065592,0.100305,354,0,0
8575556,"Gerra (Gambarogno), Paese",,0.000033,108,1,1,2,13966,13966,27932,24,0.062394,0.082892,330,0,0
8575538,"Vira (Gambarogno), Edifors",,0.000068,108,2,1,3,2528,2528,5056,27,0.056044,0.078795,120,0,0
8575539,"Monti di Fosano, Oratorio",,0.000068,108,1,1,2,2528,2528,5056,26,0.058881,0.083312,200,0,0
8575540,"Indemini, Monti in Cima al Pra",,0.000069,108,1,1,2,2528,2528,5056,25,0.062044,0.089508,278,0,0
8575543,"Riazzino, al Bosco",,0.000036,101,1,1,2,11569,11569,23138,23,0.067766,0.081511,686,0,0
8575544,"Riazzino, Bugaro",,0.000042,101,1,1,2,11569,11569,23138,22,0.0722,0.085899,735,0,0
8575545,"Agarone, Chiossette",,0.000046,101,1,1,2,11569,11569,23138,21,0.07729,0.091006,782,0,0
8575546,"Agarone, Bivio per Cugnasco",,0.00005,101,1,1,2,11569,11569,23138,20,0.08319,0.097027,827,0,0
8575547,"Agarone, Ronco Morasci",,0.000054,101,1,1,2,11569,11569,23138,19,0.090113,0.104244,870,0,0
8575548,"Agarone, Roccolo",,0.000056,101,1,1,2,11569,11569,23138,18,0.098349,0.113068,911,0,0
8575549,"Vira (Gambarogno), Bellavista",,0.000063,108,2,1,3,8561,7826,16387,7,0.25,0.370408,308,0,0
8575550,"Casenzano, Roncaccio",,0.000064,108,1,1,2,7826,7826,15652,6,0.285714,0.408333,270,0,0
8575551,"Casenzano, Paese",,0.000066,108,1,1,2,7826,7826,15652,5,0.333333,0.456667,230,0,0
8575552,"Casenzano, la Tempelina",,0.000067,108,1,1,2,7826,7826,15652,4,0.4,0.520833,188,0,0
8575553,"Casenzano, Maggiolo",,0.000068,108,1,1,2,7826,7826,15652,3,0.5,0.611111,144,0,0
8575554,"Ronco (Gambarogno), Paese",,0.000068,108,1,1,2,7826,7826,15652,2,0.666667,0.75,98,0,0
8575555,"Ronco (Gambarogno), Str. Lozze",,0.000069,108,1,1,2,7826,7826,15652,1,1,1,50,0,0
8575557,"S. Nazzaro, Paese",,0.000091,108,3,1,4,18618,13966,32584,23,0.065941,0.086855,3358,0,0
8575558,"S. Nazzaro, Molinetto",,0.000089,108,1,1,2,13966,13966,27932,22,0.069948,0.091554,3421,0,0
8575559,"Gerra (Gambarogno), Cimitero",,0.000086,108,1,1,2,13966,13966,27932,21,0.074513,0.097282,3482,0,0
8575561,"Ranzo, Bivio per S. Abbondio",,0.000162,108,2,1,3,14190,16904,31094,19,0.085854,0.114629,47593,0,0
8575562,"Ranzo, Paese",,0.000149,108,1,2,3,16904,19826,36730,18,0.093023,0.131577,47229,0,0
8575563,"Dirinella, Bivio per Caviano",,0.000074,108,1,2,3,16888,16888,33776,17,0.098214,0.131636,44983,0,0
8575564,"Dirinella, Confine",,0.000042,108,1,1,2,13966,13966,27932,16,0.104097,0.124916,42727,0,0
8575565,"Ranzo-S. Abbondio, Stazione",,0.000074,108,1,1,2,2938,2938,5876,3,0.5,0.611111,1410,0,0
8575566,"Ranzo, Piccolo Mondo",,0.000074,108,1,1,2,2938,2938,5876,2,0.666667,0.75,942,0,0
8575567,"S. Abbondio, Bivio Calgiano",,0.000074,108,1,1,2,2938,2938,5876,1,1,1,472,0,0
8575569,"Caviano, Casa Fois",,0.000042,108,1,1,2,2922,2922,5844,3,0.5,0.611111,1413,0,0
8575570,"Caviano, Paese",,0.000047,108,1,1,2,2922,2922,5844,2,0.666667,0.75,944,0,0
8575571,"Scaiano, Casa Lulita",,0.000051,108,1,1,2,2922,2922,5844,1,1,1,473,0,0
8575573,"Mendrisio, Stazione",,0.000056,99,3,5,8,27472,122867,150339,24,0.154236,0.224039,1443.75,0,0
8575645,"Meride, Campeggio",,0.000036,99,2,1,3,10698,10698,21396,12,0.17126,0.211103,104,0,0
8575602,"Novazzano, Ponte Pobbia",,0.000071,99,1,3,4,18426,18426,36852,27,0.12442,0.180943,1798,0,0
8575605,"Chiasso, Centro Sportivo",,0.000044,99,2,1,3,11650,11650,23300,28,0.115076,0.152617,316,0,0
8575607,"Genestrerio, Croce Grande",,0.000073,99,3,2,5,30925,30895,61820,27,0.129218,0.183158,1336.6,0,0
8575620,"Gaggiolo, Confine",,0.000054,99,1,2,3,16530,16530,33060,13,0.180915,0.224918,335.25,0,0
8575628,"Balerna, Piazza",,0.000051,99,3,6,9,53349,53349,106698,26,0.150943,0.25076,1714.4,0,0
8575768,"Chiasso, Via Volta",,0.000053,99,3,6,9,33183,67406,100589,25,0.147727,0.248085,2304.253968,0,0
8575770,"Chiasso, Boffalora",,0.000026,99,2,4,6,51903,61482,113385,32,0.12168,0.216943,263.912698,0,0
8575575,"Mendrisio, Borgo",,0.00002,99,1,1,2,20127,20147,40274,23,0.096527,0.116399,312,0,0
8575576,"Mendrisio, Filanda",,0.000028,99,1,2,3,20147,20176,40323,22,0.106189,0.132307,467,0,0
8575577,"Castel S.Pietro, al Mulino",,0.000023,99,1,1,2,13332,13332,26664,21,0.109937,0.131914,477.428571,0,0
8575578,"Castel S.Pietro, Bv.Corteglia",,0.00003,99,1,1,2,13332,13332,26664,20,0.122724,0.150287,622.428571,0,0
8575579,"Castel S.Pietro,Pte Loverciano",,0.000037,99,1,1,2,13332,13332,26664,19,0.138989,0.177348,765.428571,0,0
8575580,"Castel S.Pietro, Posta",,0.000042,99,1,4,5,13332,17171,30503,18,0.160377,0.224714,906.428571,0,0
8575608,"Genestrerio, Piazza",,0.000062,99,2,2,4,28697,28697,57394,26,0.132316,0.194365,1528.733333,0,0
8575651,"Sagno, Paese",,0.000018,99,1,2,3,8136,8305,16441,25,0.124765,0.178642,42,0,0
8575784,"Morbio Superiore, Croce",,0.000052,99,1,1,2,13257,13257,26514,25,0.111607,0.149198,627,0,0
8575581,"Castel S.Pietro, al Roccolo",,0.00002,99,1,1,2,3839,3839,7678,19,0.07907,0.098867,280,0,0
8575582,"Castel S.Pietro, Obino",,0.000028,99,1,1,2,3839,3839,7678,18,0.085017,0.105209,367,0,0
8575583,"Campora, Chiesa",,0.000034,99,1,1,2,3839,3839,7678,17,0.091996,0.112964,452,0,0
8575585,"Monte, Paese",,0.00004,99,1,1,2,3839,3839,7678,16,0.100304,0.122766,535,0,0
8575586,"Monte, Grotto del Lauro",,0.000045,99,1,1,2,3839,3839,7678,15,0.11036,0.135887,616,0,0
8575587,"Casima, Paese",,0.000049,99,1,2,3,3839,3839,7678,14,0.122785,0.156279,695,0,0
8575797,"Cabbio, S. Rocco",,0.000057,99,1,1,2,8913,8913,17826,14,0.12232,0.148547,1302,0,0
8577352,"Muggio, Marenca",,0.000062,99,2,3,5,11801,11801,23602,11,0.180435,0.241654,1412,0,0
8575590,"Genestrerio, Canova",,0.000022,99,2,3,5,18426,18426,36852,31,0.087487,0.123265,126,0,0
8575595,"Brusata (Novazzano), al Gaggio",,0.000044,99,1,1,2,8995,8967,17962,32,0.078885,0.098731,668,0,0
8575596,"Novazzano, Bivio Boscherina",,0.000054,99,2,1,3,12355,15038,27393,31,0.085128,0.107941,830,0,0
8575591,"Brusata (Novazzano), Costa",,0.000017,99,1,1,2,11650,11650,23300,36,0.061181,0.076587,40,0,0
8575592,"Brusata (Novazzano), Nord",,0.000025,99,1,1,2,11650,11650,23300,35,0.064787,0.080777,200,0,0
8575593,"Brusata (Novazzano), Dogana",,0.000032,99,1,1,2,11650,11650,23300,34,0.068867,0.085687,358,0,0
8575594,"Brusata (Novazzano), Paese",,0.000039,99,1,1,2,11650,8995,20645,33,0.073523,0.091549,514,0,0
8575598,"Novazzano, Casate",,0.000063,99,2,2,4,18426,18426,36852,30,0.092489,0.121346,1218,0,0
8575599,"Novazzano, Chiesa",,0.000038,99,1,1,2,9452,9371,18823,30,0.09198,0.115988,0,0,0
8575600,"Novazzano, Moronaccio",,0.00007,99,2,1,3,18345,18426,36771,29,0.100679,0.129722,1512,0,0
8575601,"Novazzano, Fercasa",,0.00007,99,1,1,2,18426,18426,36852,28,0.111264,0.149093,1656,0,0
8575603,"Balerna, Passeggiata",,0.000031,99,1,2,3,11650,11650,23300,29,0.104371,0.138388,42,0,0
8575604,"Balerna, Via Ciseri",,0.000024,99,1,1,2,5586,5586,11172,29,0.103786,0.132969,0,0,0
8575609,"Ligornetto, Crocevia Bullani",,0.000037,99,1,1,2,22633,22359,44992,32,0.083065,0.104297,273,0,0
8575610,"Ligornetto, Paese",,0.000043,99,1,1,2,22359,22359,44718,31,0.090006,0.114143,401,0,0
8575611,"Ligornetto, alla Passeggiata",,0.000047,99,1,1,2,22359,22369,44728,30,0.098266,0.127131,527,0,0
8575612,"S. Pietro di Stabio, Bivio",,0.000051,99,1,2,3,22369,22434,44803,29,0.108262,0.146296,651,0,0
8575613,"S. Pietro di Stabio, Posta",,0.000033,99,1,1,2,21098,21098,42196,29,0.107627,0.140643,0,0,0
8575614,"Stabio, Municipio",,0.00006,99,2,1,3,22434,22836,45270,28,0.119808,0.163376,893,0,0
8575617,"Stabio, Dazio Vecchio",,0.000042,99,2,1,3,16530,16530,33060,16,0.120205,0.14166,161.25,0,0
8575618,"Stabio, Case Rapelli",,0.000046,99,1,1,2,16530,16530,33060,15,0.135174,0.159263,221.25,0,0
8575619,"Stabio, Madonnina",,0.00005,99,1,1,2,16530,16530,33060,14,0.154622,0.184316,279.25,0,0
8583240,"Genestrerio, Cimitero",,0.000054,99,3,2,5,25299,25309,50608,11,0.217742,0.287545,915.95,0,0
8583409,"Novazzano, Boscherina 1",,0.000025,99,1,1,2,3388,3388,6776,13,0.168919,0.214095,128.583333,0,0
8575621,"Salorino, Bivio per Salorino",,0.000023,99,1,1,2,6844,6844,13688,16,0.107011,0.128027,132.571429,0,0
8575623,"Salorino, Municipio",,0.00003,99,1,1,2,6844,6844,13688,15,0.118457,0.140416,208.571429,0,0
8575624,"Salorino, Chiesa",,0.000037,99,1,1,2,6844,6844,13688,14,0.132812,0.156751,282.571429,0,0
8575625,"Salorino, Gruppello",,0.000042,99,1,1,2,6844,6844,13688,13,0.151351,0.179441,354.571429,0,0
8575626,"Somazzo, Ciappelloso",,0.000047,99,1,1,2,6844,6844,13688,12,0.176221,0.213632,424.571429,0,0
8575627,"Somazzo, Paese",,0.000051,99,1,2,3,6844,6844,13688,11,0.21134,0.273945,492.571429,0,0
8575641,"Besazio, Fornasella",,0.000058,99,2,4,6,15352,16751,32103,11,0.201794,0.273911,508.8,0,0
8575646,"Meride, Paese",,0.000051,99,2,4,6,11266,11266,22532,11,0.204276,0.276006,530.25,0,0
8575779,"Morbio Inferiore, Posta",,0.000026,99,1,3,4,38337,38337,76674,30,0.118018,0.202681,273.030159,0,0
8575822,"Vacallo, Piazza",,0.000044,99,2,3,5,18631,18631,37262,11,0.191898,0.260808,328.475,0,0
8578870,"Mendrisio, Banchette",,0.000087,99,1,4,5,71853,71823,143676,11,0.211905,0.287775,1639.219048,0,0
8578875,"Capolago, Stazione",,0.000088,99,2,3,5,18082,27447,45529,11,0.189542,0.254362,1719,0,0
8580021,"Chiasso, Rampa",,0.000042,99,3,2,5,48226,48226,96452,11,0.20297,0.274721,420.396032,0,0
8580061,"Mendrisio, Casa Anziani",,0.000048,99,2,3,5,71823,71853,143676,10,0.221902,0.289688,1435.244444,0,0
8580080,"Arzo, Coop",,0.00008,99,5,4,9,27800,13741,41541,9,0.212329,0.283807,1651.422283,0,0
8575649,"Morbio Superiore, Lattecaldo",,0.00002,99,1,3,4,479,10093,10572,20,0.153759,0.214268,329.431746,0,0
8575771,"Morbio Inferiore, Villette",,0.000016,99,1,1,2,14730,14730,29460,31,0.10778,0.161438,35,0,0
8575790,"Morbio Superiore, Ponte Sagno",,0.000071,99,3,3,6,17564,15549,33113,19,0.142077,0.211089,1733.042857,0,0
8575814,"Vacallo, Casa Materna",,0.00003,99,1,3,4,17870,17870,35740,11,0.191358,0.253867,129.525,0,0
8580025,"Chiasso, Scuole",,0.000056,99,3,3,6,13928,13928,27856,11,0.185751,0.254757,725.138645,0,0
8580059,"Mendrisio, Macello",,0.000154,99,9,7,16,92351,87053,179404,10,0.214286,0.309573,4163.527717,0,0
8580067,"Bruzella, Cimitero",,0.000047,99,2,1,3,8899,6457,15356,11,0.182045,0.231241,154.659524,0,0
8580068,"Morbio Inferiore, Serfontana",,0.000135,99,7,5,12,57911,57407,115318,10,0.219512,0.312621,2265.484199,0,0
8575629,"Pura, ai Ronchetti",,0.000052,81,3,1,4,16464,17008,33472,20,0.084499,0.100257,444,0,0
8575630,"Rancate, Cimitero",,0.00002,99,1,1,2,16751,16751,33502,16,0.112372,0.135677,96,0,0
8575631,"Rancate, Posta",,0.000028,99,1,2,3,16751,16751,33502,15,0.12532,0.155366,186,0,0
8575632,"Rancate, Vallechiara",,0.000023,99,1,1,2,8288,8288,16576,15,0.1242,0.146658,0,0,0
8575633,"Besazio, Via Rive",,0.000042,99,2,1,3,16751,16751,33502,14,0.140351,0.166829,360,0,0
8575634,"Besazio, Paese",,0.000047,99,1,1,2,16751,16751,33502,13,0.161565,0.196876,444,0,0
8575635,"Besazio, Crusagh",,0.000051,99,1,3,4,16751,26239,42990,12,0.190669,0.250224,526,0,0
8575638,"Arzo, Bagno Spiaggia",,0.000038,99,1,1,2,7263,7263,14526,12,0.16946,0.209473,182,0,0
8575643,"Tremona, Gurnaga",,0.000031,99,1,2,3,9907,9907,19814,13,0.177062,0.22376,88,0,0
8575636,"Arzo, Posta",,0.000025,99,1,1,2,7168,7263,14431,14,0.128809,0.152753,28,0,0
8575637,"Arzo, San Grato",,0.000032,99,1,1,2,7263,7263,14526,13,0.146264,0.175148,106,0,0
8575642,"Meride, alla Guana",,0.000023,99,1,1,2,9570,9907,19477,14,0.151877,0.182768,18,0,0
8580107,"Mendrisio, Centro Studi 2",,0.000063,99,3,5,8,40474,38900,79374,9,0.246914,0.334034,2407.300855,0,0
8583238,"Arzo, Scuole",,0.000047,99,2,2,4,6507,9575,16082,9,0.181818,0.294221,401.230159,0,0
8575647,"Meride, Fontana di Meride",,0.000022,99,1,1,2,568,568,1136,3,0.5,0.611111,66,0,0
8575648,"Serpiano, Casa Doganale",,0.000029,99,1,1,2,568,568,1136,2,0.666667,0.75,46,0,0
8575650,"Sagno, alla Madonnina",,0.000017,99,1,2,3,9094,9326,18420,20,0.148394,0.19724,20,0,0
8575789,"Morbio Superiore, Verana",,0.000055,99,1,1,2,16142,16142,32284,20,0.125448,0.169624,1221,0,0
8575652,"Peccia, Paese",,0.000044,101,2,3,5,5309,5309,10618,6,0.339286,0.446491,304,0,0
8575656,"Mogno, Paese",,0.000042,101,1,1,2,2439,2439,4878,6,0.322581,0.411667,30,0,0
8575653,"Peccia, Corgello",,0.000023,101,1,1,2,2439,2439,4878,9,0.19403,0.274023,51,0,0
8575654,"Peccia, Cambleo",,0.000031,101,1,1,2,2439,2439,4878,8,0.222222,0.301488,46,0,0
8575655,"Mogno, Colonia Pazzalino",,0.000037,101,1,1,2,2439,2439,4878,7,0.261905,0.341775,39,0,0
8575657,"Ponte Tresa, Stazione",,0.000072,81,4,3,7,29244,29244,58488,25,0.065603,0.0937,3714,0,0
8575658,"Ponte Tresa, Dogana",,0.000031,81,1,1,2,19586,19586,39172,17,0.104869,0.16377,0,0,0
8575659,"Croglio, Ronco Regina",,0.000058,81,2,1,3,21529,21529,43058,16,0.112971,0.17311,2276,0,0
8575660,"Croglio, Madonnone",,0.00006,81,1,1,2,21529,21529,43058,15,0.122642,0.184919,2210,0,0
8575661,"Barico, Bivio per Barico",,0.000062,81,1,1,2,21529,21529,43058,14,0.134409,0.200858,2142,0,0
8575662,"Croglio, Peschiera",,0.000063,81,1,1,2,21529,21529,43058,13,0.149068,0.225,2072,0,0
8575663,"Molinazzo di Monteggio, Lisora",,0.000065,81,1,2,3,21529,21529,43058,12,0.167883,0.273138,2000,0,0
8575664,"Molinazzo di Monteggio,Ressega",,0.000038,81,1,1,2,12148,12148,24296,3,0.5,0.611111,291,0,0
8575665,"Ponte Cremenaga, Roncaccio",,0.000044,81,1,1,2,12148,12148,24296,2,0.666667,0.75,196,0,0
8575666,"Fornasette, Villaggio Vacanze",,0.000048,81,1,1,2,12148,12148,24296,1,1,1,99,0,0
8575668,"Molinazzo di Monteggio,Ramello",,0.000038,81,1,1,2,9381,9381,18762,11,0.166667,0.241603,1538,0,0
8575669,"Monteggio, Bruciata",,0.000044,81,1,1,2,9381,8831,18212,10,0.188889,0.273343,1458,0,0
8575672,"Sessa, S. Maria di Corte",,0.000047,81,2,1,3,9285,9381,18666,12,0.150538,0.240791,684,0,0
8575673,"Sessa, Bonzaglio",,0.000051,81,1,1,2,9381,9381,18762,11,0.164557,0.256108,596,0,0
8575674,"Sessa, Suino",,0.000054,81,1,1,2,9381,9381,18762,10,0.181818,0.274636,506,0,0
8575675,"Monteggio, Tiradelza",,0.000057,81,1,1,2,9381,9381,18762,9,0.203704,0.298088,414,0,0
8575676,"Monteggio, Bivio Fornasette",,0.000059,81,1,1,2,9381,9381,18762,8,0.232558,0.330119,320,0,0
8575677,"Monteggio, Paese",,0.000061,81,1,1,2,9381,9381,18762,7,0.272727,0.380688,224,0,0
8582410,"Sessa, Lanera",,0.00007,81,1,1,2,7772,7759,15531,2,0.666667,0.75,134,0,0
8575680,"Ponte Tresa, Chiesa",,0.000031,81,1,1,2,7715,7157,14872,24,0.064691,0.078976,1377,0,0
8575681,"Ponte Tresa, Fabbrica Tappeti",,0.000037,81,1,1,2,7157,7157,14314,23,0.068719,0.083201,1440,0,0
8575682,"Purasca, Inferiore",,0.000043,81,1,1,2,7157,7157,14314,22,0.073311,0.088142,1501,0,0
8575683,"Purasca, Paese",,0.000047,81,1,1,2,7157,7157,14314,21,0.078594,0.094021,1560,0,0
8575684,"Purasca, Posta Vecchia",,0.000051,81,1,1,2,7157,7157,14314,20,0.084736,0.101176,1617,0,0
8575685,"Barico, Paese",,0.000054,81,1,1,2,7157,7715,14872,19,0.091968,0.110182,1672,0,0
8575686,"Croglio, Paese",,0.000057,81,1,1,2,7715,7715,15430,18,0.100608,0.122189,1725,0,0
8580142,"Fiesso, Paese",,0.000063,108,2,3,5,16569,16650,33219,15,0.152975,0.247553,373.966667,0,0
8580808,"Polmengo, AlpTransit",,0.000099,108,4,3,7,13940,13940,27880,14,0.162939,0.255486,1734.966667,0,0
8581248,"Chiggiogna, Fedoccio",,0.000058,108,2,2,4,12752,12752,25504,13,0.17301,0.241746,1463,0,0
8575690,"Airolo, Funivia",,0.000031,108,1,1,2,3582,3582,7164,10,0.157303,0.242942,1559,0,0
8575691,"Airolo, Cioss di fuori",,0.000038,108,1,1,2,3582,3582,7164,9,0.173333,0.258822,1460,0,0
8575692,"Fontana, Cioss di dentro",,0.000043,108,1,1,2,3582,3582,7164,8,0.193548,0.278075,1359,0,0
8575693,"Fontana, Gerora",,0.000047,108,1,1,2,3582,3582,7164,7,0.22,0.302381,1256,0,0
8575694,Cioss Prato (Bedretto),,0.000051,108,1,1,2,3582,514,4096,6,0.25641,0.335,1151,0,0
8575696,"Airolo, Bivio per Nante",,0.000031,108,1,1,2,1948,1948,3896,1,1,1,112,0,0
8575700,"Maroggia-Melano, Stazione",,0.000056,99,2,1,3,8823,8823,17646,21,0.070087,0.090404,679,0,0
8575701,"Ambrì-Piotta, Stazione",,0.000046,108,3,2,5,20922,20946,41868,18,0.124486,0.165778,4811.133333,0,0
8575705,Arnorengo,,0.000033,108,1,2,3,5065,5065,10130,18,0.126382,0.188964,94,0,0
8575702,"Ambrì, Chiesa",,0.000031,108,1,1,2,18030,18030,36060,19,0.123839,0.163293,3979.133333,0,0
8575704,"Quinto, Morenca",,0.000027,108,1,1,2,5302,5065,10367,19,0.113445,0.156892,129,0,0
8579104,"Pollegio, Centrale d'esercizio",,0.000026,108,1,2,3,12752,12752,25504,16,0.13852,0.196355,1881.9,0,0
8575706,Deggio,,0.000045,108,2,2,4,4136,4136,8272,17,0.115063,0.172486,792,0,0
8575709,Altanca,,0.000042,108,1,1,2,2916,2916,5832,17,0.110169,0.147181,104,0,0
8575707,"Quinto, Ronco",,0.00003,108,1,1,2,2916,2916,5832,19,0.093264,0.127665,236,0,0
8575708,"Piotta, Cresta",,0.000036,108,1,1,2,2916,2916,5832,18,0.100952,0.136261,171,0,0
8575710,"Quinto, S. Martino",,0.000065,108,2,1,3,4136,4136,8272,16,0.121429,0.161682,528,0,0
8575711,Catto,,0.000066,108,1,1,2,4136,4136,8272,15,0.135501,0.18227,457,0,0
8575712,Lurengo,,0.000067,108,1,1,2,4136,2916,7052,14,0.153605,0.215064,384,0,0
8581249,"Airolo, Buco dei Cavalli",,0.000102,108,4,2,6,16752,16680,33432,14,0.162791,0.249734,2219.716667,0,0
8575722,"Faido, Bivio Ospedale",,0.000042,108,3,2,5,4842,4842,9684,17,0.135922,0.193828,1583.866667,0,0
8580119,"Molare, Barescia",,0.000062,108,1,1,2,4060,4060,8120,17,0.131387,0.181732,743,0,0
8575716,Tortengo,,0.000015,108,1,1,2,3993,4007,8000,20,0.09784,0.132348,696,0,0
8575717,"Mairengo, Paese",,0.000024,108,1,2,3,4007,3925,7932,19,0.107042,0.151993,656,0,0
8580123,"Polmengo, Paese",,0.000029,108,1,1,2,3709,3709,7418,19,0.104668,0.135831,74,0,0
8575720,Tarnolgio,,0.000015,108,1,1,2,561,561,1122,19,0.108999,0.141611,116,0,0
8575723,"Faido, Chinchengo",,0.000029,108,1,1,2,4060,4060,8120,26,0.0677,0.095984,1309,0,0
8575724,Primadengo,,0.000035,108,1,1,2,4060,4060,8120,25,0.071741,0.101246,1272,0,0
8575725,Calpiogna,,0.000041,108,1,1,2,4060,4060,8120,24,0.076343,0.107776,1233,0,0
8575726,Campello,,0.000046,108,1,1,2,4060,4060,8120,23,0.081633,0.116289,1192,0,0
8575727,"Molare, Paese",,0.00005,108,1,1,2,4060,4060,8120,22,0.087778,0.1284,1149,0,0
8575728,"Carì, Paese",,0.000053,108,1,2,3,4060,4060,8120,21,0.095006,0.149693,1104,0,0
8575731,Tengia,,0.000025,108,1,1,2,2493,2762,5255,21,0.089835,0.118393,69,0,0
8575730,"Rossura, Paese",,0.000033,108,1,2,3,2762,5524,8286,22,0.087401,0.142341,167,0,0
8580124,"Faido, Ospedale Distrettuale",,0.000085,108,3,2,5,5867,5867,11734,16,0.14916,0.225913,1869.466667,0,0
8580132,"Faido, Pesa Comunale",,0.00003,108,1,2,3,9587,4455,14042,4,0.4375,0.559524,182.733333,0,0
8575733,"Lavorgo, Stazione",,0.000053,108,2,3,5,16037,21428,37465,17,0.133971,0.202941,3167.4,0,0
8575734,"Nivo, Paese",,0.000026,108,1,1,2,4564,4564,9128,2,0.666667,0.75,240,0,0
8575735,"Chironico, Grumo",,0.000033,108,1,1,2,4564,4253,8817,1,1,1,121,0,0
8575736,"Anzonico, Bivio Calonico",,0.000026,108,1,2,3,4112,7567,11679,5,0.388889,0.540476,769.5,0,0
8575738,"Calonico, Paese",,0.00003,108,1,1,2,2886,3455,6341,5,0.333333,0.456667,5,0,0
8575737,"Calonico, Probello",,0.000022,108,1,1,2,6910,2886,9796,6,0.285714,0.408333,121,0,0
8575739,"Anzonico, Paese",,0.000047,108,2,1,3,4112,4112,8224,4,0.4,0.520833,421.5,0,0
8575740,Cavagnago,,0.000051,108,1,1,2,4112,4112,8224,3,0.5,0.611111,301.5,0,0
8575741,"Sobrio, Ronzano",,0.000054,108,1,1,2,4112,4112,8224,2,0.666667,0.75,179.5,0,0
8575742,"Sobrio, Paese",,0.000057,108,1,1,2,4112,318,4430,1,1,1,55.5,0,0
8581104,"Figgione, Bivio per Figgione",,0.000076,108,3,2,5,5793,750,6543,1,1,1,174.766667,0,0
8575743,"Rivera, Caslaccio",,0.000034,102,1,1,2,12850,12850,25700,25,0.06233,0.078536,1709,0,0
8575746,"Rivera, Bricola",,0.000058,102,3,1,4,19521,19521,39042,23,0.070285,0.089772,2008,0,0
8575747,"Bironico, Piazza Guidetti",,0.00006,102,1,2,3,19521,19521,39042,22,0.07512,0.099892,2069,0,0
8575748,"Bironico, Posta",,0.000036,102,1,2,3,6848,6808,13656,22,0.074964,0.09982,784,0,0
8575749,"Bironico, Superiore",,0.000026,102,1,1,2,6631,6671,13302,7,0.25,0.370408,693,0,0
8575750,"Medeglia, alla Motta",,0.000033,102,1,1,2,6671,6671,13342,6,0.285714,0.408333,600,0,0
8575751,"Medeglia, Campaccio",,0.000039,102,1,1,2,6671,6671,13342,5,0.333333,0.456667,505,0,0
8575752,"Medeglia, Drossa",,0.000044,102,1,1,2,6671,6671,13342,4,0.4,0.520833,408,0,0
8575753,"Isone, Mulino",,0.000048,102,1,1,2,6671,6671,13342,3,0.5,0.611111,309,0,0
8575755,"Camignolo, Sopra",,0.000052,102,2,1,3,12850,12850,25700,21,0.077491,0.092257,1393,0,0
8575756,"Camignolo, Sotto",,0.000055,102,1,1,2,12850,12850,25700,20,0.083429,0.098713,1440,0,0
8575757,"Mezzovico, Stazione",,0.000058,102,1,1,2,12850,12850,25700,19,0.090399,0.106598,1485,0,0
8575758,"Mezzovico, Bivio per Vira",,0.00006,102,1,1,2,12850,12850,25700,18,0.098698,0.116536,1528,0,0
8575762,"Sigirino, Bivio",,0.000062,102,1,1,2,12850,10956,23806,17,0.108745,0.129736,1569,0,0
8575763,"Sigirino, Piazza",,0.000063,102,1,2,3,10956,12850,23806,16,0.12116,0.149643,1608,0,0
8575764,"Taverne, Dosso",,0.000038,102,1,1,2,6164,6164,12328,16,0.12041,0.143612,0,0,0
8575765,"Meride, Crocefisso",,0.000036,99,1,1,2,568,568,1136,1,1,1,24,0,0
8575776,"Morbio Inferiore, S. Lucia",,0.000053,99,5,3,8,39374,48187,87561,30,0.119891,0.200993,675.83254,0,0
8575785,"Morbio Superiore, Posta",,0.000079,99,4,2,6,27468,27366,54834,24,0.124623,0.178876,1673.278571,0,0
8581596,"Morbio Superiore, zona Ronco",,0.000045,99,1,1,2,11238,11106,22344,12,0.195122,0.27484,154.145754,0,0
8587122,"Chiasso, Stazione",,0.00019,99,8,5,13,88033,88304,176337,10,0.248649,0.365537,3109.097835,0,0
8587124,"Chiasso, Municipio",,0.000043,99,1,8,9,68712,68704,137416,9,0.27439,0.426279,656.062771,0,0
8587129,"Mendrisio, OSC",,0.000075,99,3,3,6,37646,22961,60607,11,0.230769,0.329139,1972.073077,0,0
8589496,"Chiasso,  Crocione",,0.000031,99,1,1,2,13654,13654,27308,12,0.195122,0.27484,10,0,0
8575780,"Morbio Inferiore, Basilica",,0.000033,99,2,1,3,13257,13257,26514,29,0.079141,0.099879,319,0,0
8575781,"Morbio Inferiore, Piano",,0.000039,99,1,1,2,13257,13257,26514,28,0.085276,0.107774,399,0,0
8575782,"Morbio Inferiore, Pianelle",,0.000044,99,1,1,2,13257,13257,26514,27,0.092498,0.117732,477,0,0
8575783,"Morbio Superiore, Campagna",,0.000048,99,1,1,2,13257,13257,26514,26,0.101124,0.130821,553,0,0
8575786,"Morbio Superiore, Buée",,0.000045,99,1,1,2,16128,16142,32270,23,0.093264,0.11799,1068,0,0
8575787,"Morbio Superiore, Chiesa",,0.000049,99,1,1,2,16142,16142,32284,22,0.101905,0.129885,1121,0,0
8575788,"Morbio Superiore, Chiavarino",,0.000052,99,1,1,2,16142,16142,32284,21,0.112407,0.145989,1172,0,0
8575791,"Caneggio, Sotto Ronco",,0.000031,99,1,1,2,8749,8913,17662,20,0.073782,0.093142,1074,0,0
8575792,"Caneggio, S. Antonio",,0.000037,99,1,1,2,8913,8913,17826,19,0.078886,0.098322,1117,0,0
8575793,"Caneggio, Paese",,0.000042,99,1,1,2,8913,8913,17826,18,0.084803,0.104467,1158,0,0
8575794,"Caneggio, la Costa",,0.000047,99,1,1,2,8913,8770,17683,17,0.091743,0.111892,1197,0,0
8575795,"Bruzella, Paese",,0.000051,99,1,1,2,8770,8913,17683,16,0.1,0.121083,1234,0,0
8575796,"Cabbio, Dossello",,0.000054,99,1,1,2,8913,8913,17826,15,0.109989,0.132826,1269,0,0
8575798,"Cabbio, Posta",,0.00008,99,2,1,3,11801,11801,23602,13,0.137931,0.171309,2099,0,0
8575799,"Muggio, Paese",,0.000079,99,1,3,4,11801,15105,26906,12,0.158333,0.210908,2122,0,0
8577345,"Casima, al Fosso",,0.000033,99,1,1,2,2888,2888,5776,12,0.154412,0.191753,0,0,0
8575800,"Muggio, Fontane",,0.000033,99,1,1,2,3304,3304,6608,9,0.2,0.31433,666,0,0
8575801,"Muggio, Cassino",,0.000039,99,1,1,2,3304,3304,6608,8,0.222222,0.339732,600,0,0
8575802,"Muggio, Casarno",,0.000044,99,1,1,2,3304,3304,6608,7,0.25,0.370408,532,0,0
8575803,"Muggio, Butigia",,0.000048,99,1,1,2,3304,3304,6608,6,0.285714,0.408333,462,0,0
8575804,"Muggio, Meri",,0.000052,99,1,1,2,3304,3304,6608,5,0.333333,0.456667,390,0,0
8575805,"Muggio, Casa Leone",,0.000055,99,1,1,2,3304,3304,6608,4,0.4,0.520833,316,0,0
8575806,"Scudellate, Paese",,0.000058,99,1,1,2,3304,1891,5195,3,0.5,0.611111,240,0,0
8575807,"Muggio, Bivio Casiroli",,0.00006,99,1,1,2,1891,1891,3782,2,0.666667,0.75,162,0,0
8575808,"Roncapiano, Paese",,0.000062,99,1,1,2,1891,1891,3782,1,1,1,82,0,0
8575809,"Chiasso, Via Bossi",,0.000073,99,4,4,8,34532,38696,73228,12,0.173913,0.239188,1407.807143,0,0
8575829,"Pedrinate, Paese",,0.000058,99,1,1,2,8601,8601,17202,13,0.149105,0.190667,384,0,0
8580022,"Chiasso, Piazza Indipendenza",,0.000075,99,2,3,5,15428,15428,30856,12,0.172897,0.239539,605.168498,0,0
8575812,"Vacallo, S. Simone",,0.000026,99,1,2,3,25263,25263,50526,13,0.149606,0.193418,338,0,0
8575813,"Pizzamiglio, Dogana",,0.000022,99,1,1,2,17870,17870,35740,12,0.162069,0.199195,92.525,0,0
8575817,"Vacallo, Scuole",,0.00003,99,2,2,4,18631,18631,37262,12,0.163993,0.211574,264.475,0,0
8575820,"Vacallo, Vignola",,0.000024,99,1,1,2,11238,11238,22476,12,0.1625,0.20291,0,0,0
8580069,"Morbio Inferiore, Breggia",,0.00008,99,4,4,8,44664,42169,86833,10,0.217125,0.30294,1251.587862,0,0
8575824,"Chiasso, al Sasso",,0.000039,99,2,1,3,7327,8601,15928,18,0.089586,0.113629,314,0,0
8575825,"Chiasso, Polo Nord",,0.000044,99,1,1,2,8601,8601,17202,17,0.097171,0.121814,332,0,0
8575826,"Pedrinate, Gasparina",,0.000048,99,1,1,2,8601,8601,17202,16,0.106267,0.13207,348,0,0
8575827,"Pedrinate, Bellavista",,0.000052,99,1,1,2,8601,8601,17202,15,0.117378,0.145386,362,0,0
8575828,"Pedrinate, Grotto Paradiso",,0.000055,99,1,1,2,8601,8601,17202,14,0.131261,0.163586,374,0,0
8575837,Brünnemoos b. Rosshäusern,,0.000055,44,1,1,2,2677,2677,5354,2,0.666667,0.75,34,0,0
8580468,"Romont FR, Arruffens",,0.000089,13,6,2,8,14997,14141,29138,1,1,1,753.188528,0,0
8575840,"Yverdon, Quai de la Thièle",,0.000082,35,4,3,7,4883,4882,9765,18,0.113088,0.170029,4005.966667,0,0
8579645,"St-Aubin NE, anc. poste",,0.000045,35,2,2,4,2405,2405,4810,18,0.109497,0.150858,30035.533333,0,0
8582968,"Bonvillars, bas du village",,0.000051,35,1,1,2,4704,4704,9408,1,1,1,81,0,0
8578066,"St-Aubin NE, Le Devens",,0.000064,35,3,2,5,743,743,1486,5,0.388889,0.540476,1557.5,0,0
8579648,"St-Aubin NE, Senet",,0.000052,35,2,3,5,1220,743,1963,4,0.5,0.680556,2011.5,0,0
8575842,"Pura, Loco",,0.000055,81,1,1,2,17008,16601,33609,19,0.091687,0.108793,506,0,0
8575843,"Pura, Moriscio",,0.000058,81,1,1,2,16601,16601,33202,18,0.100269,0.119792,566,0,0
8575857,"Castelrotto, Ospedale",,0.000069,81,1,1,2,7715,7715,15430,2,0.666667,0.75,8,0,0
8580041,"Aranno, Lusciè",,0.000025,81,1,1,2,5538,309,5847,2,0.666667,0.75,0,0,0
8575847,"Bedigliora, Nerocco",,0.000068,81,2,1,3,8056,8056,16112,6,0.285714,0.408333,562,0,0
8575848,"Astano, La Bolla",,0.000069,81,1,1,2,8056,7772,15828,5,0.333333,0.456667,458,0,0
8575852,"Walkringen, Bahnhof",,0.000032,100,1,1,2,4445,4445,8890,7,0.266667,0.386607,140,0,0
8575853,"Bedigliora, Feredino",,0.000065,81,2,1,3,7715,7715,15430,6,0.285714,0.408333,424,0,0
8575854,"Biogno, Paese",,0.000066,81,1,1,2,7715,7715,15430,5,0.333333,0.456667,323,0,0
8575855,"Beride, Paese",,0.000067,81,1,1,2,7715,7715,15430,4,0.4,0.520833,220,0,0
8575856,"Castelrotto, Valleggiolo",,0.000068,81,1,1,2,7715,7715,15430,3,0.5,0.611111,115,0,0
8575863,"Brontallo, Bivio",,0.000059,101,2,3,5,3641,6322,9963,5,0.428571,0.587037,189,0,0
8575864,"Brontallo, Paese",,0.000028,101,1,1,2,2188,2681,4869,7,0.25,0.355357,0,0,0
8575866,"Menzonio, Mulini",,0.000054,101,1,1,2,3641,3641,7282,5,0.352941,0.463889,12,0,0
8575865,"Menzonio, Sentiero",,0.000051,101,2,1,3,3641,3641,7282,6,0.291667,0.397619,29,0,0
8575867,"Menzonio, Bivio",,0.000074,101,2,2,4,6815,3148,9963,4,0.454545,0.616667,125,0,0
8575868,"Menzonio, Paese",,0.000042,101,1,1,2,2188,2681,4869,4,0.4,0.520833,0,0,0
8575869,"Broglio, Paese",,0.000078,101,2,1,3,3641,3641,7282,3,0.5,0.611111,81,0,0
8575870,"Prato, Ponte",,0.000078,101,1,1,2,3641,3641,7282,2,0.666667,0.75,56,0,0
8575871,"Sornico, S. Martino",,0.000077,101,1,1,2,3641,3641,7282,1,1,1,29,0,0
8575873,Mondada (Bavona),,0.000035,101,1,1,2,1227,1227,2454,9,0.2,0.31433,135,0,0
8575874,Fontana (Bavona),,0.00004,101,1,1,2,1227,1227,2454,8,0.222222,0.339732,128,0,0
8575875,Sabbione (Bavona),,0.000045,101,1,1,2,1227,1227,2454,7,0.25,0.370408,119,0,0
8575876,Ritorto (Bavona),,0.000049,101,1,1,2,1227,1227,2454,6,0.285714,0.408333,108,0,0
8575877,Foroglio (Bavona),,0.000053,101,1,1,2,1227,1227,2454,5,0.333333,0.456667,95,0,0
8575878,Roseto (Bavona),,0.000056,101,1,1,2,1227,1227,2454,4,0.4,0.520833,80,0,0
8575879,Fontanellata (Bavona),,0.000058,101,1,1,2,1227,1227,2454,3,0.5,0.611111,63,0,0
8575880,Sonlerto (Bavona),,0.00006,101,1,1,2,1227,1227,2454,2,0.666667,0.75,44,0,0
8575881,"S. Carlo (Bavona), Ponte",,0.000062,101,1,1,2,1227,1227,2454,1,1,1,23,0,0
8575882,Veglia di Peccia,,0.000023,101,1,1,2,1668,1668,3336,4,0.4,0.520833,68,0,0
8575883,Cortignelli,,0.000031,101,1,1,2,1668,1668,3336,3,0.5,0.611111,54,0,0
8575884,"S. Carlo di Peccia, Paese",,0.000037,101,1,1,2,1668,1668,3336,2,0.666667,0.75,38,0,0
8575885,"S. Carlo di Peccia, Centrale",,0.000042,101,1,1,2,1668,1668,3336,1,1,1,20,0,0
8575887,"Cevio, Posta",,0.00002,82,1,1,2,2796,2960,5756,15,0.117284,0.194925,19,0,0
8575888,"Cevio, Rovana",,0.000028,82,1,1,2,2960,2885,5845,14,0.125874,0.204366,36,0,0
8575889,"Linescio, di Fuori",,0.000035,82,1,1,2,2885,2810,5695,13,0.136,0.215241,51,0,0
8575890,"Linescio, Paese",,0.00004,82,1,1,2,2810,2810,5620,12,0.148148,0.228053,64,0,0
8575891,"Linescio, di Dentro",,0.000045,82,1,1,2,2810,2810,5620,11,0.163043,0.243627,75,0,0
8575892,"Collinasca, Paese",,0.000049,82,1,1,2,2810,2810,5620,10,0.181818,0.263464,84,0,0
8575893,"Collinasca, l'Ovi",,0.000053,82,1,1,2,2810,2810,5620,9,0.206349,0.29069,91,0,0
8575894,"Collinasca, Casa De Torri",,0.000056,82,1,1,2,2810,2810,5620,8,0.24,0.333433,96,0,0
8575895,"Cerentino, Paese",,0.000058,82,1,2,3,2810,4145,6955,7,0.289474,0.425108,99,0,0
8575896,"Cerentino, Chiesa",,0.000036,82,1,1,2,2810,2796,5606,3,0.5,0.611111,30,0,0
8575897,"Cerentino, Ponte per Corino",,0.000041,82,1,1,2,2796,2796,5592,2,0.666667,0.75,22,0,0
8575898,"Bosco Gurin, Ueberab",,0.000046,82,1,1,2,2796,2796,5592,1,1,1,12,0,0
8575899,"Cerentino, Pedipiodi",,0.000036,82,1,1,2,1335,1335,2670,6,0.285714,0.408333,60,0,0
8575900,Niva (VMaggia),,0.000041,82,1,1,2,1335,1335,2670,5,0.333333,0.456667,55,0,0
8575902,"Campo (VMaggia), al Piano",,0.000046,82,1,1,2,1335,1335,2670,4,0.4,0.520833,48,0,0
8575903,"Campo (VMaggia), Paese",,0.00005,82,1,1,2,1335,1335,2670,3,0.5,0.611111,39,0,0
8575904,"Campo (VMaggia), Ganelle",,0.000053,82,1,1,2,1335,1335,2670,2,0.666667,0.75,28,0,0
8575905,Cimalmotto,,0.000056,82,1,1,2,1335,1335,2670,1,1,1,15,0,0
8575910,"Walkringen, Dorni",,0.000038,100,1,2,3,4445,4445,8890,6,0.318182,0.492857,127,0,0
8575994,"Worb, Mühlestrasse",,0.000027,100,1,1,2,2225,2225,4450,6,0.285714,0.408333,0,0,0
8575911,"Rovio, Basso",,0.000058,99,1,1,2,8823,8838,17661,20,0.074592,0.094807,768,0,0
8575912,"Rovio, Costa",,0.00006,99,1,1,2,8838,8838,17676,19,0.079765,0.099936,855,0,0
8575913,"Arogno, la Cassina",,0.000062,99,1,1,2,8838,8838,17676,18,0.085766,0.105998,940,0,0
8575914,"Arogno, Cà Nova",,0.000064,99,1,1,2,8838,8838,17676,17,0.092814,0.113285,1023,0,0
8575915,"Arogno, Nebbia",,0.000065,99,1,1,2,8838,8838,17676,16,0.10121,0.122234,1104,0,0
8575916,"Arogno, Sasso Grosso",,0.000066,99,1,1,2,8838,8838,17676,15,0.111383,0.133525,1183,0,0
8575917,"Arogno, Cà del Ferée",,0.000067,99,1,1,2,8838,8838,17676,14,0.123967,0.148298,1260,0,0
8575919,"Effretikon, Zentrum",,0.000021,84,1,8,9,79753,79756,159509,22,0.076846,0.109893,473,0,0
8575941,"Lindau, Eschikon",,0.000043,84,2,4,6,18057,18057,36114,20,0.086322,0.108926,1853.166667,0,0.000001
8576169,Oberwil bei Nürensdorf,,0.000033,84,1,3,4,12756,12675,25431,21,0.083762,0.101717,505,0,0
8576170,"Nürensdorf, Berg",,0.000054,84,4,4,8,10182,10178,20360,20,0.084366,0.103181,4254.333333,0,0.000001
8576172,"Breite b. N., Grünenwaldstr.",,0.000042,84,3,4,7,12683,12674,25357,20,0.084115,0.102264,183.233333,0,0.000003
8576174,"Brütten, Hofacher",,0.000031,84,2,1,3,4107,4113,8220,23,0.068927,0.077766,1790,0,0
8588311,"Effretikon, Brüttenerstrasse",,0.000032,84,3,1,4,12718,12720,25438,2,0.666667,0.75,14,0,0
8575920,"Effretikon, Müselacher",,0.000013,84,1,1,2,19364,19366,38730,7,0.241935,0.319524,0,0,0
8575943,"Grafstal, Oberdorf",,0.000017,84,1,2,3,13162,13162,26324,5,0.363636,0.504167,36,0,0
8587857,"Kyburg, Ausserdorf",,0.000027,84,2,2,4,6643,6265,12908,2,0.75,0.833333,6,0,0
8575923,"Illnau, Kirche",,0.000023,84,2,3,5,18038,18033,36071,7,0.245283,0.407143,69,0,0
8575924,"Illnau, Steinacher",,0.000018,84,1,1,2,14237,14241,28478,8,0.190476,0.276091,0,0,0
8575925,"Illnau, Wingert",,0.000032,84,2,1,3,15757,12725,28482,7,0.215686,0.299351,11,0,0
8575927,"Illnau, Bahnhof",,0.00009,84,5,1,6,25543,9007,34550,5,0.3,0.374074,887,0,0
8575929,"Illnau, Horben",,0.000088,84,1,1,2,9007,9018,18025,4,0.380952,0.447917,774,0,0
8575930,Agasul,,0.000085,84,1,2,3,9018,9018,18036,3,0.538462,0.619048,659,0,0
8575932,"Weisslingen, Dettenried",,0.000036,84,2,1,3,5028,5031,10059,3,0.5,0.566667,15,0,0
8575933,"Neschwil, Post",,0.000098,84,3,3,6,9209,9019,18228,2,0.8,0.875,320,0,0
8575934,"Weisslingen, Lendikerstrasse",,0.000039,84,1,1,2,4082,4080,8162,2,0.6,0.666667,0,0,0
8575936,"Theilingen, Post",,0.000109,84,3,1,4,8127,950,9077,1,1,1,94.5,0,0
8575938,"Tagelswangen, Buckstrasse",,0.000025,84,2,2,4,17470,15380,32850,22,0.073931,0.087176,32,0,0
8576167,"Nürensdorf, Chrüzstrass",,0.000035,84,3,2,5,13043,13053,26096,21,0.078217,0.093142,263.833333,0,0
8575942,"Winterberg ZH, Wältiwis",,0.000022,84,2,3,5,26388,25437,51825,6,0.333333,0.515,89,0,0
8575939,"Lindau, Rigacher",,0.000026,84,2,1,3,13290,13290,26580,21,0.079605,0.094419,550,0,0
8575940,"Effretikon, Langhag",,0.000023,84,2,2,4,6020,5397,11417,21,0.079642,0.095872,318.166667,0,0
8588502,"Winterberg ZH, Kleinikon",,0.000056,84,3,2,5,4767,4767,9534,1,1,1,180,0,0
8590506,"Brütten, Zelgli",,0.000035,84,1,1,2,2488,2488,4976,1,1,1,0,0,0
8575946,"Effretikon, Girhalde",,0.00002,84,2,2,4,25818,25789,51607,4,0.428571,0.569444,97.5,0,0
8588279,"Tagelswangen, Gerenhalde",,0.000035,84,3,1,4,15379,64,15443,1,1,1,6.5,0,0
8588312,"Effretikon, Kapelle Rikon",,0.000048,84,2,1,3,14810,8541,23351,1,1,1,19,0,0
8575947,"Kyburg, Billikon",,0.00002,84,1,1,2,12691,12721,25412,3,0.5,0.566667,72,0,0
8575949,"Glattfelden, Post",,0.000028,83,1,2,3,6803,15252,22055,3,0.5,0.611111,12,0,0
8575950,"Zweidlen, Bahnhof",,0.000023,83,1,1,2,7427,7429,14856,3,0.454545,0.533333,0,0,0
8575952,"Glattfelden, Schulhaus Hof",,0.000042,83,2,2,4,15254,15253,30507,2,0.666667,0.75,16,0,0
8575954,"Glattfelden, Stationsweg",,0.000035,83,1,1,2,13972,13971,27943,2,0.666667,0.75,2,0,0
8575953,"Glattfelden, Eichhölzli",,0.000029,83,1,1,2,14162,13972,28134,3,0.5,0.611111,5,0,0
8575955,"Glattfelden, Bahnhof",,0.000059,83,2,1,3,15062,14164,29226,1,1,1,7,0,0
8575957,"Uster, Talacker",,0.000021,84,1,2,3,21413,21410,42823,5,0.368421,0.516667,539,0,0
8575958,"Uster, Im Hölzli",,0.00002,84,1,2,3,20978,20981,41959,4,0.461538,0.597222,195,0,0
8575960,"Mönchaltorf, Traube",,0.000028,84,2,1,3,19535,19536,39071,4,0.416667,0.516667,195,0,0
8575961,"Mönchaltorf, Wihalde",,0.000043,84,2,2,4,21414,21415,42829,3,0.571429,0.708333,320,0,0
8575962,"Oetwil am See, Zelgli",,0.000029,84,1,1,2,17569,17565,35134,3,0.5,0.611111,0,0,0
8576021,"Grüningen, Stedtli",,0.000039,84,1,1,2,18081,18067,36148,8,0.225,0.267229,221,0,0
8575970,"Feldbach, Viadukt",,0.000022,8,1,1,2,5513,5513,11026,19,0.121073,0.146762,28,0,0
8575972,"Stäfa, Schützenhaus Wanne",,0.000026,8,2,1,3,4612,4891,9503,10,0.15873,0.226508,144.5,0,0
8575973,"Stäfa, Kniebreche",,0.000033,8,1,1,2,4891,4891,9782,9,0.179245,0.253926,151.5,0,0
8575976,"Uster, Florastrasse",,0.000034,84,2,2,4,18796,18924,37720,13,0.122715,0.177105,2005.457143,0,0
8575977,"Uster, Oberuster",,0.000025,84,1,1,2,18735,18735,37470,13,0.120419,0.159216,0,0,0
8575978,"Uster, Linde",,0.000047,84,2,1,3,18924,18930,37854,12,0.133929,0.178054,1941.457143,0,0
8575979,"Uster, Koppach",,0.000051,84,1,2,3,18930,18933,37863,11,0.151203,0.21223,1906.457143,0,0
8575982,"Gossau ZH, Rigistrasse",,0.000044,84,1,2,3,17207,17206,34413,8,0.235632,0.295616,1667,0,0
8576017,"Gossau ZH, Zentrum",,0.000043,84,2,4,6,18196,18168,36364,7,0.291971,0.372321,1728.804762,0,0
8576037,"Grüningen, Adler",,0.000074,84,3,2,5,18305,18081,36386,6,0.352273,0.422581,175.971429,0,0
8575980,"Uster, Neufuhr",,0.000032,84,1,1,2,17207,17208,34415,10,0.166023,0.200194,1747,0,0
8575981,"Bertschikon b. G., Müselacher",,0.000038,84,1,1,2,17208,17207,34415,9,0.194444,0.234136,1708,0,0
8576016,"Gossau ZH, Tannenberg",,0.000016,84,1,1,2,9178,9774,18952,8,0.230337,0.273258,80.804762,0,0
8575983,"Kempten, Emmetschloo",,0.000028,84,2,1,3,20068,20066,40134,12,0.132013,0.171907,97.666667,0,0
8575984,"Bäretswil, Eishalle",,0.000035,84,1,1,2,20066,20064,40130,11,0.148289,0.192543,126.666667,0,0
8575985,"Bäretswil, Oberdorf",,0.00004,84,1,2,3,20064,20062,40126,10,0.169643,0.229574,153.666667,0,0
8575986,"Bäretswil, Bärenplatz",,0.000028,84,1,1,2,12759,12760,25519,9,0.185,0.219123,70.166667,0,0
8575987,"Bäretswil, Bahnhof",,0.000035,84,1,1,2,12760,12754,25514,8,0.220859,0.258896,93.166667,0,0
8575990,"Rosshäusern, Bahnhof",,0.000058,44,1,1,2,2677,2109,4786,1,1,1,18,0,0
8575991,Neuthal bei Bäretswil,,0.000045,84,2,1,3,9535,9526,19061,9,0.185792,0.222771,104.5,0,0
8575992,"Bauma, Giess. Wolfensberger",,0.000049,84,1,1,2,9526,9532,19058,8,0.221477,0.262734,121.5,0,0
8575995,"Wetzikon ZH, Alterswohnheim",,0.00005,84,3,1,4,5572,5571,11143,10,0.159091,0.195238,607.333333,0,0
8575996,"Wetzikon ZH, Spital",,0.000054,84,1,1,2,5571,5570,11141,9,0.183784,0.22032,607.333333,0,0
8575997,"Wetzikon ZH, Bachtelstrasse",,0.000057,84,1,1,2,5570,5568,11138,8,0.218543,0.258694,605.333333,0,0
8576092,"Wetzikon ZH, Schloss",,0.000066,84,1,2,3,23523,23536,47059,6,0.349398,0.422989,76.666667,0,0
8576008,"Hinwil, Bossikon",,0.000011,84,0,2,2,0,3095,3095,8,0.22973,0.291772,0,0,0
8576011,"Hinwil, Industriestrasse",,0.000031,84,1,1,2,2105,2105,4210,8,0.21831,0.260868,62,0,0
8576009,"Hinwil, Hinwil Center Ost",,0.000016,84,1,1,2,2105,2104,4209,10,0.15942,0.197691,2,0,0
8576010,"Hinwil, Wässeristrasse",,0.000024,84,1,1,2,2104,2105,4209,9,0.183908,0.222631,33,0,0
8576012,"Hinwil, Kreuzplatz",,0.000042,84,2,2,4,3095,3095,6190,7,0.27027,0.331429,120,0,0
8576013,"Hinwil, Dorf",,0.000029,84,1,1,2,1547,1547,3094,7,0.263636,0.308374,0,0,0
8576048,"Hinwil, Langmatt",,0.000045,84,1,1,2,1438,1438,2876,7,0.263636,0.308374,188.5,0,0
8576014,"Wetzikon ZH, Alpenblick",,0.000052,84,5,3,8,28060,30129,58189,13,0.207792,0.258411,2574.804762,0,0
8576055,"Hombrechtikon, Holflüe",,0.000076,8,3,3,6,14286,14311,28597,17,0.157576,0.21317,1547.5,0,0
8576074,"Dürnten, J.-C.-Heerstrasse",,0.000061,8,1,1,2,22134,22133,44267,13,0.183381,0.217389,349,0,0
8587963,"Bubikon, Platte",,0.000037,8,1,2,3,4316,3693,8009,4,0.4,0.520833,550,0,0
8576015,"Grüt (Gossau ZH), Lindenhof",,0.000026,84,1,4,5,27395,27445,54840,6,0.347107,0.425794,678.804762,0,0
8576018,"Gossau ZH, Oberstufe/Altrüti",,0.00002,84,1,1,2,9403,9400,18803,10,0.161702,0.196053,276,0,0
8576022,"Grüningen, Freihof",,0.000059,84,2,3,5,18314,18311,36625,7,0.282258,0.353129,290.471429,0,0
8576023,"Grüningen, Heispel",,0.000027,84,1,2,3,7552,7542,15094,7,0.276423,0.334104,0,0,0
8576030,"Gossau ZH, Unterhofen",,0.00002,84,1,1,2,4197,4209,8406,7,0.255639,0.296849,0,0,0
8576033,"Grüt (Gossau ZH), Grünau",,0.000071,84,5,2,7,17673,17677,35350,6,0.333333,0.40303,1368.5,0,0
8576091,"Wetzikon ZH, Wildbach",,0.00013,84,6,2,8,29108,29093,58201,6,0.348837,0.42,983.766667,0,0
8576094,"Kempten, Kreuzackerstrasse",,0.000057,84,1,1,2,21284,21284,42568,6,0.3375,0.398765,27,0,0
8576104,"Hinwil, Bahnhof",,0.000105,84,4,2,6,6574,4519,11093,6,0.345679,0.420238,11556,0,0
8576020,"Ottikon (Gossau), Unterottikon",,0.000033,84,2,1,3,18043,18081,36124,9,0.187817,0.223627,276,0,0
8576034,"Ottikon (Gossau), Strick",,0.000041,84,1,1,2,8648,8663,17311,7,0.266667,0.30811,85,0,0
8576027,"Männedorf, Glärnischstrasse",,0.000037,84,3,1,4,16191,16201,32392,18,0.134538,0.174944,908.5,0,0
8576028,"Männedorf, Kirchweg",,0.000043,84,1,1,2,16201,16202,32403,17,0.153132,0.207249,959.5,0,0
8576089,"Männedorf, Boldernstrasse",,0.000052,8,1,2,3,7113,7111,14224,7,0.262295,0.371429,192,0,0
8576101,"Stäfa, Bahnhof",,0.000139,8,3,3,6,24899,15736,40635,6,0.283019,0.42,1201.5,0,0
8587682,"Männedorf, Dammstrasse",,0.000082,8,3,1,4,7293,7288,14581,5,0.304348,0.397619,546,0,0
8576046,"Hinwil, Gstalden",,0.000069,8,4,2,6,3433,3387,6820,13,0.177333,0.211645,1330,0,0
8576071,"Dürnten, Langacher",,0.000052,8,1,2,3,22134,22135,44269,13,0.178962,0.211984,524,0,0
8576047,"Hinwil, Friedhof",,0.00004,84,1,1,2,1401,1438,2839,8,0.214286,0.252897,170.5,0,0
8576052,"Bubikon, Wihalde",,0.000086,8,7,1,8,12774,12797,25571,19,0.134126,0.169032,1888.166667,0,0
8576054,"Stäfa, Binz",,0.000039,8,1,2,3,4891,6761,11652,8,0.206897,0.308598,156.5,0,0
8576064,"Stäfa, Obstgarten",,0.000067,8,1,2,3,9160,9160,18320,9,0.180952,0.280242,916,0,0
8576065,"Stäfa, Tränkebachstrasse",,0.000039,8,1,1,2,4446,4446,8892,8,0.197674,0.267927,406.5,0,0
8576066,"Stäfa, Grund",,0.000056,8,2,1,3,8094,8094,16188,8,0.197674,0.267927,406.5,0,0
8576067,"Stäfa, Krone",,0.000108,8,3,1,4,15921,15921,31842,7,0.231884,0.31369,928.5,0,0
8576058,"Uerikon, Töbeli",,0.000057,8,3,1,4,9159,9159,18318,15,0.104167,0.167728,1126,0,0
8576059,"Uerikon, Moritzberg",,0.00006,8,1,1,2,9159,9160,18319,14,0.111628,0.175704,1096,0,0
8576060,"Stäfa, Phonak",,0.000061,8,1,1,2,9160,9160,18320,13,0.120419,0.185177,1064,0,0
8576061,"Stäfa, Mies",,0.000063,8,1,1,2,9160,9160,18320,12,0.130952,0.196868,1030,0,0
8576062,"Stäfa, Dorf",,0.000065,8,1,1,2,9160,9160,18320,11,0.143836,0.212211,994,0,0
8576063,"Stäfa, Landi",,0.000066,8,1,1,2,9160,9160,18320,10,0.16,0.234841,956,0,0
8576068,"Bubikon, Tafleten",,0.000039,8,2,1,3,21585,22125,43710,16,0.118479,0.134166,146,0,0
8576069,"Dürnten, Rothus",,0.000044,8,1,1,2,22125,22130,44255,15,0.1334,0.151176,274,0,0
8576070,"Dürnten, Etzelstrasse",,0.000048,8,1,1,2,22130,22134,44264,14,0.152778,0.174934,400,0,0
8576073,"Dürnten, Breitenmattstrasse",,0.000059,8,2,1,3,22135,22134,44269,14,0.155985,0.179341,238,0,0
8576077,"Kempraten, Bahnhof",,0.00003,67,2,1,3,16539,16536,33075,14,0.154428,0.182609,922.47619,0,0
8587943,"Rapperswil SG, Kreuzliplatz",,0.000076,67,5,7,12,37347,37368,74715,10,0.269841,0.393729,17026.157143,0,0
8587947,"Rüti ZH, Würzhalde",,0.000065,67,2,3,5,4701,4703,9404,12,0.201117,0.306681,2631.5,0,0
8576080,"Meilen, Bahnhof",,0.00003,8,2,4,6,13149,26769,39918,15,0.164021,0.270159,938,0,0
8587981,"Meilen, Eichholz",,0.000017,8,1,2,3,6583,11997,18580,7,0.22619,0.320301,140,0,0
8576082,"Meilen, Beugen",,0.000017,8,1,2,3,13074,13068,26142,14,0.138686,0.217637,260,0,0
8576083,"Meilen, Obermeilen",,0.000018,8,1,1,2,7109,7112,14221,13,0.123596,0.188189,222,0,0
8576084,"Meilen, Dollikon",,0.000026,8,1,1,2,7112,7113,14225,12,0.134615,0.199172,222,0,0
8576085,"Meilen, Weid",,0.000033,8,1,1,2,7113,7114,14227,11,0.148148,0.21272,220,0,0
8576086,"Uetikon am See, Grossdorf",,0.000039,8,1,1,2,7114,7116,14230,10,0.165217,0.230242,216,0,0
8576087,"Männedorf, Büelen",,0.000044,8,1,1,2,7116,7110,14226,9,0.1875,0.254586,210,0,0
8576088,"Männedorf, Allmendhof",,0.000049,8,1,1,2,7110,7113,14223,8,0.217949,0.292787,202,0,0
8578526,"Rapperswil SG, Scheidweg",,0.000033,67,1,1,2,32187,32187,64374,13,0.14786,0.182347,100,0,0
8576093,"Wetzikon ZH, Binzackerstrasse",,0.000054,84,2,1,3,21276,21284,42560,7,0.259259,0.301531,51,0,0
8576097,"Uster, Wil",,0.000025,84,2,1,3,20172,20182,40354,3,0.5,0.611111,231,0,0
8576099,"Uster, Turicum",,0.000021,84,1,1,2,18489,18489,36978,6,0.28,0.385714,539,0,0
8579026,Münsingen Chäsi,,0.000019,100,1,1,2,5657,5657,11314,5,0.333333,0.420833,60,0,0
8578560,"Ermenswil, Stich",,0.000078,67,1,1,2,17287,17287,34574,9,0.223684,0.300724,51,0,0
8578564,"Rüti ZH, Ferrach",,0.000065,67,1,2,3,17137,17137,34274,5,0.342105,0.438462,61,0,0
8578524,"Rapperswil SG, Cityplatz",,0.000036,67,2,2,4,57839,57812,115651,15,0.169197,0.243345,4723.757143,0,0
8578529,"Jona, Bollwies",,0.000071,67,3,4,7,47047,47993,95040,11,0.203857,0.28889,5791.338095,0,0
8578534,"Jona, Buech Industrie",,0.000032,67,1,2,3,5044,5044,10088,9,0.246445,0.314751,184,0,0
8580885,"Wald ZH, Sportstrasse",,0.00003,67,2,3,5,2963,2963,5926,11,0.227074,0.313302,910.75,0,0
8587940,"Fischenthal, Bodmen",,0.000054,67,1,3,4,1008,1008,2016,14,0.1625,0.266697,195,0,0
8588036,"Rüti ZH, Bandwies",,0.000046,67,2,1,3,3333,2012,5345,5,0.333333,0.456667,5,0,0
8590447,"Stäfa, Frohberg",,0.000059,67,1,1,2,5681,4448,10129,1,1,1,3,0,0
8576105,"Wetzikon ZH, Bahnhof",,0.000254,84,7,12,19,60532,48114,108646,5,0.490566,0.664744,13454.1,0,0
8587422,"Wetzikon ZH, Haldenstrasse",,0.000029,84,1,1,2,2754,2753,5507,6,0.3,0.365556,0,0,0
8587939,"Hinwil, Hinwil Center West",,0.000029,84,1,1,2,1052,1052,2104,3,0.5,0.611111,0,0,0
8583487,"Pfäffikon ZH, Mettlenstrasse",,0.000101,84,2,4,6,13885,13877,27762,3,0.55,0.651515,1385.9,0,0
8587681,"Bäretswil, Gemeindehaus",,0.000029,84,1,1,2,7304,7294,14598,4,0.409091,0.472222,0,0,0
8587956,"Wetzikon ZH, Medikon/Kulti",,0.000053,84,2,3,5,4072,4071,8143,5,0.4,0.514286,14,0,0
8587958,"Kempten, Talhof",,0.00009,84,4,4,8,21956,1420,23376,3,0.615385,0.729167,2115.8,0,0
8587937,"Gossau ZH, Moos",,0.000029,84,1,1,2,8430,9029,17459,1,1,1,0,0,0
8587991,"Ottikon (Gossau), Kirschgarten",,0.000072,8,1,1,2,3693,3688,7381,1,1,1,7,0,0
8590443,"Hinwil, Zürichstrasse",,0.000056,84,1,1,2,2043,1548,3591,1,1,1,2,0,0
8576106,"Richterswil, Bahnhof",,0.000011,113,0,6,6,0,43034,43034,18,0.146988,0.278901,0,0,0
8576107,"Richterswil, Wisli",,0.000012,113,1,2,3,8103,8062,16165,28,0.066581,0.136406,0.5,0,0
8576108,"Richterswil, Kerag",,0.000018,113,2,3,5,8063,8091,16154,27,0.069863,0.153808,27,0,0
8576109,"Richterswil, Bächlistrasse",,0.000021,113,2,1,3,4022,4020,8042,27,0.067308,0.119269,24.5,0,0
8576110,"Richterswil, Neuhus",,0.000016,113,1,1,2,4095,4097,8192,27,0.067308,0.119269,0,0,0
8577515,"Wollerau, Dorfplatz",,0.00005,113,1,1,2,16654,16641,33295,18,0.113433,0.166903,228,0,0
8576112,"Richterswil, Chrummbächli",,0.000049,113,4,2,6,8192,8198,16390,26,0.070692,0.134796,203,0,0
8576113,"Richterswil, Im Leemann",,0.000032,113,1,1,2,4100,4109,8209,26,0.069322,0.116387,0,0,0
8576114,"Richterswil, Speerstrasse",,0.000059,113,2,1,3,8207,8208,16415,25,0.0729,0.123692,285,0,0
8576116,"Richterswil, Untere Schwanden",,0.000061,113,1,2,3,8208,8176,16384,24,0.076923,0.139019,323,0,0
8576117,"Richterswil, Obermatt",,0.000037,113,1,1,2,8151,8078,16229,24,0.075342,0.119451,0,0,0
8576118,"Samstagern, Frohberg",,0.000068,113,2,1,3,8103,8104,16207,23,0.07963,0.124158,393,0,0
8576119,"Samstagern, Sagenbach",,0.000069,113,1,1,2,8104,8104,16208,22,0.084507,0.129621,425,0,0
8576120,"Samstagern, Im Walder",,0.000069,113,1,1,2,8104,8101,16205,21,0.09011,0.136092,455,0,0
8576122,"Samstagern, Zopfschmitten",,0.00007,113,1,1,2,8101,8104,16205,20,0.096618,0.143959,483,0,0
8576123,"Samstagern, Fälmis",,0.00007,113,1,1,2,8104,8102,16206,19,0.104278,0.153854,509,0,0
8576126,"Samstagern, Bahnhof",,0.000078,113,2,1,3,17669,9573,27242,17,0.124579,0.185378,786,0,0
8577517,"Wollerau, Felsenrain",,0.000055,113,2,1,3,16889,16889,33778,17,0.124579,0.185378,291,0,0
8576133,"Kindhausen ZH, Bodenacher",,0.000037,84,3,2,5,20743,20744,41487,17,0.096774,0.110717,231,0.000005,0.000005
8576135,"Effretikon, Moosburg",,0.000027,84,1,1,2,19896,16924,36820,17,0.096553,0.108465,0,0,0.000005
8588096,"Volketswil, Hofwisen",,0.000068,84,7,3,10,44616,44706,89322,14,0.130239,0.148253,4472.350163,0.000005,0.000153
8590504,"Benglen, Gerlisbrunnen",,0.000019,129,1,3,4,22388,45216,67604,14,0.155983,0.177006,16601.155651,0.000004,0.005838
8590604,"Fällanden, Bruggacher",,0.000039,129,2,3,5,37545,37532,75077,13,0.138101,0.155742,6928.970401,0.000019,0.000162
8590605,"Fällanden, Eggler",,0.000054,129,4,2,6,46759,46686,93445,13,0.146302,0.163692,7918.066892,0.000146,0.000012
8576130,"Volketswil, Huzlenstrasse",,0.000017,84,1,1,2,24535,24534,49069,16,0.106173,0.118427,76.5,0,0
8576139,"Volketswil, In der Höh",,0.000062,84,4,3,7,42281,41484,83765,16,0.106602,0.124225,1076.466667,0.000005,0.000001
8576138,"Walkringen, Niederwil",,0.00005,100,2,1,3,4445,4445,8890,5,0.333333,0.456667,95,0,0
8588098,"Gutenswil, Sternen",,0.000085,84,1,1,2,23257,21645,44902,1,1,1,43,0,0
8576141,"Wikartswil, Dorf",,0.000054,100,1,1,2,4445,4445,8890,4,0.4,0.520833,76,0,0
8576144,"Walkringen, Rüttihubelbad",,0.000056,100,1,1,2,4445,4445,8890,3,0.5,0.611111,55,0,0
8576148,"Pfungen, Eskimo",,0.000034,107,1,1,2,7871,7867,15738,1,1,1,68,0,0
8580797,"Engelburg, Schulhaus",,0.000062,71,5,2,7,32034,22246,54280,14,0.136267,0.161955,2605.951401,0,0
8581207,"Trogen, Oberstall",,0.000054,71,2,2,4,5480,5480,10960,1,1,1,108.583333,0,0
8581399,"Rehetobel, Ausserkaien",,0.000065,71,2,1,3,8689,580,9269,1,1,1,88,0,0
8576154,"Kloten, Oberfeld",,0.000022,107,2,1,3,36483,36979,73462,25,0.092096,0.105198,2212.75,0.000089,0
8576155,"Kloten, Grubenstrasse",,0.00003,107,1,2,3,36979,36993,73972,24,0.101246,0.119325,2680.75,0,0.000177
8576161,"Bassersdorf, Gemeindehaus",,0.000017,84,2,1,3,3834,3755,7589,22,0.072777,0.08393,3.833333,0.000008,0.000088
8576164,"Zufikon, Bachhalde",,0.000021,85,1,1,2,1768,2618,4386,23,0.07416,0.081397,675,0.000299,0
8576168,Birchwil bei Nürensdorf,,0.000026,84,1,1,2,12675,12756,25431,22,0.077429,0.08981,89,0,0
8576171,"Breite b. N., Sternen",,0.00005,84,4,4,8,9495,8753,18248,21,0.090127,0.111624,4365.01581,0,0.000003
8576173,"Breite b. N., Winterthurerstr.",,0.00005,84,4,4,8,7664,6177,13841,19,0.092181,0.112378,3939.682477,0,0.000005
8576179,"Winterthur, Zentrum Töss",,0.000049,68,1,3,4,16985,16970,33955,19,0.093649,0.112302,8634.666667,0,0.000005
8588315,"Bassersdorf, Grindel",,0.000054,107,2,2,4,36749,36497,73246,19,0.093578,0.109261,2703.87381,0.002283,0.000084
8576176,"Brütten, Harossen",,0.000056,84,3,2,5,8587,6596,15183,22,0.073881,0.085322,3488.4,0,0
8588316,"Bassersdorf, Dietlikonerstr.",,0.000069,107,4,4,8,38759,36112,74871,18,0.100204,0.120151,16949.938071,0.000002,0.000088
8590710,"Lindau, Nürensdorferstrasse",,0.000046,84,1,2,3,8811,8814,17625,1,1,1,2.333333,0,0.000002
8594298,"Winterthur, Archstrasse/HB",,0.000094,68,2,1,3,8598,3192,11790,2,0.666667,0.75,184,0,0.000002
8576178,"Winterthur, Töss",,0.000045,68,3,1,4,16978,16985,33963,20,0.085789,0.098482,8253.666667,0,0
8590929,"Winterthur, Brühleck",,0.000043,68,2,1,3,12871,12869,25740,11,0.181034,0.254971,814,0,0.000002
8576180,"Winterthur, Loki",,0.000025,68,1,1,2,12857,12857,25714,14,0.131274,0.169306,2828.333333,0,0
8590926,"Winterthur, Brücke",,0.000044,68,1,2,3,12660,12663,25323,10,0.186441,0.284885,1784.333333,0,0
8576197,"Zürich, Feldeggstrasse",,0.000025,85,1,1,2,114599,114615,229214,18,0.119656,0.131715,1015.783153,0,0.001371
8576189,"Zollikon, Rebwiesstrasse",,0.000064,86,1,4,5,2075,2075,4150,14,0.127278,0.146232,2472,0,0.025482
8576194,"Zürich, Elektrowatt",,0.000013,85,1,1,2,21738,21695,43433,17,0.093573,0.101428,52.5,0.033891,0.023523
8576195,"Zürich, Opernhaus",,0.000013,85,1,2,3,114002,118525,232527,19,0.103557,0.113829,721.5,0.033891,0.024079
8576183,"Zollikon, Seestrasse",,0.000021,86,1,1,2,1000,1000,2000,20,0.072949,0.078864,332,0.00134,0
8576185,"Zollikon, Gemeindehaus",,0.000057,86,3,1,4,2075,2075,4150,18,0.084985,0.09175,2160,0.00213,0
8576186,"Zollikon, Höhestrasse",,0.000059,86,1,1,2,2075,2075,4150,17,0.092655,0.100285,2241,0,0
8576187,"Zollikon, Allmend",,0.000061,86,1,1,2,2075,2075,4150,16,0.10187,0.110996,2320,0,0
8576188,"Zollikon, Schützenstrasse",,0.000063,86,1,1,2,2075,2075,4150,15,0.113151,0.125131,2397,0,0
8576201,"Zollikon, Bahnübergang",,0.000059,86,5,1,6,45424,45470,90894,16,0.102982,0.112457,21402.562336,0.023523,0.000602
8576202,"Zollikon, Felbenstrasse",,0.000074,86,2,1,3,45520,45521,91041,15,0.114525,0.127093,21472.562336,0.000602,0.000602
8576203,"Zollikon, Dufourplatz",,0.000088,86,2,4,6,46521,46520,93041,14,0.129022,0.149075,21912.462336,0.000602,0.000813
8590505,"Binz bei Maur, Fridlimatt",,0.000011,129,0,2,2,0,26273,26273,14,0.15599,0.174133,0,0,0.005621
8590592,"Dübendorf, Wasserfurren",,0.000053,129,2,3,5,51805,51817,103622,12,0.156928,0.178268,5911.384127,0.001483,0.000794
8587651,"Wallisellen, Glatt (Bus)",,0.000022,107,2,1,3,96516,96503,193019,17,0.146438,0.168953,689.290135,0.020143,0.049354
8591034,"Zürich, Albisgütli",,0.000023,85,2,4,6,40457,41877,82334,9,0.221245,0.2462,2573.974828,0.049877,0.064429
8591039,"Zürich, Alte Trotte",,0.000025,85,4,5,9,31501,31505,63006,9,0.230871,0.260736,795.760099,0.099534,0.079625
8591052,"Zürich, Bäckeranlage",,0.000024,85,4,7,11,115525,115995,231520,9,0.234805,0.270493,4391.703323,0.126413,0.0952
8591038,"Zürich, Albisriederplatz",,0.000079,85,9,9,18,229831,230507,460338,10,0.24428,0.28599,36751.921266,0.178498,0.116386
8591051,"Zürich, Bachmattstrasse",,0.000037,85,2,3,5,47870,47925,95795,9,0.220661,0.243087,9475.91954,0.022839,0.055038
8591057,"Zürich, Bahnhof Altstetten N",,0.000218,85,9,6,15,102402,102187,204589,9,0.248286,0.28363,23077.453022,0.027704,0.113088
8591064,"Zürich, Bahnhof Selnau",,0.000053,85,3,7,10,57176,57339,114515,9,0.250951,0.287555,10805.378582,0.034673,0.191433
8591074,"Zürich, Bernoulli-Häuser",,0.000038,85,5,5,10,103402,101125,204527,9,0.224273,0.25418,1405.401929,0.183284,0.14347
8587652,"Zürich, Altried",,0.000042,107,3,5,8,147689,149941,297630,16,0.171252,0.209403,28530.150853,0.049354,0.245715
8591082,"Zürich, Billoweg",,0.000056,130,1,2,3,51436,51432,102868,9,0.200645,0.218576,1653.397497,0.000696,0.031485
8591058,"Zürich, Bahnhof Enge",,0.000028,85,5,6,11,137430,138199,275629,9,0.246295,0.280977,4226.018158,0.140433,0.107622
8591059,"Zürich, Bahnhof Enge/Bederstr.",,0.000271,85,10,7,17,92151,102784,194935,9,0.254211,0.289789,88215.803916,0.06457,0.07252
8591080,"Zürich, Bhf. Wollishofen/Werft",,0.000089,85,2,1,3,44786,45181,89967,12,0.209202,0.23314,8228.028788,0,0.011361
8591100,"Zürich, Brunaustrasse",,0.000055,130,2,2,4,51432,51433,102865,11,0.220288,0.249911,1262.020678,0.011934,0.015838
8591104,"Zürich, Burgwies",,0.000042,85,2,2,4,54478,54592,109070,12,0.209654,0.235717,649.319516,0.014941,0.01462
8576196,"Zürich, Kreuzstrasse",,0.000017,85,1,1,2,114544,114599,229143,19,0.10704,0.116444,792.783153,0.000556,0
8576198,"Zürich, Höschgasse",,0.000042,85,2,1,3,170712,170772,341484,17,0.135676,0.152288,2232.783153,0.001371,0
8576199,"Zürich, Fröhlichstrasse",,0.000047,85,1,1,2,170772,170767,341539,16,0.156691,0.181925,2451.783153,0,0
8590596,"Ebmatingen, Leeacherstrasse",,0.000063,129,4,3,7,29182,29270,58452,13,0.147186,0.16493,7522.706636,0.000755,0.000021
8590597,"Ebmatingen, Looren",,0.000047,129,2,3,5,19905,19934,39839,14,0.130511,0.149978,6395.15,0.000019,0.00004
8576204,"Zollikon, Beugi",,0.00003,86,1,1,2,44520,44517,89037,22,0.063057,0.070355,11231,0.000019,0
8576205,"Zollikon, Goldhaldenplatz",,0.000036,86,1,1,2,44517,44515,89032,21,0.067118,0.074863,11248,0,0
8576206,"Küsnacht ZH, Bühlstrasse",,0.000042,86,1,1,2,44515,44509,89024,20,0.071751,0.080201,11263,0,0
8576207,"Küsnacht ZH, Goldbacherstrasse",,0.000046,86,1,1,2,44509,44501,89010,19,0.077086,0.086693,11276,0,0
8576208,"Küsnacht ZH, Boglerenstrasse",,0.00005,86,1,1,2,44501,44498,88999,18,0.083295,0.094965,11287,0,0
8576209,"Küsnacht ZH, Schiedhaldenstr.",,0.000054,86,1,2,3,44498,63623,108121,17,0.090614,0.106739,11296,0,0
8576215,"Itschnach, Fallacher",,0.000049,86,1,2,3,42150,42160,84310,17,0.09002,0.105422,1077,0,0
8576210,"Küsnacht ZH, Schiedhaldensteig",,0.000034,86,1,1,2,42140,42132,84272,20,0.071386,0.079607,1068,0,0
8576211,"Küsnacht ZH, Schübel",,0.000039,86,1,1,2,42132,42148,84280,19,0.076662,0.085939,1073,0,0
8576214,"Itschnach, Dorf",,0.000044,86,1,1,2,42148,42150,84298,18,0.082797,0.093983,1076,0,0
8576223,"Küsnacht ZH, Bahnhof",,0.000037,86,2,3,5,24940,31389,56329,16,0.097284,0.113994,3107,0,0
8576225,"Zumikon, Waltikon",,0.000066,86,3,5,8,18069,18075,36144,14,0.118353,0.137225,7052.310195,0.000779,0
8576226,"Zumikon, Dorfzentrum",,0.000022,86,1,1,2,13050,13050,26100,3,0.444444,0.541667,0,0,0
8576216,"Küsnacht ZH, Oberwacht",,0.000054,86,2,3,5,40145,40143,80288,16,0.098433,0.116606,11295,0,0
8576217,"Küsnacht ZH, Obere Heslibachst",,0.000026,86,1,2,3,21485,27947,49432,17,0.089834,0.105359,1805,0,0
8576218,"Küsnacht ZH, Bergstrasse",,0.000022,86,1,1,2,21492,21483,42975,4,0.384615,0.483333,1448,0,0
8576219,"Küsnacht ZH, Himmelistrasse",,0.00003,86,1,1,2,21483,21492,42975,3,0.5,0.583333,1090,0,0
8576220,"Küsnacht ZH, Hesligenstrasse",,0.000036,86,1,2,3,21492,21489,42981,2,0.75,0.833333,730,0,0
8576221,"Küsnacht ZH, Ränkestrasse",,0.000026,86,1,1,2,10733,10731,21464,2,0.666667,0.75,0,0,0
8576222,"Küsnacht ZH, Allmend",,0.000049,86,2,1,3,21487,12126,33613,1,1,1,4,0,0
8590669,"Itschnach, Tägermoos",,0.000072,86,1,2,3,42143,32254,74397,1,1,1,569,0,0
8590601,"Egg, Station",,0.000022,86,1,1,2,62,63,125,15,0.104597,0.112237,0,0,0
8590613,"Forch, Bahnhof",,0.000041,86,2,2,4,747,750,1497,14,0.116471,0.12626,703,0,0
8590648,"Hinteregg, Station",,0.000028,86,1,1,2,63,63,126,14,0.116167,0.123668,0,0,0
8576227,"Wiesendangen, Bahnhof",,0.000011,68,0,3,3,0,3828,3828,18,0.089394,0.155068,0,0,0
8576228,"Wiesendangen, Baumschulstrasse",,0.000014,68,1,2,3,1764,1806,3570,18,0.087218,0.134035,0.5,0,0
8587004,Bertschikon bei Attikon,,0.000039,68,1,1,2,390,390,780,1,1,1,8,0,0
8576229,"Wiesendangen, Attikerstrasse",,0.00002,68,2,2,4,3498,3498,6996,17,0.09375,0.141215,83.5,0,0
8576230,"Wiesendangen, Dorf",,0.000025,68,2,1,3,1806,1806,3612,17,0.092257,0.125879,28,0,0
8576231,"Wiesendangen, Hinterdorf",,0.000041,68,2,1,3,3540,3498,7038,16,0.099819,0.134677,219,0,0
8576232,"Wiesendangen, Gemeindehaus",,0.000046,68,1,1,2,3498,3498,6996,15,0.108871,0.146214,269,0,0
8576233,"Wiesendangen, Wasserfuri",,0.00005,68,1,1,2,3498,3498,6996,14,0.11991,0.162677,317,0,0
8576234,"Wiesendangen, Ländli",,0.000053,68,1,2,3,3498,3498,6996,13,0.133676,0.191638,363,0,0
8576235,"Otelfingen, Bahnhof",,0.000011,107,0,1,1,0,14883,14883,26,0.074913,0.081446,0,0,0
8576236,"Otelfingen, Post",,0.00002,107,1,1,2,14883,14886,29769,25,0.080873,0.088454,756,0,0
8576237,"Otelfingen, Schule",,0.000028,107,1,1,2,14886,14886,29772,24,0.087872,0.096975,1510,0,0
8576238,"Boppelsen, Dorf",,0.000035,107,1,1,2,14886,16219,31105,23,0.09621,0.107636,2262,0,0
8576239,"Boppelsen, Hand",,0.00004,107,1,2,3,16219,16155,32374,22,0.106311,0.121703,3012,0,0
8591037,"Zürich, Albisriederdörfli",,0.000028,85,3,2,5,93608,93678,187286,10,0.209762,0.234156,3954.144451,0.041869,0.017487
8591044,"Zürich, Am Suteracher",,0.000016,85,1,1,2,26706,26709,53415,10,0.204765,0.225552,0,0.004794,0.010885
8576242,"Zürich, Grünwald",,0.000028,107,1,2,3,1271,22827,24098,21,0.118641,0.138787,3755,0,0
8576243,"Regensdorf, Lettenhau",,0.000023,107,1,1,2,11273,11303,22576,21,0.118502,0.137638,0,0,0
8576246,"Regensdorf, Ostring",,0.000016,107,1,3,4,28797,28799,57596,12,0.179602,0.200117,212.878662,0.000327,0.000714
8576264,"Regensdorf, Chrüzächer",,0.000017,107,1,1,2,19115,19106,38221,12,0.136651,0.147422,247,0.003662,0.000334
8576252,"Watt, Haldensteig",,0.00003,107,1,1,2,9144,9144,18288,11,0.154923,0.16556,996,0,0.000351
8576280,"Regensdorf, Althard",,0.000045,107,1,4,5,23431,23431,46862,10,0.184268,0.205316,755,0,0.000021
8588094,"Dänikon, Rotflue",,0.000045,107,1,2,3,23005,22970,45975,10,0.182772,0.199238,1994,0,0.000021
8590461,"Adlikon b. R., Pächterried",,0.000035,107,3,1,4,24444,24286,48730,10,0.18232,0.196811,2640,0,0.00002
8590462,"Adlikon b. R., Leematten",,0.000046,107,3,2,5,11874,11874,23748,10,0.182772,0.199238,1542.378662,0.000351,0.000021
8590758,"Regensdorf, Querstrasse",,0.000063,107,2,1,3,20188,20194,40382,10,0.18232,0.196811,1320,0.000001,0.00002
8590759,"Regensdorf, Strassenverkehrs.",,0.00003,107,1,2,3,5957,5956,11913,10,0.182772,0.199238,825,0,0.000021
8590760,"Regensdorf, Zentrum Ost",,0.00009,107,5,1,6,30847,30997,61844,10,0.18232,0.196811,1524,0.000002,0.00002
8576248,"Watt, Geerenweg",,0.00002,107,2,1,3,30669,33495,64164,14,0.10886,0.117554,217,0.000343,0
8576249,Watt,,0.000028,107,1,2,3,33495,33496,66991,13,0.121819,0.133668,566,0,0
8576251,"Watt, Laubisser",,0.000023,107,1,1,2,9050,9144,18194,12,0.134491,0.142689,676,0,0
8576253,"Adlikon b. R., Dorf",,0.000035,107,2,3,5,40017,42913,82930,12,0.137904,0.153703,921,0,0
8576255,"Adlikon b. R., Sonnhalde",,0.000021,107,1,1,2,25918,28621,54539,12,0.137515,0.149889,0,0,0
8576256,"Adlikon b. R., Sonnhalde West",,0.000038,107,2,5,7,30364,31681,62045,11,0.158988,0.180162,1529.5,0,0
8576257,"Buchs ZH, Petermoos",,0.000017,107,1,1,2,16905,20576,37481,12,0.136003,0.146307,0,0,0
8576278,"Regensdorf, Furtbächli",,0.000027,107,2,1,3,18490,18857,37347,12,0.135287,0.144308,52.5,0,0
8576258,"Buchs ZH, Linde",,0.000032,107,2,3,5,26151,27435,53586,11,0.156953,0.17293,454,0,0
8576259,"Buchs ZH, Post",,0.00002,107,1,2,3,6578,6577,13155,11,0.156566,0.170505,0,0,0
8576260,"Buchs-Dällikon, Bahnhof",,0.000029,107,2,2,4,5715,16590,22305,15,0.097218,0.107091,105,0,0
8576271,"Dällikon, Seitenacker",,0.000019,107,1,1,2,21502,23002,44504,15,0.096959,0.104449,168,0,0
8591047,"Zürich, Aubrücke",,0.000074,85,4,5,9,125460,151925,277385,9,0.223575,0.256497,10058.340308,0.026462,0.013843
8576265,"Regensdorf, Gemeindehaus",,0.00003,107,2,3,5,43617,40105,83722,11,0.157823,0.174732,709.5,0.000334,0.000002
8590756,"Regensdorf, Feldblumenstrasse",,0.000046,107,1,2,3,11418,11418,22836,11,0.154995,0.167066,1352,0,0.000002
8576269,"Regensdorf, Dreispitz",,0.000019,107,1,2,3,9282,11418,20700,14,0.106836,0.115693,120,0,0
8576270,"Regensdorf, Sportanl Wisacher",,0.000019,107,1,1,2,5958,5958,11916,14,0.106552,0.113053,0,0,0
8576272,"Dällikon, Dorf",,0.00004,107,2,2,4,34439,34443,68882,14,0.107052,0.116685,892,0,0
8576273,"Dänikon, Gemeindehaus",,0.000028,107,1,1,2,23006,22966,45972,13,0.118861,0.125864,1115,0,0
8576274,Hüttikon,,0.000034,107,1,1,2,22966,23007,45973,12,0.134491,0.142689,1410,0,0
8576275,"Regensdorf, Holenbach",,0.00004,107,1,1,2,23007,23005,46012,11,0.154923,0.16556,1703,0,0
8576276,"Dällikon, Industrie",,0.000028,107,1,1,2,11437,11437,22874,1,1,1,38,0,0
8576279,"Regensdorf, Hardhölzli",,0.000041,107,2,1,3,22095,23431,45526,11,0.155989,0.168302,438,0,0
8576283,"Dielsdorf, Dorfzentrum",,0.000035,107,1,1,2,15217,15622,30839,12,0.13425,0.142114,664,0,0.000001
8590757,"Regensdorf, Pumpwerkstrasse",,0.00005,107,2,1,3,18859,18856,37715,11,0.154601,0.16455,993,0.000001,0.000001
8576281,"Adlikon b. R., Ziegelhütte",,0.000021,107,1,1,2,15624,15609,31233,14,0.106369,0.112643,40,0,0
8576282,"Dielsdorf, Altmoos",,0.000028,107,1,1,2,15609,15217,30826,13,0.118674,0.125492,353,0,0
8576284,"Urnäsch, Hofbach",,0.000058,73,1,1,2,2172,1088,3260,1,1,1,14,0,0
8576285,"Dielsdorf, Bezirksgebäude",,0.000016,107,1,1,2,15136,15136,30272,5,0.333333,0.456667,5,0,0
8576286,"Dielsdorf, Spitalstrasse",,0.000024,107,1,1,2,15136,15136,30272,4,0.4,0.520833,8,0,0
8576287,"Regensberg, Hirsmühle",,0.000031,107,1,1,2,15136,15136,30272,3,0.5,0.611111,9,0,0
8576288,"Regensberg, Höfli",,0.000038,107,1,1,2,15136,15136,30272,2,0.666667,0.75,8,0,0
8576289,"Regensberg, Dorf",,0.000043,107,1,1,2,15136,14745,29881,1,1,1,5,0,0
8576290,"Hüntwangen-Wil, Bahnhof",,0.000032,68,1,5,6,5933,26583,32516,7,0.316667,0.48208,1054,0,0
8576295,"Wasterkingen,Ausserdorfstrasse",,0.000016,68,1,1,2,5183,5181,10364,1,1,1,0,0,0
8576291,"Wil ZH, Gemeindehaus",,0.000016,68,1,1,2,5937,5933,11870,6,0.285714,0.408333,150,0,0
8576292,"Wil ZH, Lirenhof",,0.000025,68,1,1,2,5933,5922,11855,5,0.333333,0.456667,84,0,0
8576298,"Dinhard, Bahnhof/Welsikon",,0.000032,68,1,1,2,3860,3847,7707,6,0.27027,0.365,848,0,0
8576301,"Thalheim-Altikon, Bahnhof",,0.000038,68,1,2,3,3847,3860,7707,5,0.333333,0.47037,751,0,0
8576304,Gütighausen,,0.000034,68,1,1,2,3476,3476,6952,5,0.291667,0.390476,7,0,0
8576303,Thalheim an der Thur,,0.000027,68,1,1,2,3476,3476,6952,6,0.25,0.352083,108,0,0
8576305,"Adelboden, Mühleport",,0.000086,43,4,1,5,21090,21154,42244,39,0.053144,0.06581,5284,0,0
8576324,"Adelboden, Schlegeli Crystal",,0.000062,43,1,1,2,7403,7090,14493,5,0.272727,0.353704,45,0,0
8576307,"Adelboden, Margeli",,0.000035,43,1,1,2,11452,11452,22904,37,0.057367,0.065143,5768,0,0
8576308,"Adelboden, Hirschen",,0.00004,43,1,1,2,11452,11452,22904,36,0.060707,0.0689,6142,0,0
8576309,"Achseten, Tregel",,0.000045,43,1,1,2,11452,11452,22904,35,0.064469,0.073222,6514,0,0
8576310,"Achseten, Hoher Steg",,0.000049,43,1,1,2,11452,11452,22904,34,0.06874,0.078252,6884,0,0
8576311,"Achseten, Schmitten",,0.000053,43,1,1,2,11452,11452,22904,33,0.07363,0.084188,7252,0,0
8576312,"Frutigen, Meise",,0.000056,43,1,1,2,11452,11350,22802,32,0.079283,0.091315,7618,0,0
8576313,"Frutigen, Hohstalden",,0.000058,43,1,1,2,11350,11452,22802,31,0.085894,0.100059,7982,0,0
8576314,"Achseten, Bettbach",,0.00006,43,1,1,2,11452,11452,22904,30,0.093728,0.111102,8344,0,0
8576315,"Frutigen, Spital",,0.000062,43,1,1,2,11452,11452,22904,29,0.10316,0.125626,8704,0,0
8576340,"Spiezwiler, Schulhaus",,0.000035,43,1,3,4,6446,6446,12892,15,0.161905,0.257182,1928.816947,0,0
8576341,"Spiezwiler, Stegweide",,0.000021,43,1,4,5,5532,5532,11064,15,0.167785,0.282326,834,0,0
8588176,"Mitholz, Unter der Fluh",,0.000022,43,1,2,3,10207,10207,20414,4,0.4375,0.559524,71,0,0
8576319,"Adelboden, Rainweg",,0.000049,43,2,1,3,7467,7403,14870,10,0.150538,0.239371,140,0,0
8576320,"Adelboden, Schönbühl",,0.000053,43,1,1,2,7403,7403,14806,9,0.164557,0.253938,125,0,0
8576321,"Adelboden, Janz Team",,0.000056,43,1,1,2,7403,7403,14806,8,0.181818,0.271131,108,0,0
8576322,"Adelboden, Altersheim",,0.000058,43,1,1,2,7403,7403,14806,7,0.203704,0.291991,89,0,0
8576323,"Adelboden, Schlegeli Hari",,0.000061,43,1,1,2,7403,7403,14806,6,0.232558,0.318333,68,0,0
8576325,"Adelboden, Dürrenegge",,0.000088,43,2,1,3,9638,9702,19340,4,0.333333,0.40625,272,0,0
8576326,"Adelboden, Falkiport",,0.000085,43,1,1,2,9702,9702,19404,3,0.4375,0.5,245,0,0
8576327,"Adelboden, Kreuzgasse",,0.000083,43,1,3,4,9702,9078,18780,2,0.666667,0.75,216,0,0
8576328,"Adelboden, Brügge",,0.000035,43,1,1,2,2806,2806,5612,2,0.6,0.666667,0,0,0
8576329,"Adelboden, Raufmatte",,0.000064,43,2,2,4,5614,5613,11227,1,1,1,76,0,0
8588698,"Adelboden, Bollersgraben",,0.000038,43,1,1,2,2807,2806,5613,1,1,1,0,0,0
8576334,"Spiez, Niesenbrücke",,0.000021,43,1,4,5,7257,7817,15074,21,0.132623,0.175384,1583.761064,0,0
8576377,"Interlaken, Lindenallee",,0.000021,43,1,4,5,16975,16976,33951,15,0.158392,0.269904,143.938095,0,0
8576858,"Gwatt, Camping",,0.000031,43,2,1,3,5758,5758,11516,15,0.11704,0.152807,809,0,0
8579134,"Interlaken, Gymnasium",,0.000121,43,4,5,9,20643,14033,34676,13,0.162069,0.299597,1327,0,0
8579304,"Unterseen, Friedhof",,0.00006,43,1,1,2,6445,6445,12890,14,0.113433,0.170498,152,0,0
8579332,"Interlaken, Rugenparkstrasse",,0.000092,43,3,2,5,12184,12268,24452,13,0.124579,0.200903,1925,0,0
8579334,"Matten b. I., Wychelstrasse",,0.000071,43,1,2,3,6588,6588,13176,11,0.141129,0.214799,1775,0,0
8576335,"Spiez, Leimern",,0.000015,43,1,1,2,4464,4464,8928,24,0.076067,0.128293,947.666667,0,0
8576336,"Spiez, Aeschiweg",,0.000024,43,1,1,2,4464,4464,8928,23,0.080321,0.135347,874.666667,0,0
8576337,"Spiez, Eigen",,0.000031,43,1,1,2,4464,4464,8928,22,0.085153,0.144882,799.666667,0,0
8576349,"Spiez, Schiffstation",,0.000039,43,2,2,4,2983,2983,5966,2,0.75,0.833333,234,0,0
8588105,"Spiez, Spiezmoos",,0.000139,43,6,6,12,6392,6392,12784,11,0.212389,0.413031,1725.185434,0,0
8588614,"Spiez, Kapellenstrasse",,0.000104,43,1,2,3,7882,7882,15764,5,0.375,0.547222,828,0,0
8576339,"Spiezwiler, Neumatte",,0.000029,43,3,1,4,6446,6446,12892,16,0.141689,0.201355,1991.816947,0,0
8576364,"Frutigen, Winklen",,0.000049,43,1,2,3,3222,3222,6444,13,0.178771,0.28704,1185.911204,0,0
8576345,"Hondrich, Byfang",,0.00004,43,1,3,4,3353,3353,6706,12,0.193717,0.310566,203.594398,0,0
8576342,"Spiez, Doren",,0.00002,43,2,1,3,3353,3353,6706,15,0.12987,0.176668,443.594398,0,0
8576343,"Spiez, Sibirienkurve",,0.000028,43,1,1,2,3353,3353,6706,14,0.145522,0.199205,365.594398,0,0
8576344,"Hondrich, Stutz",,0.000034,43,1,1,2,3353,3353,6706,13,0.165939,0.235463,285.594398,0,0
8576359,"Aeschi b. Spiez, Niederdorf",,0.000055,43,1,2,3,4475,2855,7330,12,0.182482,0.303146,325,0,0
8583412,"Mülenen, Chappelegand",,0.000059,43,1,4,5,1856,1856,3712,12,0.198582,0.359952,444.294398,0,0
8583853,"Aeschi b. Spiez, Hundbüel",,0.000021,43,1,1,2,556,560,1116,12,0.181159,0.283146,2.5,0,0
8587239,"Wengi b. Frutigen, Dorf",,0.000044,43,2,3,5,3222,3222,6444,12,0.183824,0.323146,891.244538,0,0
8588104,"Spiez, Kreuz",,0.000059,43,1,1,2,3119,3119,6238,12,0.181159,0.283146,1199,0,0
8583852,"Aeschi b. Spiez, Adelmatt",,0.000023,43,1,2,3,1134,1130,2264,12,0.184397,0.297897,123,0,0
8576356,"Aeschiried, Kapelle",,0.000063,43,1,2,3,3800,3726,7526,15,0.140351,0.230333,391.333333,0,0
8576347,"Spiez, Des Alpes",,0.000024,43,2,2,4,2983,2983,5966,3,0.555556,0.666667,456,0,0
8576348,"Spiez, Eden Hotel",,0.000021,43,1,1,2,1490,1490,2980,3,0.5,0.583333,0,0,0
8576351,"Krattigen, Dorf",,0.000046,43,2,2,4,5576,5333,10909,20,0.097113,0.189676,662.666667,0,0
8576361,"Aeschi b. Spiez, Alleestrasse",,0.000054,43,1,1,2,4588,745,5333,2,0.666667,0.75,49.333333,0,0
8576353,"Aeschi b. Spiez, Mustermattli",,0.000056,43,3,1,4,3800,3799,7599,18,0.106061,0.159239,679.333333,0,0
8576354,"Aeschiried, Ebenen",,0.000059,43,1,1,2,3799,3800,7599,17,0.115254,0.172598,585.333333,0,0
8576355,"Aeschiried, Chemihütte",,0.000061,43,1,1,2,3800,3800,7600,16,0.126437,0.192443,489.333333,0,0
8576357,"Aeschi b. Spiez, Hasleren",,0.000049,43,2,1,3,4475,4475,8950,14,0.142105,0.208609,539,0,0
8576358,"Aeschi b. Spiez, Lengmattli",,0.000052,43,1,1,2,4475,4475,8950,13,0.159509,0.239819,433,0,0
8576360,"Aeschi b. Spiez, Längenboden",,0.00005,43,2,1,3,4588,4588,9176,3,0.5,0.611111,179.333333,0,0
8576362,"Grabs, Lims",,0.000044,73,2,1,3,15269,15269,30538,27,0.096801,0.124409,31187.733333,0,0
8576363,"Reichenbach i. K., Buchholz",,0.000045,43,3,1,4,3222,3222,6444,14,0.15566,0.227246,1270.911204,0,0
8576365,"Cavigliano, Bivio Onsernone",,0.000063,101,1,1,2,5370,5370,10740,35,0.07338,0.087767,8746,0,0
8576367,"Frutigen, Rybrügg",,0.000031,43,1,1,2,9647,10207,19854,11,0.164179,0.226517,509,0,0
8576369,"Kandersteg, Blümlisalp",,0.000056,43,2,2,4,11483,12759,24242,9,0.21978,0.318591,687,0,0
8589869,"Kandersteg, Talstat. Oeschinen",,0.000022,43,1,1,2,1276,1276,2552,2,0.666667,0.75,4,0,0
8576370,"Kandersteg, Victoria",,0.000035,43,1,1,2,11321,11482,22803,8,0.246753,0.317607,557,0,0
8576371,"Kandersteg, Bahnhof",,0.000041,43,1,3,4,11482,16269,27751,7,0.310345,0.432937,525,0,0
8576372,"Intragna, Ponte",,0.000065,101,1,1,2,5370,5511,10881,34,0.079016,0.096552,9140,0,0
8577037,"Interlaken, Unt. Bönigstrasse",,0.000015,43,1,1,2,5954,5954,11908,15,0.126615,0.183393,19.5,0,0
8579161,"Unterseen, Gartenstrasse",,0.000031,43,1,1,2,6442,6445,12887,17,0.091904,0.144382,72,0,0
8576388,"Bönigen, Erschwanden",,0.000043,43,1,1,2,3348,3348,6696,18,0.100775,0.150902,156,0,0
8576389,"Iseltwald, Mühle",,0.000051,43,2,1,3,3630,3630,7260,17,0.109914,0.171546,204,0,0
8576384,"Ringgenberg, Moosrain",,0.000036,43,1,2,3,8202,7959,16161,15,0.132653,0.211275,56,0,0
8576390,"Iseltwald, Dorfplatz",,0.000058,43,2,3,5,3824,3824,7648,16,0.121065,0.21335,496,0,0
8579135,"Matten b. I., Jungfrau Park",,0.000031,43,1,3,4,3432,3433,6865,4,0.5,0.654762,70,0,0
8580891,"Iseltwald, am Urfer",,0.000042,43,1,2,3,3348,3255,6603,4,0.454545,0.616667,5,0,0
8576380,"Golino, Posta",,0.000066,101,1,1,2,5511,5511,11022,33,0.085606,0.108095,9532,0,0
8576383,"Ringgenberg, Post",,0.000029,43,3,1,4,8202,8202,16404,16,0.119101,0.174567,128,0,0
8576385,"Bönigen, Schlössli",,0.000025,43,2,1,3,3348,3348,6696,21,0.081121,0.120189,369,0,0
8576386,"Bönigen, Hauetenbach",,0.000032,43,1,1,2,3348,3348,6696,20,0.086677,0.127744,300,0,0
8576387,"Bönigen, Wäldli",,0.000038,43,1,1,2,3348,3348,6696,19,0.093146,0.137494,229,0,0
8576391,"Biel/Bienne, Bahnhof/Gare",,0.000138,87,8,7,15,99202,367452,466654,23,0.122053,0.165143,21100.747619,0,0
8576408,"Biel/Bienne, Brunnenplatz",,0.000019,87,3,3,6,132869,132665,265534,26,0.080807,0.118559,1700.766667,0,0
8576392,"Biel/Bienne, Zentralplatz",,0.000028,87,1,9,10,313157,312980,626137,22,0.133105,0.175709,12340.715873,0,0
8576725,"Biel/Bienne, Nidaugasse",,0.000036,87,3,2,5,63313,63195,126508,20,0.157551,0.224879,4033.1,0,0
8579946,"Biel/Bienne, Residenz",,0.000048,87,3,6,9,76060,76660,152720,20,0.159734,0.24201,4244.92381,0,0
8576410,"Biel/Bienne, Kongresshaus",,0.00003,87,2,3,5,45431,45453,90884,25,0.085354,0.121123,726.771429,0,0
8576411,"Biel/Bienne, Kreuzplatz/Croix",,0.000048,87,2,5,7,103332,103349,206681,24,0.09155,0.130181,3614.957143,0,0
8576724,"Biel/Bienne, Omega",,0.000069,87,4,5,9,123289,123437,246726,19,0.172265,0.250477,12012.942063,0,0
8587276,"Biel/Bienne, Taubenloch",,0.000071,87,4,3,7,98672,98742,197414,18,0.167838,0.232692,6855.154762,0,0
8587315,"Port, Dorf",,0.000018,87,1,1,2,16660,16656,33316,20,0.151417,0.209388,0,0,0
8587616,"Biel/Bienne, Falkenstrasse",,0.000042,87,1,1,2,48511,48506,97017,20,0.151417,0.209388,374,0,0
8587618,"Biel/Bienne, Renferstrasse",,0.000045,87,3,4,7,50215,50995,101210,17,0.179291,0.249402,6725.971429,0,0
8587619,"Biel/Bienne, Place Guisan",,0.00018,87,12,13,25,284063,283974,568037,19,0.177481,0.289601,194836.524603,0,0
8576393,"Biel/Bienne, Altstadt/V. Ville",,0.000014,87,1,5,6,143251,144032,287283,27,0.076803,0.114121,976.9,0,0
8576395,"Biel/Bienne,rte.de Reuchenette",,0.000019,87,2,5,7,33301,40119,73420,27,0.077,0.11384,1377.083333,0,0
8576413,"Biel/Bienne, 3 Tannen/3 Sapins",,0.000027,87,1,1,2,30501,30503,61004,22,0.099058,0.116713,3970,0,0
8576417,"Brügg BE, Sonnhalde",,0.000029,87,1,2,3,30503,35477,65980,19,0.128328,0.153313,6667,0,0
8576414,"Biel/Bienne, Friedhof/Cimetie.",,0.000036,87,2,3,5,46390,46389,92779,21,0.109786,0.135794,6075,0,0
8576419,"Brügg BE, Bahnhof",,0.000026,87,2,5,7,48233,48227,96460,18,0.152935,0.188965,14990.516667,0,0
8576722,"Orpund, Post",,0.000042,87,1,1,2,17702,17702,35404,20,0.133775,0.165131,808,0,0
8576723,"Biel/Bienne, Orpundplatz",,0.000086,87,6,2,8,135675,135649,271324,19,0.15367,0.201624,4514.597619,0,0
8576394,"Biel/Bienne, Bellevue",,0.000013,87,1,2,3,10648,10648,21296,28,0.071629,0.097994,187.5,0,0
8592470,"Port, Neumatt",,0.000029,87,2,2,4,15403,15503,30906,7,0.252101,0.322857,2561.152381,0,0
8592475,"Biel/Bienne, Ried",,0.00003,87,1,2,3,22685,22684,45369,8,0.254237,0.332024,30,0,0
8576398,"Orvin, place du village",,0.000019,87,1,4,5,7791,7793,15584,23,0.095366,0.154834,220.5,0,0
8576399,"Orvin, église",,0.000015,87,1,3,4,3706,3659,7365,23,0.094758,0.148839,0,0,0
8576400,"Les Prés-d'Orvin, Bellevue",,0.000028,87,3,2,5,2239,2192,4431,24,0.086473,0.126012,83,0,0
8576401,"Les Prés-d'Orvin, Le Grillon",,0.000023,87,1,2,3,2160,2162,4322,23,0.093603,0.14019,66.5,0,0
8576402,"Frinvillier, village",,0.000044,87,5,2,7,5479,5526,11005,23,0.093306,0.141205,116.666667,0,0
8576397,"Orvin, Cheval Blanc",,0.00002,87,2,2,4,7116,7823,14939,24,0.08773,0.130828,314.5,0,0
8576407,Romont BE,,0.000055,87,1,3,4,4243,4243,8486,23,0.091158,0.140624,532,0,0
8576403,"Vauffelin, bif. sur Plagne",,0.000033,87,2,2,4,4243,4243,8486,25,0.079145,0.114536,332,0,0
8576405,"Plagne, bas du village",,0.000032,87,1,1,2,2992,2992,5984,25,0.078125,0.105122,135,0,0
8576404,"Plagne, place du Cerf",,0.000025,87,1,1,2,2981,2992,5973,26,0.072961,0.096387,84,0,0
8576406,"Vauffelin, poste",,0.000052,87,2,1,3,4254,4243,8497,24,0.084118,0.117724,485,0,0
8587620,"Biel/Bienne, Neumarkt/Marché-N",,0.000075,87,6,4,10,58882,59071,117953,22,0.098876,0.154285,15086.416667,0,0
8587782,"Frinvillier, bif sur Vauffelin",,0.000042,87,2,3,5,2409,2409,4818,4,0.47619,0.591667,1885.25,0,0
8576409,"Biel/Bienne, Zukunftstrasse",,0.000033,87,2,1,3,88427,87664,176091,25,0.083986,0.109034,2204.904762,0,0
8593320,"Biel/Bienne, Bloeschweg",,0.000033,87,1,1,2,48394,48386,96780,7,0.254902,0.33663,133,0,0
8592477,"Biel/Bienne, Spiegel/Miroir",,0.00005,87,4,4,8,47074,46930,94004,7,0.27619,0.383415,9233.761905,0,0
8576412,"Biel/Bienne, Tiefenmatt",,0.000019,87,1,1,2,30503,30501,61004,23,0.090252,0.10347,3378,0,0
8576416,"Brügg BE, Chaletweg",,0.000021,87,1,1,2,30503,30503,61006,20,0.113883,0.130794,6081,0,0
8576418,"Brügg BE, Bärletweg",,0.000023,87,1,1,2,30503,31397,61900,22,0.121212,0.140483,1639,0,0
8576420,"Brügg BE, Jura",,0.000031,87,1,2,3,31397,31397,62794,21,0.137725,0.166957,2220,0,0
8576428,"Studen BE, Grien",,0.000041,87,1,2,3,9120,9442,18562,21,0.140217,0.168131,3852,0,0
8577954,"Lengnau BE, Sportplatz",,0.000048,127,2,4,6,12335,12046,24381,15,0.172004,0.226247,2231,0,0
8592463,"Biel/Bienne, Gassmann",,0.000037,87,2,2,4,41104,41104,82208,10,0.211712,0.271082,3862.233333,0,0
8593348,"Biel/Bienne, Längfeld/Long-Chp",,0.000063,87,2,2,4,38528,38428,76956,7,0.246914,0.348452,2659.5,0,0
8593354,"Biel/Bienne, Mettlenweg",,0.000043,87,1,1,2,38370,38370,76740,7,0.230769,0.303836,18,0,0
8576422,"Aegerten, Stockfeld",,0.000024,87,1,1,2,22438,22438,44876,27,0.077379,0.083777,1533,0,0
8576423,"Studen BE, 3 Tannen",,0.000031,87,1,1,2,22438,22438,44876,26,0.083743,0.091169,2110,0,0
8576424,"Studen BE, Schulhaus",,0.000037,87,1,1,2,22438,22438,44876,25,0.091259,0.100286,2685,0,0
8576425,"Studen BE, Wydenplatz",,0.000043,87,1,2,3,22438,25428,47866,24,0.100272,0.112185,3258,0,0
8576426,"Studen BE, Längacker",,0.000029,87,1,1,2,12186,12186,24372,23,0.109784,0.123,2716,0,0
8576427,"Studen BE, Sagi",,0.000036,87,1,1,2,12186,9120,21306,22,0.123137,0.141426,3285,0,0
8576429,"Studen BE, Petinesca",,0.000047,87,2,1,3,16234,16236,32470,28,0.073738,0.07996,1099,0,0
8576430,"Worben, Tribey",,0.00005,87,1,1,2,16236,16236,32472,27,0.079488,0.086547,1662,0,0
8576431,"Worben, Post",,0.000054,87,1,1,2,16236,16236,32472,26,0.08622,0.094489,2223,0,0
8576432,"Worben, Gemeindehaus",,0.000057,87,1,1,2,16236,16236,32472,25,0.094212,0.104291,2782,0,0
8576433,"Worben, Busswilstrasse",,0.000059,87,1,1,2,16236,16236,32472,24,0.103853,0.116789,3339,0,0
8576435,"Lyss, Parkschwimmbad",,0.000063,87,2,1,3,17868,17868,35736,23,0.115555,0.132353,5581.5,0,0
8580776,"Seedorf BE, Tannenmatte",,0.000039,44,1,1,2,3471,3471,6942,23,0.112288,0.139531,272,0,0
8581076,"Lyss, Seelandhalle",,0.000091,44,2,3,5,4577,4577,9154,21,0.142662,0.197902,206120.4,0,0
8581354,"Vorimholz, Wysserain",,0.000037,44,1,1,2,1024,1024,2048,21,0.14149,0.190152,0,0,0
8581428,"Ortschwaben, Schulhaus",,0.000059,44,2,2,4,8988,8988,17976,21,0.141975,0.194983,6878.5,0,0
8580569,"Aarberg, Bielstr/Friedhof",,0.00004,87,1,1,2,4942,122,5064,2,0.666667,0.75,2,0,0
8576445,"Hindelbank, Post",,0.000036,44,2,1,3,4696,4696,9392,34,0.058996,0.065552,1869,0,0
8576446,"Hindelbank, Bahnhof",,0.000041,44,1,2,3,4696,4696,9392,33,0.062594,0.070586,2488,0,0
8576449,"Hettiswil b. H., Dorf",,0.000029,44,1,1,2,3959,3959,7918,33,0.0625,0.069089,0,0,0
8587638,"Aegerten, Jurastrasse",,0.000048,87,1,1,2,8958,8959,17917,10,0.20202,0.275258,80,0,0
8576450,"Krauchthal, Buch",,0.000053,44,2,2,4,4696,4696,9392,32,0.066559,0.074467,3720,0,0
8578885,"Locarno, S. Antonio centrale",,0.000088,101,3,3,6,63195,63199,126394,32,0.092135,0.127308,1012,0,0
8578910,"Ascona, S. Materno",,0.00003,101,1,1,2,21265,21265,42530,32,0.091196,0.12065,0,0,0
8576452,"Krauchthal, Länggasse",,0.000033,44,1,1,2,4452,4452,8904,31,0.071117,0.078361,4326,0,0
8576454,"Hub b. Krauchthal,Spritzenhaus",,0.000039,44,1,1,2,4452,4452,8904,30,0.076438,0.084687,4937,0,0
8576455,"Hub b. Krauchthal, Schulhaus",,0.000044,44,1,1,2,4452,4452,8904,29,0.08263,0.092305,5546,0,0
8576456,"Hub b. Krauchthal,Brünnliacker",,0.000048,44,1,1,2,4452,4452,8904,28,0.089927,0.101689,6153,0,0
8576457,"Bolligen, Lutzeren",,0.000052,44,1,1,2,4452,4452,8904,27,0.098653,0.113602,6758,0,0
8576462,"Burgdorf, Heimiswilstrasse",,0.000033,45,2,1,3,25532,25532,51064,10,0.190821,0.221343,144,0,0
8576466,"Heimiswil, Kipf",,0.000022,45,1,1,2,7043,7004,14047,12,0.143396,0.165321,111,0,0
8576467,"Heimiswil, Löwen",,0.00003,45,1,1,2,7004,7004,14008,11,0.165198,0.189646,166,0,0
8576468,"Heimiswil, Niederdorf",,0.000036,45,1,1,2,7004,7004,14008,10,0.195251,0.226223,219,0,0
8576472,Brügglen b. Kaltacker,,0.000037,45,2,1,3,1773,1825,3598,11,0.162896,0.186668,48,0,0
8576473,"Kaltacker, Leumberg",,0.000042,45,1,1,2,1825,1825,3650,10,0.191892,0.220523,95,0,0
8576480,"Zufikon, Schulanlage",,0.000029,85,1,1,2,2618,2618,5236,22,0.079944,0.08817,961,0,0
8576487,"Burgdorf, Eyfeldweg",,0.000054,45,3,1,4,28088,28088,56176,11,0.164211,0.187923,216,0,0
8576488,"Kirchberg BE, Badimatte",,0.000057,45,1,1,2,28088,28088,56176,10,0.193955,0.224026,266,0,0
8576491,"Ersigen, Unterdorf",,0.000026,45,1,1,2,8595,8594,17189,10,0.195251,0.226223,124,0,0
8576494,"Alchenstorf, Unteralchenstorf",,0.000022,45,1,1,2,6487,6487,12974,10,0.191892,0.220523,34,0,0
8576496,"Zufikon, Volg",,0.000036,85,1,1,2,2618,2618,5236,21,0.08672,0.096443,1245,0,0
8576504,"Burgdorf, Bahnhof",,0.000263,45,14,7,21,99626,118825,218451,8,0.30131,0.393772,3381,0,0
8587798,"Burgdorf, Parkhaus Oberstadt",,0.000043,45,1,4,5,20531,20533,41064,8,0.269841,0.336327,225,0,0
8587812,Kernenried,,0.000058,45,1,1,2,4511,4509,9020,12,0.130261,0.153445,130,0,0
8587816,"Burgdorf, Pulverweg",,0.00009,45,1,1,2,28459,28459,56918,8,0.24898,0.295004,366,0,0
8587817,"Burgdorf, Aebistrasse",,0.000129,45,3,9,12,92119,91646,183765,7,0.326087,0.434762,1582.314286,0,0
8587830,"Burgdorf, Alterspflegeheim",,0.000055,45,2,2,4,11326,11638,22964,7,0.299213,0.359461,0,0,0
8587818,"Burgdorf, Schlossmatt",,0.000032,45,2,4,6,19994,20533,40527,8,0.272727,0.350198,485.685714,0,0
8587826,Tschamerie,,0.00006,45,1,2,3,13569,13569,27138,7,0.29661,0.35932,245,0,0
8587839,"Lyssach, Kernenriedstrasse",,0.000055,45,3,2,5,28023,27980,56003,6,0.309091,0.370588,63,0,0
8587866,"Burgdorf, Jungfraustrasse",,0.000078,45,3,3,6,24996,25023,50019,7,0.308333,0.38269,269.5,0,0
8587868,"Kirchberg BE, Nyco",,0.000034,45,1,2,3,12819,12819,25638,7,0.293103,0.355182,102,0,0
8576507,"Huttwil, Friedhof",,0.000026,45,1,1,2,7767,7767,15534,4,0.357143,0.466667,43,0,0
8576509,"Eriswil, Schulhaus",,0.000054,45,2,1,3,7970,7920,15890,2,0.6,0.666667,49,0,0
8576542,"Heiligenschwendi, Reha Zentrum",,0.000053,43,2,1,3,2639,2639,5278,23,0.09499,0.116946,452.5,0,0
8576543,"Heiligenschwendi, Alpenblick",,0.000056,43,1,3,4,2639,2639,5278,22,0.104517,0.136153,659.5,0,0
8576553,"Goldiwil, Stägacher",,0.000067,43,1,1,2,1859,1859,3718,22,0.101073,0.120356,2034,0,0
8576544,"Heiligenschwendi, Aebnit",,0.000027,43,1,1,2,1859,1859,3718,29,0.060928,0.072293,279,0,0
8576545,"Goldiwil, Hintermatt",,0.000034,43,1,1,2,1859,1859,3718,28,0.064605,0.076533,482,0,0
8576546,"Goldiwil, Obermatt",,0.000039,43,1,1,2,1859,1859,3718,27,0.068772,0.081595,683,0,0
8576547,"Goldiwil, Wendeplatz",,0.000044,43,1,1,2,1859,1859,3718,26,0.073534,0.087926,882,0,0
8576548,"Goldiwil, Melli",,0.000049,43,1,2,3,1859,1859,3718,25,0.079028,0.097053,1079,0,0
8576549,"Goldiwil, Blümlisalp",,0.000032,43,1,1,2,989,989,1978,25,0.078713,0.093127,0,0,0
8576550,"Goldiwil, Kirche",,0.000058,43,2,2,4,1859,1859,3718,24,0.085067,0.102884,1467,0,0
8576551,"Goldiwil, Jungfrau",,0.000036,43,1,1,2,870,870,1740,24,0.084727,0.098949,0,0,0
8576552,"Goldiwil, Montana",,0.000066,43,2,1,3,1859,1859,3718,23,0.092164,0.108354,1847,0,0
8576554,"Thun, Lauenen",,0.000084,43,2,1,3,2579,2579,5158,21,0.11194,0.136338,2715,0,0
8576568,"Heimenschwand, Kuhstelle",,0.000035,43,1,3,4,1859,1859,3718,20,0.091049,0.142786,537.166667,0,0
8576577,"Steffisburg, Oberes Flühli",,0.000059,43,1,1,2,1080,1080,2160,19,0.086957,0.114167,660,0,0
8576792,"Gurzelen, Stuffäri",,0.000044,43,1,2,3,1377,1377,2754,18,0.115702,0.190307,166,0,0
8576800,"Thierachern, Wegweiser",,0.00006,43,1,2,3,1080,1050,2130,17,0.126126,0.206236,210,0,0
8576801,"Blumenstein, Alte Post",,0.000065,43,3,3,6,1856,1856,3712,17,0.127329,0.221022,2500,0,0
8576804,"Blumenstein, Secki",,0.000041,43,1,2,3,1167,1167,2334,17,0.124579,0.207647,1532,0,0
8576810,"Thierachern, Sandbühl",,0.000053,43,1,1,2,1047,1047,2094,17,0.112319,0.168805,155,0,0
8588165,"Thun, Allmendstrasse/Polygon",,0.000116,43,2,2,4,8061,8061,16122,12,0.181818,0.286908,1090.65,0,0
8588482,"Thun, Jungfraustrasse",,0.000086,43,1,3,4,5994,5994,11988,8,0.253333,0.383897,808.5,0,0
8576560,"Heiligenschwendi, Stapfebode",,0.000037,43,2,2,4,930,930,1860,5,0.375,0.547222,1165.5,0,0
8576565,"Heiligenschwendi, Kohlerensäge",,0.000049,43,1,1,2,780,600,1380,1,1,1,4,0,0
8576561,"Heiligenschwendi, Schulhaus",,0.000027,43,1,1,2,780,780,1560,5,0.333333,0.456667,932,0,0
8576562,"Heiligenschwendi,Ober-Eichholz",,0.000033,43,1,1,2,780,780,1560,4,0.4,0.520833,703,0,0
8576563,"Heiligenschwendi,Unt.-Eichholz",,0.000039,43,1,1,2,780,780,1560,3,0.5,0.611111,472,0,0
8576564,"Heiligenschwendi, Hundschüpfen",,0.000044,43,1,1,2,780,780,1560,2,0.666667,0.75,239,0,0
8576567,"Heimenschwand, Höh",,0.000028,43,1,1,2,1859,1859,3718,21,0.084099,0.119724,652.166667,0,0
8576579,"Steffisburg, Dorf",,0.000077,43,3,2,5,7765,7765,15530,18,0.094372,0.12974,3074.5,0,0
8576570,"Fahrni, Bach",,0.000037,43,3,1,4,1080,1080,2160,25,0.059609,0.079209,1416,0,0
8576571,"Fahrni, Lood",,0.000042,43,1,1,2,1080,1080,2160,24,0.062842,0.082696,1295,0,0
8576572,"Fahrni, Rachholtern",,0.000047,43,1,1,2,1080,1080,2160,23,0.066472,0.086739,1172,0,0
8576573,"Fahrni, Obere Mürggen",,0.000051,43,1,1,2,1080,1080,2160,22,0.070581,0.091508,1047,0,0
8576574,"Fahrni, Lueg",,0.000054,43,1,1,2,1080,1080,2160,21,0.075269,0.09727,920,0,0
8576575,"Steffisburg, Wendeplatte",,0.000057,43,1,1,2,1080,1080,2160,20,0.080669,0.104489,791,0,0
8576580,"Steffisburg, Platz",,0.000044,43,1,1,2,7735,7735,15470,17,0.099907,0.123978,1347,0,0
8576582,"Steffisburg, Ziegelei",,0.000089,43,3,1,4,8425,8425,16850,15,0.122402,0.157407,9353.166667,0,0
8576583,"Steffisburg, Brauerei",,0.000087,43,1,1,2,8425,8425,16850,14,0.138158,0.188194,9212.166667,0,0
8587748,"Gwatt, Moos",,0.000064,43,2,2,4,7048,7048,14096,12,0.164021,0.226327,327.666667,0,0
8576639,"Eriz, Garage",,0.00006,43,1,1,2,480,390,870,11,0.175926,0.258565,114,0,0
8587874,"Thun, KKThun",,0.000143,43,5,4,9,8066,8066,16132,11,0.187302,0.272566,6491.5,0,0
8588164,"Spiez, Lötschbergplatz",,0.000101,43,6,3,9,4732,2052,6784,11,0.196429,0.336942,583.852101,0,0
8576589,"Heimenschwand, Rohrimoos Bad",,0.000064,43,3,1,4,810,810,1620,18,0.095855,0.142246,1563,0,0
8576590,"Wachseldorn, Dorf",,0.000065,43,1,1,2,810,810,1620,17,0.103152,0.150031,1350,0,0
8576592,"Wachseldorn, Hof",,0.000066,43,1,1,2,810,810,1620,16,0.111821,0.159641,1135,0,0
8576593,"Wachseldorn, Schulhaus",,0.000067,43,1,1,2,810,810,1620,15,0.122302,0.171999,918,0,0
8576594,"Süderen, Dorf",,0.000068,43,1,1,2,810,810,1620,14,0.135246,0.188878,699,0,0
8576596,"Oberlangenegg, Inn. Kreuzweg",,0.000069,43,1,1,2,810,810,1620,13,0.151659,0.214398,478,0,0
8588426,"Steffisburg, Kirche",,0.000169,43,6,2,8,6956,1769,8725,10,0.202247,0.318893,2299.3,0,0
8576598,"Schwarzenegg, Bären",,0.00006,43,3,1,4,1170,1170,2340,14,0.128755,0.180078,2751.75,0,0
8576599,"Schwarzenegg, Ried Schmiede",,0.000062,43,1,1,2,1170,1170,2340,13,0.142857,0.196469,2524.75,0,0
8576600,"Schwarzenegg, Ried Käserei",,0.000063,43,1,1,2,1170,1170,2340,12,0.16092,0.219915,2295.75,0,0
8576601,"Unterlangenegg, Aebnit",,0.000065,43,1,1,2,1170,1170,2340,11,0.184932,0.257923,2064.75,0,0
8576603,"Fahrni, Schlierbach",,0.000021,43,1,1,2,809,809,1618,11,0.166667,0.274534,1087,0,0
8576604,"Fahrni, Schmiede",,0.000029,43,1,1,2,809,809,1618,10,0.181818,0.292897,848,0,0
8576606,"Fahrni, Abrahams Schoss",,0.000035,43,1,1,2,809,809,1618,9,0.2,0.31433,607,0,0
8576607,"Steffisburg, Emberg",,0.000041,43,1,1,2,809,809,1618,8,0.222222,0.339732,364,0,0
8576609,"Oberdiessbach, Bahnhof",,0.000032,100,2,1,3,3215,3235,6450,11,0.2,0.30215,474,0,0
8581745,"Wichtrach, Bernstrasse",,0.00007,100,4,2,6,4734,2156,6890,4,0.454545,0.616667,131.5,0,0
8576611,"Aeschlen b. O., Dorf",,0.000022,100,1,1,2,660,660,1320,9,0.2,0.31433,342,0,0
8576612,"Aeschlen, Langenegg",,0.000029,100,1,1,2,660,660,1320,8,0.222222,0.339732,312,0,0
8576613,"Aeschlen, Bareichte",,0.000036,100,1,1,2,660,660,1320,7,0.25,0.370408,280,0,0
8576614,"Linden, Dorf",,0.000041,100,1,1,2,660,660,1320,6,0.285714,0.408333,246,0,0
8576615,"Linden, Grafenbühl",,0.000046,100,1,1,2,660,660,1320,5,0.333333,0.456667,210,0,0
8576616,"Linden, Gridenbühl",,0.00005,100,1,1,2,660,660,1320,4,0.4,0.520833,172,0,0
8576617,"Linden, Jassbach",,0.000053,100,1,1,2,660,660,1320,3,0.5,0.611111,132,0,0
8576618,"Linden, Schlegwegbad",,0.000056,100,1,1,2,660,660,1320,2,0.666667,0.75,90,0,0
8576619,"Heimenschwand, Hinterägerten",,0.000059,100,1,1,2,660,660,1320,1,1,1,46,0,0
8576626,"Wangelen, Alte Post",,0.000075,43,4,1,5,269,269,538,6,0.285714,0.408333,1524,0,0
8576627,"Wangelen, Bühl",,0.000075,43,1,1,2,269,269,538,5,0.333333,0.456667,1275,0,0
8576628,"Wangelen, Mühlematt",,0.000075,43,1,1,2,269,269,538,4,0.4,0.520833,1024,0,0
8576629,"Heimenschwand, Bruchenbühl",,0.000074,43,1,1,2,269,268,537,3,0.5,0.611111,771,0,0
8576630,"Heimenschwand, Scheidweg",,0.000074,43,1,1,2,268,268,536,2,0.666667,0.75,516,0,0
8576631,"Heimenschwand, Marbach",,0.000074,43,1,1,2,268,268,536,1,1,1,259,0,0
8576633,"Eriz, Losenegg",,0.000039,43,2,1,3,480,480,960,17,0.102881,0.16721,1566,0,0
8576634,"Eriz, Bühl",,0.000044,43,1,1,2,480,480,960,16,0.110092,0.175025,1329,0,0
8576635,"Eriz, Schwand",,0.000048,43,1,1,2,480,480,960,15,0.118557,0.184231,1090,0,0
8576636,"Eriz, Bieten Schulhaus",,0.000052,43,1,1,2,480,480,960,14,0.128655,0.195415,849,0,0
8576637,"Eriz, Gysenbühl",,0.000055,43,1,1,2,480,480,960,13,0.14094,0.209617,606,0,0
8576638,"Eriz, Bödeli",,0.000057,43,1,1,2,480,480,960,12,0.15625,0.228932,361,0,0
8576888,"Unterseen, Widimatt",,0.000059,43,1,1,2,779,779,1558,6,0.27027,0.3275,622,0,0
8576995,Schermenwaldstrasse,,0.00003,44,1,2,3,11750,11750,23500,14,0.178636,0.219504,3094.833333,0,0
8577001,Zent,,0.000022,44,1,1,2,4284,4284,8568,20,0.10972,0.127135,28,0,0
8580675,"Zuzwil BE, Bergacker",,0.000066,87,2,1,3,1550,1550,3100,5,0.352941,0.463889,36,0,0
8577022,Kräyigen,,0.000051,44,1,3,4,8250,8250,16500,11,0.191111,0.249235,3606,0,0
8577024,Allmendingen,,0.000032,44,1,1,2,4653,4654,9307,11,0.174636,0.211334,84,0,0
8581351,"Bern, Schanzenstrasse",,0.000139,44,8,4,12,51336,44128,95464,13,0.153571,0.279219,8244.034127,0,0
8587292,Brunnenhof,,0.000033,44,3,4,7,3650,3649,7299,11,0.200913,0.3137,3324.945238,0,0
8588550,Bremgarten Schloss,,0.00006,44,3,2,5,11514,11754,23268,13,0.151163,0.22771,15793,0,0
8589035,Zulligerstrasse,,0.000118,44,2,2,4,3650,3650,7300,6,0.307692,0.4625,1391,0,0
8589000,Parkstrasse,,0.000031,44,2,3,5,27235,27335,54570,8,0.239362,0.315317,1665.821429,0,0
8576651,"Lüscherz, Bahnhof",,0.000031,117,1,1,2,3812,3812,7624,5,0.333333,0.436111,19,0,0
8576659,St. Johannsen,,0.000026,117,1,1,2,3193,3193,6386,18,0.087889,0.121578,2148,0,0
8582212,"Le Landeron, Bellevue",,0.000049,117,3,1,4,2204,2204,4408,17,0.091558,0.119357,2946.5,0,0
8576664,"Langnau i.E., Bahnhof",,0.000068,123,5,7,12,22885,35088,57973,19,0.157593,0.260452,992,0,0
8576690,"Langnau i.E., Friedhof",,0.000019,123,1,1,2,1412,1412,2824,23,0.092233,0.12216,0,0,0
8576665,"Bärau, Schwimmbad",,0.000019,123,1,4,5,17657,17654,35311,19,0.141732,0.220491,176,0,0
8576675,"Trub, Unterfeld",,0.000047,123,1,3,4,12929,12929,25858,19,0.138182,0.2126,276,0,0
8576676,"Trub, Weierhus Stöckli",,0.000024,123,1,3,4,9502,9492,18994,19,0.136861,0.208768,22,0,0
8576677,"Trub, Ried",,0.000018,123,1,2,3,6177,6177,12354,19,0.135283,0.198076,0,0,0
8576671,"Trubschachen, Bahnhof",,0.000047,123,1,2,3,13196,13376,26572,19,0.138889,0.199679,472,0,0
8576682,"Gohl, Dorf",,0.000037,123,1,1,2,3194,3194,6388,19,0.132353,0.182745,216,0,0
8576694,"Oberfrittenbach, Grebli",,0.00005,123,1,2,3,2818,2818,5636,19,0.136882,0.202498,288,0,0
8576695,"Langnau i.E., Hüselmatte",,0.000051,123,5,2,7,15692,15832,31524,19,0.133945,0.19394,24,0,0
8576714,"Röthenbach i.E., Fambach",,0.000047,123,1,3,4,11928,11928,23856,14,0.179104,0.264594,776,0,0
8587242,"Ramsei, Bahnhof",,0.000033,123,1,2,3,9750,9742,19492,18,0.142292,0.20509,12.333333,0,0
8588360,"Langnau i.E., Bernstrasse",,0.000106,123,3,5,8,16782,16782,33564,16,0.177112,0.287383,1690.416667,0,0
8588384,"Langnau i.E., Mooseggstrasse",,0.000031,123,1,1,2,1406,1406,2812,7,0.228814,0.28254,46.666667,0,0
8576666,"Bärau, Bahnübergang",,0.000015,123,1,1,2,13574,13574,27148,24,0.085772,0.111717,132,0,0
8576667,"Bärau, Schärischachen",,0.000024,123,1,1,2,13574,13578,27152,23,0.092715,0.120129,204,0,0
8576668,"Trubschachen, Teufenbachsteg",,0.000031,123,1,1,2,13578,13196,26774,22,0.100973,0.130832,274,0,0
8576669,"Trubschachen, Unterdorf",,0.000037,123,1,1,2,13196,11587,24783,21,0.110961,0.145075,342,0,0
8576670,"Trubschachen, Hasenlee",,0.000043,123,1,1,2,11587,13196,24783,20,0.123288,0.165461,408,0,0
8576672,"Trubschachen, Oelibrücke",,0.000031,123,1,1,2,12884,12891,25775,22,0.100765,0.133257,102,0,0
8576673,"Trub, Längengrund Säge",,0.000037,123,1,1,2,12891,12929,25820,21,0.110638,0.148424,162,0,0
8576674,"Trub, Twärenbrücke",,0.000042,123,1,1,2,12929,12929,25858,20,0.122807,0.170995,220,0,0
8576679,"Bärau, Vorder Chammershus",,0.000015,123,1,1,2,3194,3194,6388,22,0.097911,0.128364,36,0,0
8576680,"Gohl, Schulhaus Chammershus",,0.000024,123,1,1,2,3194,3194,6388,21,0.107091,0.140681,98,0,0
8576681,"Gohl, Widhus",,0.000031,123,1,1,2,3194,3194,6388,20,0.118314,0.157533,158,0,0
8576691,"Oberfrittenbach, Bad",,0.000035,123,2,1,3,2818,2818,5636,22,0.100267,0.132783,108,0,0
8576692,"Oberfrittenbach, Schulhaus",,0.000041,123,1,1,2,2818,2818,5636,21,0.109955,0.146982,170,0,0
8576693,"Oberfrittenbach, Stock",,0.000046,123,1,1,2,2818,2818,5636,20,0.12187,0.167475,230,0,0
8588354,"Langnau i.E., Hirschenplatz",,0.00006,123,1,5,6,25301,20744,46045,17,0.173267,0.28557,1307.833333,0,0
8576699,"Wettswil a.A., Schürli",,0.000028,85,1,1,2,1623,1619,3242,28,0.061461,0.066067,3024,0.000216,0
8576700,"Langnau i.E., Ilfis",,0.000019,123,1,1,2,950,950,1900,24,0.07569,0.105014,99,0,0
8576702,"Schüpbach, Bruuchbüel",,0.000027,123,1,1,2,950,950,1900,23,0.080925,0.113927,172,0,0
8576704,"Signau, Bahnhof",,0.00004,123,3,2,5,11889,11862,23751,21,0.093822,0.137737,330,0,0
8576707,"Schüpbach, Buebenei Sägerei",,0.000051,123,1,1,2,12033,12033,24066,21,0.091014,0.119761,158,0,0
8576705,"Schüpbach, Rössli",,0.000042,123,2,1,3,12006,12033,24039,23,0.078717,0.104772,30,0,0
8576706,"Schüpbach, Buebeneibrücke",,0.000047,123,1,1,2,12033,12033,24066,22,0.084388,0.111417,95,0,0
8576708,"Aeschau, Horben Schmiede",,0.000071,123,2,1,3,12125,12098,24223,20,0.098859,0.130799,616,0,0
8576709,"Eggiwil, Neuhof",,0.000071,123,1,1,2,12098,12098,24196,19,0.108298,0.146884,675,0,0
8588362,"Schüpbach, Emmenbrücke",,0.000035,123,1,1,2,950,950,1900,14,0.145455,0.255306,576,0,0
8576711,"Eggiwil, Zilmatt",,0.000031,123,1,1,2,11928,11928,23856,17,0.120192,0.152072,623,0,0
8576712,"Eggiwil, Tenndli",,0.000037,123,1,1,2,11928,11928,23856,16,0.134791,0.172913,676,0,0
8576713,"Röthenbach i.E., Fischbach",,0.000043,123,1,1,2,11928,11928,23856,15,0.153684,0.204865,727,0,0
8588358,"Langnau i.E., Hübeli",,0.000084,123,3,1,4,15205,15832,31037,17,0.152425,0.214476,529.916667,0,0
8576718,"Meinisberg, Rütti",,0.000014,87,1,1,2,17658,17686,35344,24,0.088488,0.10285,296,0,0
8576719,"Safnern, Dorfplatz",,0.000022,87,1,1,2,17686,17702,35388,23,0.096607,0.112701,427,0,0
8576720,"Safnern, Kirchweg",,0.00003,87,1,1,2,17702,17702,35404,22,0.106416,0.125239,556,0,0
8576721,"Orpund, Bürenstrasse",,0.000036,87,1,1,2,17702,17702,35404,21,0.118506,0.141833,683,0,0
8582574,"Meinisberg, Rosenweg",,0.000023,87,1,1,2,9099,9085,18184,10,0.198556,0.241926,0,0,0
8587841,"Biel/Bienne, Bibliothek",,0.000023,87,1,2,3,63193,63195,126388,10,0.234043,0.298146,41583.739683,0,0
8587898,"Biel/Bienne, Centre Boujean",,0.000066,87,3,6,9,52555,52549,105104,15,0.177358,0.285155,50177.271429,0,0
8576726,"Brienz BE, Rössliplatz",,0.000051,114,2,1,3,1337,1337,2674,21,0.110497,0.164147,245,0,0
8576728,"Brienz BE, Bahnhof",,0.000127,114,7,3,10,6784,6925,13709,19,0.136792,0.24511,1387,0,0
8576734,"Hofstetten b. Brienz, Rüttiweg",,0.000061,114,1,1,2,4505,4505,9010,20,0.114035,0.176219,260,0,0
8576729,"Brienz BE, Altersheim",,0.000047,114,1,1,2,4463,4503,8966,25,0.077975,0.116196,135,0,0
8576730,"Schwanden b. Brienz, Birgli",,0.000051,114,1,1,2,4503,4505,9008,24,0.083086,0.12284,164,0,0
8576731,"Schwanden b. Brienz, Stocki",,0.000054,114,1,1,2,4505,4504,9009,23,0.088997,0.131064,191,0,0
8576732,"Schwanden b. Br., Derfliplatz",,0.000057,114,1,1,2,4504,4503,9007,22,0.095915,0.141604,216,0,0
8576733,Oberschwanden,,0.000059,114,1,1,2,4503,4505,9008,21,0.104126,0.155773,239,0,0
8576735,"Hofstetten b. Brienz, Dorfpl.",,0.000099,114,2,1,3,5780,5530,11310,19,0.126238,0.209471,361,0,0
8576737,"Brienz BE, Lammbach",,0.000067,114,2,3,5,3546,3276,6822,18,0.136232,0.261794,1206,0,0
8579711,"Balm b. Meiringen, Urbachsey",,0.000059,114,1,2,3,2851,2851,5702,17,0.129909,0.217793,953,0,0
8576739,"Brienz BE, Fulbach",,0.00003,114,1,2,3,2462,2462,4924,9,0.261905,0.368741,108,0,0
8576742,"Hofstetten b. Brienz, Seeli",,0.000037,114,1,1,2,1275,1275,2550,9,0.24359,0.330472,38,0,0
8579962,"Brienzwiler, Bahnhof",,0.000075,114,3,2,5,3682,3875,7557,17,0.135048,0.24299,1360,0,0
8580744,"Hasliberg Hohfluh, Bären",,0.000066,114,1,1,2,3972,122,4094,9,0.24359,0.330472,114,0,0
8576740,"Brienz BE, Lauenen",,0.000024,114,1,1,2,1275,1275,2550,11,0.176471,0.238305,74,0,0
8576741,"Hofstetten b. Brienz, Tor",,0.000031,114,1,1,2,1275,1275,2550,10,0.204082,0.271925,57,0,0
8576743,"Wettswil a.A., Beerimoos",,0.000034,85,1,1,2,1619,1623,3242,27,0.065394,0.070307,3397,0,0
8576747,"Sigriswil, Dorf",,0.000071,43,2,1,3,2548,570,3118,9,0.2,0.302897,135,0,0
8576748,"Sigriswil, Port",,0.000071,43,1,1,2,570,570,1140,8,0.225,0.329762,123,0,0
8576751,"Schwanden, Stalden",,0.000083,43,2,1,3,1140,1140,2280,6,0.304348,0.421429,133,0,0
8576753,"Schwanden, Schulhaus",,0.000082,43,1,2,3,1140,1140,2280,5,0.375,0.547222,115,0,0
8588490,"Tschingel, Unterdorf",,0.000225,43,1,1,2,569,570,1139,1,1,1,195,0,0
8576757,"Gunten, Örtliboden",,0.000046,43,1,1,2,570,570,1140,5,0.333333,0.456667,79,0,0
8576758,"Aeschlen, Mattikehr",,0.00005,43,1,1,2,570,570,1140,4,0.4,0.520833,57,0,0
8576760,"Aeschlen, Erliboden",,0.000053,43,1,1,2,570,570,1140,3,0.5,0.611111,33,0,0
8576872,"Hilterfingen, Kirche",,0.000037,43,1,2,3,4341,4341,8682,21,0.079545,0.173613,2312,0,0
8576875,"Gunten, Du Lac",,0.000033,43,1,2,3,2335,2335,4670,19,0.087533,0.183394,2086,0,0
8576880,"Merligen, Kreuz",,0.000048,43,1,2,3,2096,2096,4192,14,0.118143,0.216156,1565,0,0
8583681,"Interlaken, Jungfraustrasse",,0.000172,43,5,1,6,7606,779,8385,3,0.5,0.611111,520,0,0
8582962,"Reconvilier, Bel-Air",,0.00005,1,1,2,3,2419,2349,4768,3,0.571429,0.708333,13.5,0,0
8581963,"Bassecourt, école secondaire",,0.00003,1,1,1,2,1756,1756,3512,4,0.4,0.520833,0,0,0
8582973,"Bassecourt, Colonel-Hoffmeyer",,0.000058,1,1,1,2,1871,1829,3700,2,0.666667,0.75,4,0,0
8583050,"Fornet-Dessous, La Matenne",,0.000045,1,2,2,4,1828,1777,3605,2,0.75,0.833333,19.833333,0,0
8583614,"Saicourt, Scierie",,0.000091,1,3,1,4,2791,1103,3894,2,0.666667,0.75,28,0,0
8576781,"Saignelégier, Pâquier",,0.000046,1,2,1,3,3287,3407,6694,7,0.226415,0.300794,632,0,0
8576782,"Le Bémont JU, village",,0.00005,1,1,1,2,3407,3411,6818,6,0.268293,0.339394,581,0,0
8576783,"Montfaucon, bif. Les Enfers",,0.000054,1,1,1,2,3411,3413,6824,5,0.333333,0.403333,528,0,0
8576785,"St-Brais, Le Péquie",,0.000056,1,1,2,3,3413,3427,6840,4,0.45,0.546296,473,0,0
8576787,"Glovelier,Croix des Longs-Prés",,0.000041,1,1,2,3,3195,3195,6390,4,0.466667,0.583333,73,0,0
8582154,"Glovelier, ZAM/rte de Boécourt",,0.000028,1,1,1,2,2462,2322,4784,4,0.428571,0.513889,0,0,0
8576786,"Sceut, poste",,0.000035,1,1,1,2,3195,3195,6390,5,0.347826,0.43125,132,0,0
8576788,"Uster, Burgreben",,0.000038,84,2,2,4,16974,17788,34762,4,0.4,0.555556,405.266667,0,0
8581539,"Uster, Apothekerstrasse",,0.000027,84,1,1,2,16704,16720,33424,4,0.357143,0.466667,0,0,0
8576789,"Blumenstein, Bad",,0.00004,43,2,1,3,1857,1857,3714,21,0.096591,0.144374,232,0,0
8576791,"Wattenwil, Bären",,0.000079,43,3,2,5,2457,2457,4914,19,0.114754,0.192159,1762,0,0
8576794,"Pohlern, Rohrmoos",,0.000025,43,2,1,3,1138,1138,2276,23,0.064926,0.086351,3804,0,0
8576795,"Forst, Käserei",,0.000044,43,1,1,2,1080,1080,2160,22,0.084229,0.12617,1175,0,0
8576796,"Forst, Breite",,0.000049,43,1,1,2,1080,1080,2160,21,0.09002,0.133333,986,0,0
8576797,"Längenbühl, Bach",,0.000052,43,1,1,2,1080,1080,2160,20,0.096774,0.142392,795,0,0
8576798,"Längenbühl, Grizzlibär",,0.000055,43,1,1,2,1080,1080,2160,19,0.104762,0.154525,602,0,0
8576799,"Längenbühl, Weiermatt",,0.000058,43,1,1,2,1080,1080,2160,18,0.114362,0.172492,407,0,0
8576802,"Blumenstein, Lochmannsbühl",,0.000029,43,1,1,2,1167,1167,2334,19,0.104278,0.158045,1944,0,0
8576803,"Blumenstein, Reckenbühl",,0.000036,43,1,1,2,1167,1167,2334,18,0.113433,0.175178,1739,0,0
8576805,"Uebeschi, Dürrenbühl",,0.000028,43,1,1,2,1047,1047,2094,22,0.080717,0.132007,1230,0,0
8576806,"Uebeschi, Neurütti",,0.000035,43,1,1,2,1047,1047,2094,21,0.085366,0.137098,1019,0,0
8576807,"Uebeschi, Neubau",,0.000041,43,1,1,2,1047,1047,2094,20,0.090667,0.142966,806,0,0
8576808,"Uebeschi, Dorf",,0.000046,43,1,1,2,1047,1047,2094,19,0.096774,0.149876,591,0,0
8576809,"Uebeschi, Weiersbühl",,0.00005,43,1,1,2,1047,1047,2094,18,0.103896,0.158248,374,0,0
8576811,"Thierachern, Egg",,0.000128,43,5,1,6,2247,2247,4494,16,0.122449,0.182956,1296,0,0
8576812,"Thierachern, Kirche",,0.000119,43,1,1,2,2247,2247,4494,15,0.134884,0.204092,1073,0,0
8576813,"Thierachern, oberer Schwand",,0.000112,43,1,2,3,2247,2247,4494,14,0.150538,0.24515,848,0,0
8576814,"Thierachern, Niesenstrasse",,0.000059,43,1,1,2,1947,1947,3894,14,0.145946,0.217193,0,0,0
8576815,"Thun, Waldeck",,0.00003,43,2,2,4,6802,6802,13604,14,0.14433,0.221098,4636.65,0,0
8576817,"Thun, Guisanplatz",,0.000121,43,3,2,5,8061,8061,16122,13,0.164557,0.263125,1558.65,0,0
8576890,"Uebeschi, Kärselen",,0.000062,43,1,1,2,120,120,240,13,0.159236,0.23365,0,0,0
8576818,"Blumenstein, Bären",,0.000032,43,1,1,2,1138,1138,2276,22,0.068719,0.090173,3668,0,0
8576819,"Blumenstein, Fallbach",,0.000038,43,1,1,2,1138,1138,2276,21,0.073021,0.094596,3530,0,0
8576820,"Pohlern, Hölzlibach",,0.000043,43,1,1,2,1138,1138,2276,20,0.077944,0.099792,3390,0,0
8576821,"Pohlern, Maad",,0.000048,43,1,1,2,1138,1138,2276,19,0.083633,0.106012,3248,0,0
8576822,"Pohlern, Schlössli",,0.000052,43,1,1,2,1138,1138,2276,18,0.090285,0.113648,3104,0,0
8576823,"Pohlern, Alte Post",,0.000055,43,1,1,2,1138,1138,2276,17,0.098166,0.123375,2958,0,0
8576825,"Oberstocken, Kreuzgasse",,0.000064,43,2,2,4,1227,1706,2933,15,0.119303,0.157879,2843.666667,0,0
8576836,"Allmendingen, Dorf",,0.000078,43,3,2,5,6082,6083,12165,14,0.121726,0.163762,6746.333333,0,0
8576838,"Thun, Martinstrasse",,0.000048,43,1,2,3,5994,5994,11988,14,0.128763,0.179623,1655,0,0
8576826,"Höfen, Kistlern",,0.000038,43,1,1,2,1227,1227,2454,23,0.062633,0.086231,1955,0,0
8576827,"Höfen, Speck",,0.000043,43,1,1,2,1227,1227,2454,22,0.066059,0.089622,1801,0,0
8576828,"Höfen, Unteregg",,0.000048,43,1,1,2,1227,1227,2454,21,0.069919,0.093501,1645,0,0
8576829,"Amsoldingen, See",,0.000051,43,1,1,2,1227,1227,2454,20,0.074301,0.097995,1487,0,0
8576830,"Amsoldingen, Sandgrube",,0.000055,43,1,1,2,1227,1227,2454,19,0.07932,0.103283,1327,0,0
8576831,"Amsoldingen, Kirche",,0.000057,43,1,1,2,1227,1227,2454,18,0.085128,0.109627,1165,0,0
8576832,"Amsoldingen, Kreuz",,0.00006,43,1,1,2,1227,1227,2454,17,0.091928,0.117443,1001,0,0
8576833,"Amsoldingen, Steghalten",,0.000062,43,1,1,2,1227,1227,2454,16,0.1,0.127458,835,0,0
8576837,"Allmendingen, Längmatt",,0.000044,43,1,1,2,5994,5994,11988,15,0.115385,0.151428,1829,0,0
8576853,"Zwieselberg, Glütsch",,0.000064,43,2,2,4,1410,1410,2820,12,0.152968,0.20903,1383,0,0
8576839,"Oberstocken, Wolfbuchen",,0.000092,43,3,1,4,1556,1646,3202,14,0.128596,0.15907,5332,0,0
8576840,"Niederstocken, Stockhorn",,0.000089,43,1,1,2,1646,1646,3292,13,0.145631,0.183652,5154,0,0
8576841,"Niederstocken, Schwand",,0.000086,43,1,2,3,1646,1646,3292,12,0.168182,0.225607,4974,0,0
8588171,"Thun, Burgerallee",,0.000072,43,3,3,6,5994,5994,11988,11,0.181208,0.293726,1673.166667,0,0
8588173,"Allmendingen, Wendeplatz",,0.000051,43,2,2,4,5993,5993,11986,11,0.175676,0.266561,371,0,0
8576856,"Gwatt, Gwattstutz",,0.000043,43,1,2,3,1380,1380,2760,12,0.166234,0.228369,723,0,0
8587471,"Gwatt, Deltapark",,0.000067,43,2,2,4,6568,6568,13136,12,0.165354,0.228025,2516,0,0
8587873,"Thun, Seepark",,0.000052,43,1,1,2,5787,5787,11574,12,0.16,0.208871,2049,0,0
8576845,"Reutigen, Viehschauplatz",,0.000033,43,3,2,5,1410,1410,2820,13,0.139806,0.193563,2333,0,0
8576851,"Wimmis, Bahnhof",,0.000045,43,2,1,3,1290,1290,2580,13,0.134387,0.173086,204,0,0
8576847,"Reutigen, Kapf",,0.000025,43,1,1,2,1290,1290,2580,15,0.109737,0.142566,774,0,0
8576848,"Wimmis, Brodhüsi",,0.000032,43,1,2,3,1290,1290,2580,14,0.121528,0.164176,586,0,0
8576850,"Wimmis, Dorf",,0.000025,43,1,1,2,630,630,1260,14,0.12,0.152062,0,0,0
8576854,"Reutigen, Hani",,0.000038,43,1,1,2,1380,1380,2760,13,0.144444,0.185819,922,0,0
8576859,"Thun, Seeblick",,0.000051,43,3,2,5,6568,6568,13136,14,0.130604,0.178904,3264,0,0
8576860,"Thun, Pfaffenbühl",,0.000032,43,1,1,2,5758,5758,11516,14,0.128906,0.166463,0,0,0
8576861,"Thun, Strandbad",,0.00006,43,2,2,4,6568,6568,13136,13,0.14574,0.198126,2894,0,0
8587406,"Gwatt, Bonstettenpark",,0.000036,43,1,1,2,5758,5758,11516,13,0.14382,0.185597,0,0,0
8576862,"Thun, Dürrenast",,0.000014,43,1,2,3,5662,5722,11384,17,0.111639,0.169318,108,0,0
8576863,"Thun, Hohmad",,0.000017,43,1,1,2,5662,5662,11324,17,0.109524,0.15126,0,0,0
8576864,"Thun, Freienhof",,0.000024,43,2,1,3,2186,2186,4372,28,0.063576,0.11594,1763,0,0
8576865,"Thun, Bälliz",,0.000024,43,2,1,3,2155,2151,4306,28,0.063576,0.11594,1763,0,0
8576866,"Thun, Thunerhof",,0.000052,43,2,1,3,4337,4341,8678,27,0.066478,0.122128,3499,0,0
8576867,"Thun, Hofstetten",,0.000055,43,1,1,2,4341,4341,8682,26,0.069697,0.130263,3422,0,0
8576868,"Thun, Bächimatt",,0.000058,43,1,1,2,4341,4341,8682,25,0.07329,0.141844,3343,0,0
8576871,"Hünibach, Eichbühl",,0.00003,43,1,1,2,4341,4341,8682,22,0.07563,0.148362,2405,0,0
8576874,"Oberhofen, Örtlibach",,0.000026,43,1,1,2,2335,2335,4670,20,0.082725,0.156273,2183,0,0
8576876,"Gunten, Stampbach",,0.000025,43,1,1,2,2096,2096,4192,18,0.089136,0.147478,1981,0,0
8576877,"Merligen, Ralligen",,0.000032,43,1,1,2,2096,2096,4192,17,0.094801,0.155509,1880,0,0
8576878,"Merligen, Bäregg",,0.000038,43,1,1,2,2096,2096,4192,16,0.101351,0.166201,1777,0,0
8576879,"Merligen, Vorderdorf",,0.000043,43,1,1,2,2096,2096,4192,15,0.109023,0.182426,1672,0,0
8576881,"Merligen, Nastel",,0.000031,43,1,1,2,779,779,1558,13,0.11157,0.166404,1441,0,0
8576882,"Sundlauenen, Geisskilche",,0.000037,43,1,1,2,779,779,1558,12,0.12093,0.175143,1330,0,0
8576883,"Sundlauenen, Balmholz",,0.000043,43,1,1,2,779,779,1558,11,0.132275,0.185638,1217,0,0
8576884,"Sundlauenen, Pilgerweg",,0.000047,43,1,1,2,779,779,1558,10,0.146341,0.198628,1102,0,0
8576885,"Unterseen, Gelbenbrunnen",,0.000051,43,1,1,2,779,779,1558,9,0.164286,0.215355,985,0,0
8576886,"Unterseen, Manor Farm",,0.000054,43,1,1,2,779,779,1558,8,0.188034,0.238095,866,0,0
8576887,"Unterseen, Schiessstand Lehn",,0.000057,43,1,1,2,779,779,1558,7,0.221053,0.271542,745,0,0
8576891,"Farnern, Jura",,0.00002,88,1,1,2,6948,6948,13896,24,0.063904,0.088469,91,0,0
8576892,"Rumisberg, Schoren",,0.000028,88,1,1,2,6948,6948,13896,23,0.067517,0.092568,180,0,0
8576893,"Rumisberg, Weissacker",,0.000035,88,1,1,2,6948,6948,13896,22,0.071601,0.097418,267,0,0
8576894,"Wiedlisbach, Pflegeheim",,0.00004,88,1,1,2,6948,6948,13896,21,0.076256,0.103293,352,0,0
8576895,"Wiedlisbach, Stockrain",,0.000045,88,1,1,2,6948,6948,13896,20,0.081614,0.110653,435,0,0
8576896,"Wiedlisbach, Bahnhof",,0.000049,88,1,1,2,6948,6948,13896,19,0.087845,0.120353,516,0,0
8576897,"Wiedlisbach, Wangenstrasse",,0.000053,88,1,1,2,6948,6948,13896,18,0.095185,0.134318,595,0,0
8576899,"Wangen a.d.Aare, Zytglogge",,0.00005,88,3,1,4,19637,19884,39521,17,0.10285,0.148836,63.333333,0,0
8576900,"Wangen a.A., Bahnhof",,0.000077,88,2,5,7,23358,23344,46702,16,0.11326,0.189118,879.333333,0,0
8576904,"Wangenried, Sägerei",,0.000043,88,1,3,4,5962,5962,11924,15,0.115385,0.169493,227,0,0
8576937,"Langenthal, Bahnhof",,0.000104,88,3,8,11,74846,62068,136914,19,0.155844,0.360331,1543.333333,0,0
8578123,"Inkwil, Dorf",,0.000042,88,2,1,3,2486,2486,4972,2,0.666667,0.75,8,0,0
8589945,"Walliswil b. Wangen, Stalden",,0.000062,88,3,1,4,6200,6141,12341,2,0.666667,0.75,12,0,0
8589946,"Wangen a.d. Aare, Unterführung",,0.000142,88,5,1,6,19811,3474,23285,1,1,1,55.666667,0,0
8576901,"Wangenried, Unterdorf",,0.000024,88,1,1,2,5962,5962,11924,18,0.088652,0.117417,56,0,0
8576902,"Wangenried, Linde",,0.000031,88,1,1,2,5962,5962,11924,17,0.095979,0.127395,115,0,0
8576903,"Wangenried, Schule",,0.000037,88,1,1,2,5962,5962,11924,16,0.104735,0.141886,172,0,0
8576906,"Röthenbach, Schützenhaus",,0.000036,88,2,1,3,7711,7711,15422,15,0.112164,0.139956,760,0,0
8576907,"Stels, Crals",,0.000037,112,1,1,2,1963,1963,3926,2,0.666667,0.75,2956,0,0
8576908,"Röthenbach, Chrump",,0.000054,88,2,1,3,8209,8209,16418,14,0.124555,0.155216,1083,0,0
8576914,"Heimenhausen, Post",,0.000051,88,1,2,3,6142,6199,12341,14,0.126126,0.171406,350,0,0
8576909,"Walliswil b. Wangen, Seilerei",,0.000024,88,1,1,2,6199,6199,12398,19,0.081522,0.107618,75,0,0
8576910,"Walliswil b. Wangen, Post",,0.000031,88,1,1,2,6199,6199,12398,18,0.087574,0.114178,134,0,0
8576911,"Walliswil b. Wangen, Sonne",,0.000037,88,1,1,2,6199,6142,12341,17,0.094682,0.122291,191,0,0
8576912,"Walliswil b. Wangen, Tal",,0.000043,88,1,1,2,6142,6141,12283,16,0.103152,0.132745,246,0,0
8576913,"Heimenhausen, Riedgasse",,0.000047,88,1,1,2,6141,6142,12283,15,0.113419,0.147233,299,0,0
8576915,"Wanzwil, Post",,0.000078,88,2,1,3,12416,12417,24833,13,0.140244,0.176877,1528,0,0
8576954,"Bollodingen, Dorf",,0.000057,88,1,1,2,7971,7971,15942,10,0.181818,0.285601,421,0,0
8576918,"Herzogenbuchsee, Sonnenplatz",,0.00003,88,1,1,2,21249,21249,42498,26,0.082592,0.117751,294,0,0
8576919,"Herzogenbuchsee, Friedhof",,0.000036,88,1,1,2,21249,21249,42498,25,0.088643,0.12588,309,0,0
8576920,"Bützberg, Neuquartier",,0.000042,88,1,1,2,21249,21249,42498,24,0.095745,0.136206,322,0,0
8576921,"Bützberg, Käserei",,0.000046,88,1,1,2,21249,21249,42498,23,0.104202,0.149872,333,0,0
8576923,"Bützberg, Unterdorf",,0.00005,88,1,1,2,21249,21249,42498,22,0.114447,0.169054,342,0,0
8576924,"Langenthal, Dreilinden",,0.000054,88,1,1,2,21249,21235,42484,21,0.127119,0.19861,349,0,0
8576927,"Langenthal, Tell/Kantonalbank",,0.000067,88,1,3,4,82846,82846,165692,19,0.156593,0.28299,2074.833333,0,0
8576936,"Melchnau, Oberdorf",,0.000059,88,1,1,2,15959,15959,31918,20,0.137255,0.245383,343,0,0
8576926,"Langenthal, Wiesenstrasse",,0.000066,88,4,1,5,34412,82846,117258,20,0.137441,0.214579,2073.833333,0,0
8576940,"Langenthal, Schoren-Ochsen",,0.000047,88,2,1,3,13895,13648,27543,19,0.108614,0.192962,58,0,0
8576944,"Thunstetten, Wischberg",,0.000036,88,1,1,2,7473,7473,14946,19,0.108614,0.192962,58,0,0
8576928,"Langenthal, Rössli",,0.00003,88,1,1,2,15959,15959,31918,27,0.076923,0.115879,406,0,0
8576929,"Langenthal, Neuhof",,0.000036,88,1,1,2,15959,15959,31918,26,0.081845,0.122238,403,0,0
8576930,"Obersteckholz, Post",,0.000042,88,1,1,2,15959,15959,31918,25,0.08752,0.130027,398,0,0
8576931,"Obersteckholz, am Wald",,0.000046,88,1,1,2,15959,15959,31918,24,0.094139,0.139863,391,0,0
8576932,"Melchnau, Rotwald",,0.00005,88,1,1,2,15959,15959,31918,23,0.101961,0.152793,382,0,0
8576933,"Ettenhausen TG, Elggerstrasse",,0.000048,65,1,1,2,8830,8830,17660,2,0.666667,0.75,340,0,0
8576934,"Melchnau, Unterdorf",,0.000054,88,1,1,2,15959,15959,31918,22,0.111354,0.170766,371,0,0
8576935,"Melchnau, Fabrik",,0.000057,88,1,1,2,15959,15959,31918,21,0.12285,0.197935,358,0,0
8576939,"Langenthal, Schorenstrasse",,0.00003,88,1,1,2,6949,6949,13898,20,0.10101,0.173571,30,0,0
8589201,"Langenthal, Industrie Nord",,0.000022,88,1,2,3,27773,27792,55565,5,0.36,0.485185,33.5,0,0
8576938,"Langenthal, Lindenhof",,0.000022,88,1,1,2,6948,6949,13897,21,0.094512,0.160878,67,0,0
8576942,"Langenthal, Schoren-Eisbahn",,0.000022,88,1,1,2,7472,7473,14945,21,0.094512,0.160878,134,0,0
8576943,"Thunstetten, Schorenmatte",,0.00003,88,1,1,2,7473,7473,14946,20,0.10101,0.173571,97,0,0
8576945,"Langenthal, Löwenplatz",,0.000112,88,4,2,6,30364,29091,59455,18,0.117647,0.232134,1358.5,0,0
8576946,"Langenthal, Bleichestrasse",,0.000058,88,1,1,2,15443,15444,30887,17,0.107692,0.19904,868.5,0,0
8576947,"Langenthal, Neuhüsli",,0.00006,88,1,2,3,15444,15444,30888,16,0.114943,0.232191,814.5,0,0
8589939,"Langenthal, Sängeli",,0.000044,88,1,1,2,7971,7971,15942,1,1,1,55.5,0,0
8576949,"Langenthal, Dennli",,0.000037,88,1,1,2,6699,7971,14670,15,0.117284,0.196549,731,0,0
8576950,"Bleienbach, Unterdorf",,0.000042,88,1,1,2,7971,7971,15942,14,0.125874,0.206741,673,0,0
8576951,"Bettenhausen, Dorf",,0.000047,88,1,1,2,7971,7971,15942,13,0.136,0.218885,613,0,0
8576952,"Bettenhausen, Post",,0.00005,88,1,1,2,7971,7971,15942,12,0.148148,0.234007,551,0,0
8576953,"Bollodingen, Hegen",,0.000054,88,1,1,2,7971,7971,15942,11,0.163043,0.254288,487,0,0
8576955,"Herzogenbuchsee, Bernstrasse",,0.000078,88,2,2,4,16481,16481,32962,9,0.206349,0.353602,894.5,0,0
8576957,"Tänikon, Forschungsanstalt",,0.000052,65,1,1,2,8830,8830,17660,1,1,1,171,0,0
8576959,"Oberönz, Kreuz",,0.000044,88,1,1,2,8510,8510,17020,8,0.204082,0.302738,686,0,0
8576961,"Seeberg BE, Schlüssel",,0.000061,88,2,1,3,9006,9006,18012,6,0.266667,0.3625,680,0,0
8576962,"Grasswil, Regenhalden",,0.000063,88,1,1,2,9006,9006,18012,5,0.318182,0.409524,602,0,0
8576963,"Grasswil, Oberdorf",,0.000064,88,1,1,2,9006,9006,18012,4,0.4,0.486111,522,0,0
8578936,"Ronco s. Ascona, Chiesa",,0.000053,101,2,3,5,9753,9753,19506,13,0.173913,0.214866,433,0,0
8579093,"Auressio, Ronchetto",,0.000034,101,2,2,4,5370,5370,10740,13,0.171285,0.205806,271.017857,0,0
8576972,Schönegg,,0.000039,44,3,1,4,6024,6024,12048,23,0.065164,0.077989,1175.833333,0,0
8576974,Lindenweg,,0.00005,44,3,1,4,4528,4530,9058,22,0.069146,0.081128,5826.666667,0,0
8576975,Coop,,0.000072,44,2,1,3,8928,8928,17856,21,0.07397,0.087003,5379,0,0
8576976,"Münchenbuchsee, Kipfgasse",,0.000072,44,1,1,2,8928,8927,17855,20,0.079542,0.094253,4445,0,0
8576977,Hofwilstrasse,,0.000072,44,1,1,2,8927,8928,17855,19,0.086049,0.10366,3509,0,0
8576981,Unterzollikofen,,0.000088,44,4,3,7,16398,16399,32797,17,0.102564,0.132086,11895,0,0
8589046,Betagtenheim,,0.000043,44,2,1,3,5984,5984,11968,4,0.333333,0.416667,0,0,0
8576989,Winkelriedstrasse,,0.000047,44,1,2,3,6669,6669,13338,2,0.666667,0.75,16,0,0
8589048,Geisshubel,,0.000079,44,1,2,3,9096,9096,18192,2,0.625,0.7,1187,0,0
8576984,Sandhof,,0.000023,44,1,1,2,6668,6669,13337,6,0.25,0.352083,4736,0,0
8576985,Löchligut,,0.000031,44,1,1,2,6669,6669,13338,5,0.291667,0.390476,3559,0,0
8576987,Wankdorf City,,0.000037,44,1,1,2,6669,6669,13338,4,0.352941,0.444444,2380,0,0
8576988,Stauffacherbrücke,,0.000042,44,1,1,2,6669,6669,13338,3,0.454545,0.533333,1199,0,0
8589049,Kreuz,,0.000085,44,4,3,7,10415,9807,20222,1,1,1,3569.5,0,0
8589012,Gerenstrasse,,0.000018,44,1,1,2,2988,2988,5976,10,0.180556,0.269536,22.72619,0,0
8595514,"Ittigen, Pulverstutz",,0.000114,44,1,2,3,11750,6029,17779,3,0.571429,0.708333,645.533333,0,0
8576994,Eyfeld,,0.000022,44,1,1,2,11743,11750,23493,15,0.152207,0.177346,4084.833333,0,0
8577015,Tannacker,,0.00004,44,1,1,2,3722,3722,7444,16,0.102564,0.126337,884.75,0,0
8577016,Sonnenfeld,,0.00005,44,2,2,4,4277,4277,8554,15,0.113043,0.142889,966.233333,0,0
8588999,Morgartenstrasse,,0.00005,44,1,1,2,11253,11187,22440,8,0.213592,0.277381,470,0,0
8589010,Altes Schulhaus,,0.000024,44,2,2,4,3747,3747,7494,11,0.1875,0.310055,1194,0,0
8589008,Wyleregg,,0.000036,44,1,3,4,11158,11254,22412,11,0.196078,0.337383,297.5,0,0
8589011,Chrottengässli,,0.000034,44,3,2,5,3750,3750,7500,10,0.207317,0.328665,2433.635714,0,0
8576999,UPD Waldau,,0.000017,44,1,1,2,4923,4923,9846,20,0.110785,0.13097,2965.166667,0,0
8577000,Schermenweg,,0.000026,44,1,2,3,4923,4923,9846,19,0.123762,0.151231,1922.166667,0,0
8577002,Waldeck,,0.000035,44,2,1,3,19769,19775,39544,19,0.122415,0.143139,14139.866667,0,0
8577003,Ostermundigen Bahnhof,,0.000052,44,2,2,4,20414,20413,40827,18,0.138549,0.166815,13940.033333,0,0
8577004,Zollgasse,,0.000033,44,1,2,3,19136,19136,38272,17,0.159563,0.196574,11720.5,0,0
8577014,Gümligen Bahnhof,,0.000068,44,3,2,5,7179,7179,14358,17,0.09413,0.12291,2030.983333,0,0
8577006,Blankweg,,0.000018,44,1,1,2,3583,3583,7166,24,0.060443,0.082627,8482,0,0
8577007,Hubel,,0.000026,44,1,1,2,3583,3583,7166,23,0.063694,0.08657,7382,0,0
8577008,Dennigkofen,,0.000033,44,1,1,2,3583,3583,7166,22,0.067347,0.091807,6280,0,0
8577009,Freibad,,0.000039,44,1,2,3,3583,3583,7166,21,0.071481,0.101035,5176,0,0
8577010,Rütibühl,,0.000027,44,1,1,2,1791,1791,3582,21,0.070803,0.091767,0,0,0
8577011,Amselweg,,0.000051,44,2,1,3,3583,3583,7166,20,0.075412,0.096639,2962,0,0
8577012,Meisenweg,,0.000054,44,1,1,2,3583,3583,7166,19,0.080714,0.102582,1852,0,0
8577018,Muri Villette,,0.000037,44,2,1,3,8250,8250,16500,14,0.12465,0.147866,6984,0,0
8577020,Hübeliweg,,0.000043,44,1,1,2,8250,8250,16500,13,0.1408,0.167713,5860,0,0
8577021,Waldried,,0.000047,44,1,1,2,8250,8250,16500,12,0.162011,0.197159,4734,0,0
8577023,Garten-Center,,0.000025,44,1,1,2,4654,4653,9307,12,0.150177,0.177741,1216,0,0
8588258,Münsingen Schwand,,0.000028,100,1,1,2,3088,3088,6176,10,0.157025,0.219841,48,0,0
8577027,Platane,,0.000029,89,2,1,3,4865,4865,9730,3,0.444444,0.541667,8,0,0
8577028,Feldegg,,0.000035,89,1,1,2,4865,4865,9730,2,0.6,0.666667,9,0,0
8577029,Hohrain,,0.000041,89,1,2,3,4865,4865,9730,1,1,1,8,0,0
8577030,Mätteli,,0.000028,89,1,1,2,4198,4120,8318,1,1,1,0,0,0
8577035,"Lauterbrunnen, Sandweidli",,0.000047,43,3,2,5,2353,2355,4708,4,0.428571,0.569444,661.733333,0,0
8577036,"Isenfluh, Dorf",,0.000031,43,1,1,2,2023,2023,4046,4,0.384615,0.483333,0,0,0
8577038,"Matten b. I., Hertigässli",,0.000035,43,2,1,3,6445,6445,12890,14,0.142012,0.219343,620.166667,0,0
8577039,"Interlaken, Zentrum Artos",,0.000036,43,2,2,4,10765,10765,21530,14,0.144543,0.235275,443.833333,0,0
8577040,"Niederried b.I'laken, Dorf",,0.000026,43,1,1,2,655,655,1310,14,0.142012,0.219343,0,0,0
8579133,"Interlaken, Berufsschule BZI",,0.00005,43,1,1,2,3433,3433,6866,14,0.142012,0.219343,335,0,0
8577043,"Quartino, Centro Luserte",,0.000047,108,1,1,2,13966,13966,27932,15,0.114957,0.137346,42349,0,0
8577045,"Barbengo, Baldoria",,0.000055,102,1,1,2,23370,23370,46740,15,0.132255,0.149669,130,0,0
8577046,"Barbengo, Sidema",,0.000058,102,1,1,2,23370,23370,46740,14,0.151316,0.172875,203,0,0
8579270,"Saanen, Bellerivestrasse",,0.000031,42,1,5,6,5387,5443,10830,8,0.316667,0.495677,53,0,0
8579271,"Gstaad, Grubenstrasse",,0.000036,42,2,4,6,2761,2705,5466,8,0.305085,0.467659,53,0,0
8577051,"Entlebuch, Bahnhof",,0.000095,92,6,3,9,4566,5009,9575,8,0.225806,0.341879,1352,0,0
8577053,"Entlebuch, Marktplatz",,0.000043,92,2,1,3,2013,1993,4006,8,0.222222,0.339732,0,0,0
8577063,"Entlebuch, Lehn",,0.000016,92,1,1,2,1915,1824,3739,4,0.384615,0.483333,0,0,0
8577064,"Entlebuch, Rusacher",,0.00003,92,2,1,3,1941,1987,3928,3,0.5,0.583333,4,0,0
8577054,"Entlebuch, Spüelen",,0.00008,92,3,1,4,2358,2298,4656,7,0.25,0.370408,413,0,0
8577055,"Entlebuch, Unteregg",,0.000079,92,1,1,2,2298,2298,4596,6,0.285714,0.408333,360,0,0
8577056,"Finsterwald LU, Erlengraben",,0.000078,92,1,1,2,2298,2298,4596,5,0.333333,0.456667,305,0,0
8577057,"Finsterwald LU, Chilenwald",,0.000077,92,1,1,2,2298,2298,4596,4,0.4,0.520833,248,0,0
8577058,"Finsterwald LU, Kirche",,0.000076,92,1,1,2,2298,2298,4596,3,0.5,0.611111,189,0,0
8577059,"Finsterwald LU, Lippern",,0.000076,92,1,1,2,2298,2298,4596,2,0.666667,0.75,128,0,0
8577061,"Finsterwald LU, Schwändeli",,0.000075,92,1,1,2,2298,2298,4596,1,1,1,65,0,0
8577067,"Ebnet (Entlebuch), Schulhaus",,0.000042,92,2,2,4,2024,2029,4053,2,0.75,0.833333,180,0,0
8579703,"Entlebuch, Schwand",,0.000035,92,1,1,2,1987,1870,3857,1,1,1,1,0,0
8577091,"Hochdorf, Bahnhof",,0.000045,90,2,2,4,7811,7811,15622,43,0.066794,0.097054,35389.380952,0,0
8577092,"Hochdorf, Industriestrasse",,0.00003,90,1,1,2,3487,3485,6972,4,0.416667,0.516667,137,0,0
8577137,"Tumegl/Tomils, Abzw. Hof Moos",,0.000066,111,2,1,3,1694,748,2442,6,0.285714,0.408333,54,0,0
8577159,Ebikon Hofmatt,,0.000084,90,3,2,5,107597,107275,214872,42,0.074196,0.116948,5967.333333,0,0
8589695,"Kastanienbaum, Waldwinkel",,0.000061,90,1,4,5,16788,17043,33831,9,0.240246,0.294692,1164,0,0
8589733,Kriens Pilatusmarkt,,0.0001,90,3,4,7,50481,50096,100577,9,0.241573,0.298233,3022.586508,0,0
8589748,Kriens Zunacher,,0.000066,90,2,1,3,20840,9510,30350,9,0.238255,0.276028,133.75,0,0
8589778,Luzern Dreilinden,,0.000023,90,1,2,3,61923,61972,123895,9,0.239865,0.285418,165.028571,0,0
8589779,Luzern Eggen,,0.000072,90,2,3,5,57297,58346,115643,8,0.255396,0.309205,604.257143,0,0
8582769,"Stans, Hansmatt",,0.000055,62,1,2,3,3810,3811,7621,12,0.151079,0.183936,4647,0,0
8588747,Kriens Steinibach,,0.000046,90,4,2,6,50238,61617,111855,12,0.156013,0.190656,4331.584524,0,0
8577149,Luzern Löwenplatz,,0.000021,90,2,2,4,130764,130765,261529,51,0.048783,0.076047,730.057875,0,0
8577150,Luzern Weggismatt,,0.00002,90,1,1,2,73096,101494,174590,50,0.048549,0.067133,805.070971,0,0
8577151,Luzern Maihof,,0.000028,90,1,2,3,101494,101498,202992,49,0.050909,0.07443,1170.070971,0,0
8589665,Ebikon Weichlen,,0.000133,90,5,4,9,124177,117932,242109,12,0.173025,0.220042,8931.612698,0,0
8589801,Luzern Kantonalbank,,0.000357,90,18,16,34,552142,552598,1104740,7,0.4,0.540159,22006.429029,0,0
8589807,Luzern Kreuzstutz,,0.00011,90,4,3,7,194907,133358,328265,7,0.290698,0.386381,862.9,0,0
8577152,Ebikon St. Klemens,,0.000023,90,1,1,2,91985,91988,183973,48,0.051931,0.065987,1462,0,0
8577153,Ebikon Hünenberg,,0.00003,90,1,1,2,91988,91987,183975,47,0.054649,0.070405,1823,0,0
8577154,Ebikon Falken,,0.000037,90,1,1,2,91987,91920,183907,46,0.057674,0.075674,2182,0,0
8577155,Ebikon Schachenweid,,0.000042,90,1,1,2,91920,91969,183889,45,0.061062,0.082107,2539,0,0
8589653,Adligenswil Rigiblick,,0.000041,90,1,2,3,17935,17935,35870,16,0.15229,0.214701,1293,0,0
8577164,Buchrain Reussbrücke,,0.000026,90,1,1,2,39061,39065,78126,42,0.068718,0.093779,411,0,0
8577169,Inwil Dorf,,0.000021,90,1,2,3,2650,2650,5300,41,0.07358,0.106772,30205.166667,0,0
8581812,"Kriens, Alpenstrasse",,0.000026,90,2,6,8,110768,108855,219623,11,0.210526,0.272766,8727.529762,0,0
8583380,"Gisikon, Weitblick",,0.000059,90,3,4,7,37695,36628,74323,13,0.152615,0.196732,1588.859524,0,0
8589660,Ebikon Halte,,0.000056,90,1,2,3,39063,18439,57502,13,0.142272,0.171755,417,0,0
8589663,Ebikon Höfli,,0.000071,90,1,1,2,15575,15629,31204,13,0.141982,0.166959,594,0,0
8577163,Buchrain Eichmatt,,0.000018,90,1,1,2,39010,39061,78071,43,0.064445,0.085247,85,0,0
8577168,"Inwil, Pannerhof",,0.000037,90,2,3,5,6924,9524,16448,42,0.070526,0.105254,36051.380952,0,0
8589224,"Waldibrücke, Bahnhof",,0.000027,90,2,1,3,2600,2600,5200,15,0.115968,0.133497,17.742857,0,0
8577170,Buchrain Haslirain,,0.000039,90,2,1,3,39119,39109,78228,41,0.073609,0.104976,1083.5,0,0
8577171,Perlen Dorf,,0.000044,90,1,1,2,39109,39110,78219,40,0.079264,0.120765,1405.5,0,0
8577179,Root Dorf,,0.000043,90,1,1,2,40179,40176,80355,14,0.147854,0.176331,2570.416667,0,0
8577173,Ebikon Schindler,,0.000035,90,3,1,4,105471,105477,210948,40,0.079167,0.120035,48694.42381,0,0
8589658,Buchrain Sagenwald,,0.000054,90,1,1,2,2600,2600,5200,13,0.148492,0.176011,4975.957143,0,0
8589664,Ebikon Ladengasse,,0.000125,90,6,3,9,107600,107600,215200,12,0.164286,0.204705,4901.075397,0,0
8577178,Root Ronmatt,,0.000037,90,2,1,3,40175,40179,80354,15,0.129412,0.149508,2610.416667,0,0
8582591,"Hochdorf, Schönau",,0.000041,90,1,1,2,4324,4314,8638,14,0.13321,0.159789,720,0,0
8589848,Luzern Wesemlinrain,,0.000127,90,2,2,4,130792,62235,193027,1,1,1,81.833333,0,0
8589860,Obernau Hammerschmiede,,0.000083,90,2,1,3,65002,108,65110,1,1,1,185.083333,0,0
8577182,"Feldis/Veulden, Sesselb. Mutta",,0.000067,111,1,1,2,748,748,1496,5,0.333333,0.456667,50,0,0
8577183,Luzern Casino-Palace,,0.000017,90,2,2,4,110315,110302,220617,49,0.049543,0.099543,1361.833333,0,0
8577184,Luzern Dietschiberg,,0.000018,90,1,1,2,78703,78693,157396,49,0.049391,0.09662,0,0,0
8577185,Luzern Verkehrshaus/Lido,,0.000033,90,2,3,5,110292,110249,220541,48,0.051788,0.117801,1841.833333,0,0
8588203,Luzern Brüel,,0.000086,90,2,3,5,31759,31730,63489,9,0.242515,0.289687,3922.504762,0,0
8589241,Luzern Haldensteig,,0.000045,90,2,2,4,39229,39249,78478,9,0.255591,0.300481,735.833333,0,0
8589668,Ebikon Sagenschulhaus,,0.000048,90,1,2,3,15629,15402,31031,9,0.249231,0.289981,2030.456349,0,0
8589669,Ebikon Zentralschulhaus,,0.000031,90,1,1,2,7817,7586,15403,9,0.246914,0.281106,0,0,0
8577186,Luzern Seefeldstrasse,,0.00002,90,1,1,2,31731,31758,63489,47,0.046961,0.060373,1758,0,0
8577187,Luzern Hotel Seeburg,,0.000028,90,1,1,2,31758,31758,63516,46,0.049114,0.063458,1993,0,0
8577189,Luzern Hermitage,,0.000035,90,1,1,2,31758,31758,63516,45,0.051482,0.067011,2226,0,0
8577190,Meggen Lerchenbühl,,0.000041,90,1,1,2,31758,31758,63516,44,0.054097,0.071159,2457,0,0
8577191,Meggen Rosenhalde,,0.000045,90,1,1,2,31758,31758,63516,43,0.057003,0.07608,2686,0,0
8577192,Meggen Balm,,0.000049,90,1,1,2,31758,31758,63516,42,0.060248,0.082038,2913,0,0
8577193,Meggen Schlössli,,0.000053,90,1,1,2,31758,38416,70174,41,0.063898,0.089451,3138,0,0
8577194,Meggen Kapelle,,0.000056,90,1,1,2,38416,45075,83491,40,0.068032,0.099034,3361,0,0
8577195,Meggen Huob,,0.000058,90,1,1,2,45075,45076,90151,39,0.072754,0.112197,3582,0,0
8577196,Meggen Kreuz,,0.000061,90,1,3,4,45076,45066,90142,38,0.078199,0.132842,3801,0,0
8577198,Meggen Böschenacher,,0.000036,90,2,1,3,15805,15810,31615,12,0.144082,0.163526,2,0,0
8577199,Meggen Obermattstrasse,,0.000059,90,2,1,3,31617,31623,63240,11,0.166333,0.187943,223,0,0
8577200,Meggen Tschädigen,,0.000061,90,1,1,2,31623,31624,63247,10,0.197115,0.224656,223,0,0
8587642,Merlischachen Dorf,,0.000027,91,1,1,2,135,135,270,10,0.197115,0.224656,3784.504762,0,0
8577205,"Küssnacht, Bahnhof",,0.000058,91,5,3,8,22524,26829,49353,36,0.084369,0.135394,48235.138095,0,0
8577206,"Küssnacht, Hauptplatz",,0.000027,91,1,2,3,25518,26243,51761,35,0.0741,0.116824,36423.633333,0,0
8577208,"Küssnacht, Honegg",,0.000023,91,1,1,2,24834,24882,49716,35,0.07377,0.112557,0,0,0
8577209,"Küssnacht, Breitfeld",,0.000042,91,2,3,5,26291,26295,52586,34,0.079261,0.134742,36345.633333,0,0
8577212,"Weggis, Zopf",,0.000037,91,1,1,2,18769,18769,37538,34,0.072682,0.094708,406,0,0
8577210,"Küssnacht am Rigi, Eichholtern",,0.000023,91,1,1,2,18769,18769,37538,36,0.064022,0.081775,496,0,0
8577211,"Weggis, Langenzihl",,0.00003,91,1,1,2,18769,18769,37538,35,0.068068,0.087595,452,0,0
8577213,"Weggis, Neubüel",,0.000054,91,2,1,3,20182,20182,40364,33,0.077992,0.103659,33487,0,0
8577216,"Weggis, Acher",,0.000057,91,1,1,2,20182,20182,40364,32,0.084171,0.115402,33437,0,0
8577217,"Weggis, Riedsort",,0.000059,91,1,1,2,20182,20182,40364,31,0.091449,0.131859,33385,0,0
8577222,"Vitznau, Unteraltdorf",,0.000033,91,2,1,3,14389,18070,32459,28,0.093422,0.12328,10602.2,0,0
8577223,"Vitznau, Floralpina",,0.000039,91,1,1,2,18070,18070,36140,27,0.102524,0.140897,10540.2,0,0
8580810,"Igis, Dorfplatz",,0.000042,109,2,2,4,13849,14003,27852,24,0.140293,0.188914,11389,0,0
8577229,"Melano, al Ponte",,0.000068,99,1,1,2,8838,16935,25773,13,0.139937,0.168664,1335,0,0
8579955,"Savosa, Liceo Ovest",,0.000046,102,2,2,4,15101,14835,29936,16,0.106112,0.139782,488.683333,0,0
8580699,"Manno, Centro di Calcolo",,0.000077,102,1,1,2,22904,22904,45808,16,0.104202,0.126067,1545.791667,0,0
8580700,"Manno, Suglio",,0.000161,102,5,2,7,45373,45677,91050,15,0.115385,0.144657,3365.018182,0,0
8579088,"Vallorbe, poste",,0.00006,35,7,2,9,5567,5664,11231,13,0.152263,0.218017,622.5,0,0
8579089,"Le Day, gare",,0.000037,35,1,1,2,1481,1465,2946,13,0.14876,0.196296,0,0,0
8579094,"Ballaigues, Vers-chez-Barrat",,0.00003,35,1,1,2,5705,5705,11410,9,0.188235,0.240129,2597,0,0
8579096,"Ballaigues, Jura-Rosaly",,0.000028,35,1,1,2,5281,5281,10562,11,0.144231,0.187845,2073,0,0
8579098,"Lignerolle, CVE",,0.000042,35,1,1,2,5318,5318,10636,9,0.187919,0.232115,1591,0,0
8577286,"Littau, Stächenrain",,0.000045,92,2,1,3,3850,3850,7700,20,0.074671,0.111627,3006,0,0
8577287,"Hellbühl, Moosschür",,0.000049,92,1,1,2,3850,3850,7700,19,0.079114,0.116026,2894,0,0
8577288,"Hellbühl, Post",,0.000052,92,1,1,2,3850,3850,7700,18,0.084192,0.121108,2780,0,0
8577289,"Hellbühl, Mittler Büel",,0.000055,92,1,1,2,3850,3850,7700,17,0.090056,0.127086,2664,0,0
8577290,"Ruswil, Ziswil",,0.000058,92,1,1,2,3850,3850,7700,16,0.096907,0.134272,2546,0,0
8577291,"Ruswil, Schlatt",,0.00006,92,1,1,2,3850,3850,7700,15,0.105023,0.143166,2426,0,0
8577292,"Ruswil, Moos",,0.000062,92,1,1,2,3850,3850,7700,14,0.114796,0.15463,2304,0,0
8577294,"Ruswil, Sonnhöfli",,0.00008,92,4,1,5,7050,7050,14100,12,0.141914,0.194493,4515,0,0
8577305,"Grosswangen, Hauelen",,0.000051,92,1,2,3,3275,3275,6550,1,1,1,10,0,0
8577296,"Ruswil, Soppenstig",,0.000033,92,1,1,2,5575,5575,11150,10,0.168478,0.211482,2581,0,0
8577297,"Buttisholz, Stalten",,0.000039,92,1,1,2,5575,5575,11150,9,0.196078,0.242712,2435,0,0
8581320,"Neuenkirch, Lippenrüti",,0.000053,90,2,1,3,14341,9429,23770,4,0.4,0.46875,390,0,0
8577300,"Buttisholz, Allmend",,0.000023,92,1,1,2,3275,3275,6550,6,0.259259,0.37381,900,0,0
8577301,"Grosswangen, Rot",,0.00003,92,1,1,2,3275,3275,6550,5,0.3,0.413889,726,0,0
8577302,"Grosswangen, Ed. Huber-Strasse",,0.000037,92,1,1,2,3275,3275,6550,4,0.357143,0.466667,550,0,0
8577303,"Grosswangen, Post",,0.000042,92,1,1,2,3275,3275,6550,3,0.444444,0.541667,372,0,0
8577304,"Grosswangen, Schutz",,0.000047,92,1,1,2,3275,3275,6550,2,0.6,0.666667,192,0,0
8588185,"Hellbühl, Unter Hellbühl",,0.000074,92,3,1,4,3850,3150,7000,1,1,1,182,0,0
8577308,"Bioggio Molinazzo, Stazione",,0.000077,102,3,1,4,20487,22904,43391,17,0.095057,0.114012,1522.791667,0,0
8577309,"Wald ZH, Binzholz",,0.000017,67,1,1,2,546,551,1097,24,0.070447,0.117804,196,0,0
8577316,"Wald ZH, Farnboden",,0.000026,67,1,1,2,551,551,1102,23,0.073937,0.121512,208,0,0
8577319,"Mauensee, Breiten",,0.000034,59,1,1,2,2950,2950,5900,10,0.159091,0.204181,633,0,0
8577320,"Mauensee, Schloss",,0.00004,59,1,1,2,2950,2950,5900,9,0.182432,0.228013,539,0,0
8577321,"Kottwil, Seewagen",,0.000045,59,1,1,2,2950,2950,5900,8,0.214876,0.263965,443,0,0
8577325,"Oberkirch, Feldhöfli",,0.000034,92,2,1,3,1825,1825,3650,9,0.180556,0.263858,1295,0,0
8577326,"Oberkirch, Zum gold. Wagen",,0.00004,92,1,1,2,1825,1825,3650,8,0.20339,0.285615,1127,0,0
8577329,"Nottwil, SPZ",,0.000074,92,2,1,3,3725,3625,7350,5,0.346154,0.42963,1656,0,0
8577330,"Nottwil, Abzw. Bahnhof",,0.000074,92,1,3,4,3625,3625,7250,4,0.470588,0.614583,1480,0,0
8577334,"Buttisholz, Fürti",,0.000048,92,1,2,3,1850,1850,3700,3,0.571429,0.708333,12,0,0
8588511,"Sursee, Spital Fussweg",,0.000052,92,2,1,3,1800,1800,3600,3,0.5,0.611111,0,0,0
8577331,"Nottwil, Rüteli",,0.000032,92,1,1,2,1850,1850,3700,6,0.28,0.385714,558,0,0
8577332,"Nottwil, Büel",,0.000038,92,1,1,2,1850,1850,3700,5,0.333333,0.436111,378,0,0
8577333,"Buttisholz, Gattwil",,0.000043,92,1,1,2,1850,1850,3700,4,0.416667,0.516667,196,0,0
8577335,"Ruswil, Freieck",,0.000042,92,2,1,3,2475,2475,4950,8,0.204545,0.315873,1584,0,0
8577336,"Ruswil, Althus",,0.000047,92,1,1,2,2475,2475,4950,7,0.228571,0.341964,1416,0,0
8577337,"Wolhusen, Hohrüti/Höchweid",,0.000051,92,1,1,2,2475,2475,4950,6,0.259259,0.37381,1246,0,0
8577339,"Wald ZH, Dieterswil",,0.000033,67,1,1,2,551,551,1102,22,0.077844,0.125647,218,0,0
8577340,"Wald ZH, Ober-Feld",,0.000039,67,1,1,2,551,551,1102,21,0.082251,0.130317,226,0,0
8577341,"Wald ZH, Blattenbach",,0.000044,67,1,1,2,551,551,1102,20,0.087264,0.135671,232,0,0
8577343,"Wald ZH, Tänler",,0.000048,67,1,1,2,551,551,1102,19,0.093023,0.14193,236,0,0
8577344,"Wald ZH, Etzelstrasse",,0.000052,67,1,1,2,551,551,1102,18,0.099715,0.149438,238,0,0
8582230,"Möhlin, Bata Park",,0.000053,2,4,2,6,4904,5169,10073,3,0.545455,0.638889,49.875,0,0
8582233,"Möhlin, Kleemattstrasse",,0.000032,2,1,3,4,4253,4035,8288,1,1,1,3,0,0
8582259,"Möhlin, Bäumlimatt Mitte",,0.000048,2,3,2,5,2160,878,3038,1,1,1,3.833333,0,0
8578508,"Gossau SG, Langfeld",,0.000043,71,2,2,4,16412,16412,32824,17,0.106408,0.130283,315.063002,0,0
8577369,Flüelen Gruonbach,,0.000046,93,2,1,3,25097,25096,50193,26,0.074319,0.099376,73,0,0
8577371,Flüelen Hauptplatz,,0.000065,93,2,1,3,25453,25444,50897,24,0.085271,0.112686,395,0,0
8577372,Flüelen Reider,,0.000066,93,1,1,2,25444,25445,50889,23,0.092161,0.121888,407,0,0
8577373,Altdorf Moosbad,,0.000067,93,1,1,2,25445,25445,50890,22,0.10035,0.133997,417,0,0
8577375,Altdorf Spital,,0.000153,93,7,3,10,37172,37172,74344,20,0.122449,0.181672,1833.366667,0,0
8588569,Bürglen Urnertor,,0.000141,93,2,3,5,26393,25951,52344,4,0.5,0.680556,533,0,0
8588654,Amsteg Schulhaus,,0.000054,93,1,3,4,22368,12268,34636,2,0.8,0.875,14,0,0
8591899,Göschenen Ausserdorf,,0.000056,93,1,2,3,7518,6445,13963,1,1,1,16,0,0
8591900,Flüelen Matte,,0.000133,93,4,1,5,12545,12545,25090,1,1,1,0,0,0
8577377,Altdorf Dätwyler,,0.000082,93,3,3,6,50658,50668,101326,18,0.154426,0.241647,3769.138095,0,0
8577383,Schattdorf Rossgiessen,,0.000077,93,2,3,5,32561,32517,65078,23,0.129568,0.243738,1238.609524,0,0
8577378,Schattdorf Grund,,0.000034,93,1,1,2,26392,26393,52785,17,0.122356,0.155939,1065,0,0
8577382,Schattdorf Rüttigarten,,0.000049,93,1,1,2,5848,6168,12016,24,0.116006,0.188328,245.071429,0,0
8577381,Schattdorf Chastelen,,0.000045,93,2,1,3,6169,5848,12017,25,0.105125,0.159114,199.071429,0,0
8577386,Erstfeld Bahnhof,,0.000044,93,1,2,3,24648,24646,49294,20,0.133501,0.247741,721,0,0
8577396,Wassen Post,,0.000089,93,4,2,6,7612,7771,15383,14,0.179389,0.276704,3372.188095,0,0
8581319,"Spiringen, Rütti",,0.000067,93,3,2,5,1913,1759,3672,7,0.280702,0.353199,1637.8,0,0
8583353,"Unterschächen, Lehnacher",,0.000044,93,1,2,3,851,851,1702,7,0.280374,0.357302,308,0,0
8583355,"Unterschächen, Ritzen",,0.000036,93,1,1,2,456,456,912,7,0.269231,0.329252,28,0,0
8587291,Seedorf Reussbrücke,,0.000111,93,1,3,4,18570,18571,37141,7,0.333333,0.427126,551.538095,0,0
8577384,Erstfeld Lindenried,,0.000033,93,1,1,2,24603,24648,49251,22,0.108696,0.167917,837,0,0
8577385,Erstfeld  Unterdorf,,0.000039,93,1,1,2,24648,24648,49296,21,0.119734,0.195838,780,0,0
8577387,Silenen Schützen,,0.000029,93,1,1,2,22366,22368,44734,19,0.107438,0.147226,576,0,0
8577388,Silenen Ellbogenkapelle,,0.000036,93,1,1,2,22368,22368,44736,18,0.118056,0.161702,513,0,0
8577389,Silenen Efibach,,0.000041,93,1,1,2,22368,22368,44736,17,0.131234,0.181985,448,0,0
8577390,Silenen Gemeindehaus,,0.000046,93,1,1,2,22368,21856,44224,16,0.148036,0.213179,381,0,0
8587775,Altdorf Chornmatt,,0.000061,93,2,3,5,17131,17131,34262,4,0.5,0.654762,333.383333,0,0
8588124,Seedorf Wyden,,0.000028,93,1,2,3,9056,9056,18112,4,0.461538,0.597222,0,0,0
8588567,Altdorf Langmatt,,0.000059,93,3,2,5,23465,23313,46778,4,0.454545,0.616667,241.266667,0,0
8577399,"Goldau, Löwenplatz",,0.000018,91,1,1,2,33729,42624,76353,34,0.082287,0.123992,0,0,0
8577400,"Goldau, Tierpark",,0.000033,91,2,4,6,43600,38791,82391,33,0.089193,0.150879,1009.059524,0,0
8577402,"Oberarth, Rischi",,0.000033,91,2,3,5,39962,35196,75158,33,0.088374,0.144471,451,0,0
8577403,"Oberarth, Bifang",,0.00002,91,1,1,2,32306,35255,67561,33,0.086552,0.128291,0,0,0
8577401,"Goldau, Bischofshusen",,0.000018,91,1,1,2,30161,35255,65416,34,0.081597,0.120879,0,0,0
8577404,"Oberarth, Dorf",,0.000052,91,4,3,7,41394,35165,76559,32,0.094244,0.154685,9533.092857,0,0
8577453,"Schwyz, Stoosbahn",,0.000053,91,5,3,8,19059,14533,33592,17,0.146341,0.242914,7648.419048,0,0
8588293,"Muotathal, Lustnau",,0.000079,91,1,2,3,14804,15570,30374,12,0.194286,0.278888,685.5,0,0
8577421,"Schwyz, Lützelmatt",,0.00006,91,9,1,10,33476,35423,68899,32,0.091972,0.133243,12692.783333,0,0
8577422,"Schwyz, Nietenbach",,0.000062,91,1,1,2,35423,35423,70846,31,0.100727,0.157502,12601.783333,0,0
8577425,"Lauerz, Otten",,0.000036,91,2,1,3,13525,13523,27048,25,0.096552,0.131301,1036.933333,0,0
8577426,"Lauerz, Schwanau",,0.000042,91,1,1,2,13523,13522,27045,24,0.10578,0.148134,858.933333,0,0
8577427,"Lauerz, Seegütli",,0.000046,91,1,1,2,13522,13532,27054,23,0.117073,0.173748,678.933333,0,0
8587959,"Steinen, Dorfbrücke",,0.000034,91,2,1,3,13720,13641,27361,14,0.151408,0.200093,1840.466667,0,0
8577430,"Ibach, Mythen Center",,0.000059,91,7,2,9,61980,57915,119895,29,0.087022,0.145115,5975.416667,0,0
8592409,"Schwyz, Drei Könige",,0.000161,91,7,4,11,31012,21483,52495,5,0.4,0.522917,4123.166667,0,0
8592413,"Schwyz, Kollegi",,0.000045,91,1,2,3,3672,2290,5962,3,0.545455,0.638889,1131,0,0
8594730,"Schwyz, Spital Haupteingang",,0.000055,91,2,1,3,9124,4523,13647,2,0.6,0.666667,78.5,0,0
8577433,"Ibach, Diesel",,0.000022,91,2,1,3,34014,34387,68401,27,0.071477,0.095589,1357,0,0
8577434,"Ingenbohl, Fuchsenen",,0.00003,91,1,1,2,34387,34387,68774,26,0.076253,0.102343,1184,0,0
8577436,"Brunnen, Kantonalbank",,0.000059,91,4,2,6,45632,48665,94297,24,0.088185,0.126505,9893,0,0
8577438,"Brunnen, Hafenstrasse",,0.000036,91,1,1,2,32839,32839,65678,23,0.09254,0.120068,8586,0,0
8577439,"Brunnen, Heideweg",,0.000041,91,1,1,2,32839,32839,65678,22,0.100937,0.132861,8401,0,0
8577440,"Brunnen, Sportplatzweg",,0.000046,91,1,2,3,32839,32839,65678,21,0.111111,0.152961,8214,0,0
8577441,"Brunnen, Hopfräben",,0.00003,91,1,1,2,15977,15977,31954,21,0.110081,0.144044,0,0,0
8577442,"Brunnen, Seilbahn Urmiberg",,0.000056,91,2,1,3,32839,32946,65785,20,0.122396,0.16592,7834,0,0
8577444,"Brunnen, Fallenbach",,0.000028,91,1,1,2,28011,28018,56029,20,0.137519,0.190407,895,0,0
8577448,"Schwyz, Obstmühle/Friedhof",,0.000038,91,4,2,6,21300,20590,41890,21,0.104039,0.150898,2377,0,0
8577449,"Schwyz, Spital",,0.000027,91,1,1,2,14805,14805,29610,20,0.100313,0.136679,1228,0,0
8577450,"Schwyz, Grundkapelle",,0.000034,91,1,1,2,14805,15570,30375,19,0.109756,0.150772,1008,0,0
8577451,"Schwyz, Schützenhaus",,0.00004,91,1,1,2,15570,15570,31140,18,0.121331,0.171237,786,0,0
8587533,"Muotathal, hintere Brücke",,0.000093,91,2,3,5,17336,17337,34673,15,0.148026,0.235803,2698.333333,0,0
8577454,"Ried (Muotathal), Grünenwald",,0.000045,91,2,1,3,12378,15570,27948,26,0.065483,0.100099,5996,0,0
8577455,"Ried (Muotathal), Selgis",,0.000049,91,1,1,2,15570,15570,31140,25,0.068884,0.103609,5766,0,0
8577456,"Ried (Muotathal), Hesigen",,0.000052,91,1,1,2,15570,15570,31140,24,0.072704,0.107604,5534,0,0
8577457,"Ried (Muotathal), Mühlestuden",,0.000056,91,1,1,2,15570,15570,31140,23,0.077029,0.112215,5300,0,0
8577458,"Ried (Muotathal), Kappelmatt",,0.000058,91,1,1,2,15570,15570,31140,22,0.081967,0.117627,5064,0,0
8577459,"Ried (Muotathal), Vord. Brücke",,0.00006,91,1,1,2,15570,15570,31140,21,0.087662,0.124116,4826,0,0
8577460,"Muotathal, Föllmisbrücke",,0.000062,91,1,1,2,15570,15570,31140,20,0.094306,0.132111,4586,0,0
8577461,"Muotathal, Nuschlau",,0.000064,91,1,1,2,15570,15570,31140,19,0.102161,0.142337,4344,0,0
8577463,"Muotathal, Sternen",,0.000087,91,3,1,4,17331,17337,34668,17,0.123153,0.176688,3963.333333,0,0
8577464,"Muotathal, Säge",,0.000085,91,1,2,3,17337,17337,34674,16,0.13764,0.214321,3714.333333,0,0
8577470,"Bisisthal, Zentrale EBS",,0.000054,91,1,1,2,1767,1766,3533,16,0.131429,0.188444,92,0,0
8577466,"Muotathal, Balm",,0.000047,91,1,1,2,1767,1767,3534,18,0.107865,0.149603,600,0,0
8577467,"Bisisthal, Herrgott",,0.000051,91,1,1,2,1767,1767,3534,17,0.118388,0.164916,347,0,0
8577471,"Schwyz, Herrengasse",,0.000051,91,4,1,5,28600,29787,58387,18,0.123711,0.166056,7955,0,0
8577472,"Schwyz, Nietenbachstrasse",,0.000054,91,1,2,3,29787,26003,55790,17,0.139216,0.198639,7713,0,0
8577473,"Schwyz, Verkehrsamt",,0.000034,91,1,1,2,16200,15854,32054,16,0.107527,0.185166,5868,0,0
8577474,"Schwyz, Kaltbach",,0.00004,91,1,1,2,15854,16269,32123,15,0.114458,0.193126,5572,0,0
8577475,"Schwyz, Mettli",,0.000045,91,1,1,2,16269,16269,32538,14,0.122449,0.202051,5274,0,0
8577476,"Schwyz, Burg",,0.000049,91,1,1,2,16269,16269,32538,13,0.131783,0.212186,4974,0,0
8577477,"Schwyz, Hirschen",,0.000052,91,1,1,2,16269,16269,32538,12,0.142857,0.223886,4672,0,0
8577478,"Steinen, Spiegelberg Schlag",,0.000055,91,1,1,2,16269,16269,32538,11,0.15625,0.237701,4368,0,0
8577479,"Steinen, Spiegelberg",,0.000058,91,1,1,2,16269,16269,32538,10,0.17284,0.254535,4062,0,0
8577480,"Steinen, Adelboden",,0.00006,91,1,1,2,16269,16058,32327,9,0.19403,0.276038,3754,0,0
8577481,"Steinen, Rigiblick",,0.000062,91,1,1,2,16058,16269,32327,8,0.222222,0.305655,3444,0,0
8577482,"Sattel, Erli",,0.000064,91,1,1,2,16269,16269,32538,7,0.261905,0.352381,3132,0,0
8577486,"Schwyz, Laubstrasse",,0.000033,91,4,1,5,17171,16819,33990,16,0.134545,0.18692,5283,0,0
8577487,"Rickenbach SZ, Dorf",,0.000039,91,1,1,2,16819,17399,34218,15,0.151261,0.215101,5041,0,0
8577488,"Rickenbach SZ, Stalden",,0.000044,91,1,3,4,17399,17399,34798,14,0.173267,0.272732,4797,0,0
8577499,"Ibergeregg, Passhöhe",,0.000063,91,1,3,4,934,845,1779,8,0.23301,0.338641,1083,0,0
8577502,"Oberiberg, Laburg",,0.000041,91,1,2,3,746,746,1492,8,0.216495,0.299717,42,0,0
8587768,"Schwyz, Achermann",,0.000059,91,3,1,4,8713,8422,17135,8,0.208333,0.264702,0,0,0
8577489,"Rickenbach SZ, Aufiberg/Gruobi",,0.000023,91,1,1,2,934,934,1868,18,0.085427,0.13655,3653,0,0
8577490,"Rickenbach SZ, Windstock",,0.000031,91,1,1,2,934,934,1868,17,0.090659,0.14175,3405,0,0
8577491,"Rickenbach SZ, Chaisten",,0.000037,91,1,1,2,934,934,1868,16,0.096677,0.147672,3155,0,0
8577492,"Rickenbach SZ, Meinradsrank",,0.000042,91,1,1,2,934,934,1868,15,0.103679,0.154525,2903,0,0
8577493,"Rickenbach SZ, Lauenen",,0.000047,91,1,1,2,934,934,1868,14,0.11194,0.16262,2649,0,0
8577494,"Rickenbach SZ, Handgruobi",,0.000051,91,1,1,2,934,934,1868,13,0.121849,0.172432,2393,0,0
8577495,"Rickenbach SZ, Gründel/St Karl",,0.000054,91,1,1,2,934,934,1868,12,0.133971,0.184739,2135,0,0
8577496,"Rickenbach SZ, Oberberg",,0.000057,91,1,1,2,934,934,1868,11,0.149171,0.200927,1875,0,0
8577497,"Ibergeregg, Eseltritt",,0.000059,91,1,1,2,934,934,1868,10,0.168831,0.223794,1613,0,0
8577498,"Ibergeregg, Riedmatt",,0.000061,91,1,1,2,934,934,1868,9,0.195312,0.260349,1349,0,0
8577500,"Ibergeregg, Alpstubli",,0.000029,91,1,1,2,657,746,1403,10,0.161972,0.218927,584,0,0
8577501,"Oberiberg, Wandli",,0.000035,91,1,1,2,746,746,1492,9,0.184874,0.246609,314,0,0
8589206,"Zofingen, Schwimmbad",,0.000066,94,1,1,2,8190,5856,14046,1,1,1,1,0,0
8577505,"Morschach, Swiss Holiday Park",,0.000036,91,1,1,2,15826,16019,31845,3,0.5,0.611111,846,0,0
8577506,"Morschach, Schwyzerhöhe",,0.000041,91,1,1,2,16019,16019,32038,2,0.666667,0.75,566,0,0
8577507,"Morschach, Luftseilbahn",,0.000046,91,1,1,2,16019,16019,32038,1,1,1,284,0,0
8578358,"Kaiseraugst, Hoffmann-La Roche",,0.00003,2,2,2,4,11577,11577,23154,8,0.24,0.347817,1480,0,0
8577509,"Richterswil, Säumerstrasse",,0.000012,113,1,1,2,16654,16654,33308,24,0.075342,0.119451,6,0,0
8577510,"Wollerau, Höfli",,0.000021,113,1,1,2,16654,16654,33308,23,0.07963,0.124158,48,0,0
8577511,"Wollerau, Hermannsweid",,0.000029,113,1,1,2,16654,16654,33308,22,0.084507,0.129621,88,0,0
8577512,"Wollerau, Schwalbenboden",,0.000036,113,1,1,2,16654,16654,33308,21,0.09011,0.136092,126,0,0
8577513,"Wollerau, Studenbühl",,0.000041,113,1,1,2,16654,16654,33308,20,0.096618,0.143959,162,0,0
8577514,"Wollerau, Schollenmatt",,0.000046,113,1,1,2,16654,16654,33308,19,0.104278,0.153854,196,0,0
8577518,"Wollerau, Fürti",,0.000124,113,2,1,3,26462,26462,52924,16,0.138462,0.214918,1093,0,0
8581279,"Wollerau, Bahnhof",,0.00006,113,1,1,2,13217,9573,22790,5,0.315789,0.422222,72,0,0
8577520,"Etoy, L'Espérance",,0.000041,5,2,1,3,5505,5505,11010,19,0.080586,0.101421,405,0,0
8577521,"Wollerau, Hafen",,0.000045,113,2,1,3,18175,18175,36350,19,0.099707,0.152868,240,0,0
8577522,"Wollerau, Wyssenfluh",,0.00005,113,1,1,2,18175,18175,36350,18,0.107492,0.162862,213,0,0
8577523,"Wollerau, Weingarten/Bellevue",,0.000053,113,1,1,2,18175,18175,36350,17,0.116788,0.176024,184,0,0
8577524,"Wollerau, Obermühle",,0.000056,113,1,1,2,18175,18175,36350,16,0.128099,0.194744,153,0,0
8577528,"Schwändi b. Schwanden GL, Adler",,0.000039,128,1,1,2,5419,5419,10838,7,0.255814,0.349351,11,0,0
8588281,"Elm, Obmoos",,0.000033,128,1,1,2,7022,6790,13812,2,0.666667,0.75,0,0,0
8577527,"Schwanden GL, Buchen",,0.000033,128,1,1,2,5419,5419,10838,8,0.218182,0.303671,119,0,0
8577555,"Etoy, Romanèche",,0.000046,5,1,1,2,5505,5505,11010,18,0.086653,0.107319,471,0,0
8577557,"Etoy, village",,0.00005,5,1,1,2,5505,5505,11010,17,0.093784,0.114368,535,0,0
8577558,"Etoy, Bas du Rossé",,0.000053,5,1,1,2,5505,5505,11010,16,0.102286,0.122954,597,0,0
8577562,"Etoy, En Folliar",,0.000056,5,1,1,2,5505,5505,11010,15,0.112601,0.133668,657,0,0
8577590,"Etoy, En Bellevue",,0.000059,5,1,1,2,5505,5504,11009,14,0.125378,0.147456,715,0,0
8577591,"Buchillon, Grands-Bois",,0.000061,5,1,1,2,5504,5505,11009,13,0.141623,0.165962,771,0,0
8577592,"Buchillon, collège",,0.000062,5,1,1,2,5505,5505,11010,12,0.162978,0.192378,825,0,0
8589250,"Tolochenaz,cimetière de Morges",,0.000026,5,1,1,2,6167,6167,12334,8,0.222222,0.339732,168,0,0
8589262,"St-Prex, Taillecou",,0.000059,5,1,1,2,6259,6260,12519,3,0.5,0.611111,63,0,0
8577605,"Sattel, Krone",,0.000083,91,3,2,5,14344,9481,23825,5,0.380952,0.514583,2616,0,0
8587534,"Rothenthurm, Biberegg",,0.000046,91,1,1,2,3720,4737,8457,5,0.35,0.445238,0,0,0
8577608,"Font, village",,0.000011,13,0,1,1,0,4735,4735,19,0.124191,0.165487,0,0,0
8577623,"Estavayer-le-Lac, CO",,0.000052,13,3,5,8,14850,12801,27651,11,0.244444,0.440297,5330.828571,0,0
8577613,"Treytorrens (Payerne), Nord",,0.00003,13,1,1,2,4214,4214,8428,14,0.15528,0.222158,636,0,0
8577614,"Treytorrens (Payerne), village",,0.000036,13,1,1,2,4214,4214,8428,13,0.176471,0.256811,342,0,0
8588820,"Vesin, cordonnerie",,0.000072,13,2,1,3,5501,4719,10220,1,1,1,0.5,0,0
8577626,"Bussy FR, croisée",,0.000028,13,1,1,2,4909,4909,9818,4,0.4,0.520833,4,0,0
8577625,"Sévaz, village",,0.00002,13,1,1,2,3408,4909,8317,5,0.333333,0.456667,322,0,0
8577628,Morens FR,,0.000043,13,2,1,3,6410,3408,9818,3,0.5,0.611111,605.828571,0,0
8577629,"Rueyres-les-Prés, La Chavane",,0.000048,13,1,1,2,3408,3556,6964,2,0.666667,0.75,283.828571,0,0
8577834,"Gletterens, village",,0.000089,126,2,5,7,11936,11584,23520,10,0.202422,0.253059,818.495044,0,0
8583428,"Payerne, aérodrome",,0.00006,13,2,2,4,3142,3142,6284,2,0.666667,0.75,690,0,0
8583724,"Grandcour, rte d'Estavayer",,0.000042,13,1,1,2,3066,3066,6132,2,0.666667,0.75,2,0,0
8588723,"Domdidier, CO",,0.000089,126,5,4,9,11302,11279,22581,4,0.538462,0.72619,5632.806851,0,0
8577630,"Niederteufen, alte Post",,0.00004,71,1,1,2,71,71,142,1,1,1,327,0,0
8577632,"Estavayer-le-Lac, La Corbière",,0.00002,13,1,1,2,6195,6195,12390,10,0.166667,0.263757,3128,0,0
8577633,"Montbrelloz, bif.",,0.000028,13,1,1,2,6195,4461,10656,9,0.183333,0.28153,2817,0,0
8577634,"Montbrelloz, village",,0.000034,13,1,1,2,4461,6195,10656,8,0.204082,0.302738,2504,0,0
8577635,"Forel FR, Forestel",,0.00004,13,1,1,2,6195,6195,12390,7,0.230769,0.328836,2189,0,0
8577636,"Forel FR, La Vernase",,0.000045,13,1,1,2,6195,6195,12390,6,0.266667,0.3625,1872,0,0
8577637,"Forel FR, village",,0.000049,13,1,1,2,6195,6195,12390,5,0.318182,0.409524,1553,0,0
8577645,"Cheseaux-sur-L., Martheray",,0.000035,10,1,1,2,8368,8368,16736,18,0.11307,0.133621,1830.5,0,0
8577647,"Brenles, La Gaîté",,0.000045,13,1,1,2,2408,1116,3524,10,0.174419,0.250899,1362,0,0
8577648,"Chavannes-sur-Moudon, Burinaux",,0.000049,13,1,1,2,1116,2130,3246,9,0.197183,0.274178,922,0,0
8577649,"Chavannes-sur-Moudon, La Puçaz",,0.000053,13,1,1,2,2130,2263,4393,8,0.22807,0.307784,480,0,0
8577656,"Ursy, Au Clos",,0.000033,13,2,1,3,10739,11021,21760,12,0.148148,0.228053,2535,0,0
8577657,"Rue, Chez Cottet",,0.000039,13,1,1,2,11021,11021,22042,11,0.163043,0.243627,2043,0,0
8577658,"Rue, La Grotte",,0.000044,13,1,1,2,11021,11021,22042,10,0.181818,0.263464,1549,0,0
8577659,"Rue, Montet bif.",,0.000048,13,1,1,2,11021,11021,22042,9,0.206349,0.29069,1053,0,0
8577660,"Rue, L'Abergement",,0.000052,13,1,1,2,11021,11020,22041,8,0.24,0.333433,555,0,0
8577669,"Mézières FR, Parqueterie",,0.000024,13,1,1,2,13604,13608,27212,19,0.115062,0.134733,49442.945437,0,0
8594993,"Sâles, laiterie",,0.000088,13,2,1,3,12091,7862,19953,4,0.416667,0.516667,15,0,0
8596064,"Vuisternens-dt-Romont, école",,0.000046,13,1,2,3,4757,5335,10092,3,0.555556,0.666667,1355.661905,0,0
8588865,"Bouloz, Chavannaz",,0.000032,13,1,1,2,923,923,1846,8,0.22619,0.301441,377.25,0,0
8593284,"Bulle, Saucens",,0.000056,13,2,2,4,27490,26700,54190,8,0.240964,0.348869,1087.066667,0,0
8593289,"Morlon, Eglise",,0.000061,13,2,2,4,26701,27600,54301,8,0.234568,0.340915,514.466667,0,0
8577676,"Porsel, Les Bois",,0.000063,13,3,1,4,5664,5670,11334,21,0.09709,0.107969,3384.071429,0,0
8577677,"Pont (Veveyse), Perey-Martin",,0.000064,13,1,1,2,5670,5670,11340,20,0.107266,0.120797,3278.071429,0,0
8596069,"Sommentier, En Chesaux",,0.00008,13,1,2,3,4134,3414,7548,1,1,1,695,0,0
8577688,"Romont FR, La Halle",,0.000077,13,3,1,4,8543,8543,17086,10,0.176471,0.252003,3144.57381,0,0
8577689,"Villaraboud, Beauregard",,0.000076,13,1,3,4,8543,6213,14756,9,0.204082,0.321925,2647.57381,0,0
8595957,"Ursy, Derrière la Grange",,0.000173,13,3,1,4,15262,15258,30520,2,0.666667,0.75,289.42619,0,0
8596060,"Romont FR, Les Echervettes",,0.000179,13,2,1,3,19839,4581,24420,1,1,1,120.509524,0,0
8577691,"Chavannes-Les-Forts, La Pierra",,0.000032,13,1,1,2,1466,1898,3364,10,0.195876,0.257665,1218,0,0
8577693,"Prez-vers-Siviriez, Les Combes",,0.000038,13,1,1,2,1898,1898,3796,9,0.230769,0.297906,717,0,0
8577697,"Vauderens, Route d'Ursy",,0.000086,13,3,1,4,13078,12036,25114,5,0.346154,0.42963,1427.462771,0,0
8587962,"Promasens, Les Planches",,0.000058,13,2,1,3,10983,9328,20311,3,0.5,0.611111,18,0,0
8592166,"Moudon, Verger",,0.000104,13,1,1,2,7530,5267,12797,3,0.5,0.611111,510.283333,0,0
8577700,"Montet (Glâne), Les Jordils",,0.000048,13,2,1,3,4267,5267,9534,6,0.285714,0.408333,956.767965,0,0
8577701,"Montet (Glâne), village",,0.000052,13,1,1,2,5267,5267,10534,5,0.333333,0.456667,444.767965,0,0
8591865,"Curtilles, village",,0.000129,13,2,2,4,6405,6261,12666,5,0.380952,0.514583,2133.015368,0,0
8577706,"Chavannes-sous-Ors, La Fortune",,0.000051,13,2,1,3,6679,6739,13418,23,0.087516,0.113313,4380.442063,0,0
8577707,"Orsonnens, Gottaz",,0.000054,13,1,2,3,6739,6739,13478,22,0.095205,0.129045,3985.442063,0,0
8577709,"Villarlod, La Forge",,0.000034,13,1,1,2,6573,6573,13146,21,0.088158,0.108749,1755,0,0
8577710,"Villarlod, Café",,0.00004,13,1,1,2,6573,6573,13146,20,0.09596,0.119717,1356,0,0
8577711,"Rueyres-St-Laurent, bif.",,0.000045,13,1,1,2,6573,6573,13146,19,0.105347,0.13522,955,0,0
8577713,"Granges (Veveyse), Le Rupan",,0.00002,13,1,1,2,8777,8777,17554,3,0.5,0.611111,603,0,0
8577714,"Granges (Veveyse), La Cuvigne",,0.000028,13,1,1,2,8777,8777,17554,2,0.666667,0.75,404,0,0
8577715,"Granges (Veveyse), village",,0.000034,13,1,1,2,8777,8749,17526,1,1,1,203,0,0
8577718,"Châtel-St-Denis, gare",,0.000092,12,1,4,5,15417,15454,30871,5,0.433333,0.573077,208,0,0
8579181,"Jongny, Combette",,0.000037,12,1,1,2,7623,7623,15246,5,0.333333,0.456667,5,0,0
8577721,"Les Paccots, village",,0.000042,12,1,1,2,5647,5637,11284,3,0.5,0.611111,6,0,0
8577719,"Châtel-St-Denis, Les Creuses",,0.00003,12,1,1,2,5689,5633,11322,5,0.333333,0.456667,34,0,0
8577720,"Châtel-St-Denis, Les Moilles",,0.000037,12,1,1,2,5633,5647,11280,4,0.4,0.520833,21,0,0
8577728,"Broc, Le Home",,0.000062,13,1,3,4,14126,14126,28252,13,0.142572,0.194219,885.824242,0,0
8577730,"Bulle, jardin Anglais",,0.000059,13,3,1,4,29155,29605,58760,14,0.130233,0.169118,215.5,0,0
8577745,"Essert FR, bif.",,0.000017,126,1,1,2,12682,12514,25196,18,0.091939,0.110092,1656,0,0
8577776,"Vuisternens-en-Ogoz, Bouleyres",,0.000045,13,3,1,4,12711,12744,25455,16,0.110635,0.136376,241,0,0
8577777,"Sorens, Malessert laiterie",,0.00002,13,1,1,2,6176,6179,12355,16,0.110635,0.136376,0,0,0
8577727,"Broc-Village, gare",,0.00006,13,3,1,4,14161,14126,28287,14,0.125545,0.157875,1330.824242,0,0
8577748,"Hauteville, Les Fourches",,0.000062,13,1,2,3,13035,13035,26070,15,0.123853,0.159069,2563.175758,0,0
8577735,"Grandvillard, Lormo",,0.000033,13,1,2,3,4251,4251,8502,12,0.170139,0.233027,339.954545,0,0
8577733,"Estavannens, Dessus",,0.000026,13,1,1,2,4241,4251,8492,13,0.147929,0.1922,882.954545,0,0
8577734,"Näfels, Letz",,0.000076,106,3,1,4,10050,9846,19896,13,0.123348,0.174024,398.5,0,0
8593280,"Bulle, Place de la Gare",,0.0002,13,8,5,13,83535,75199,158734,10,0.230366,0.349044,14135.42215,0,0
8577739,"Morlon, école",,0.000049,13,2,1,3,26701,27601,54302,13,0.146707,0.19102,372,0,0
8587356,"Fribourg, Pont-Zaehringen",,0.000047,126,1,6,7,104036,104036,208072,8,0.247396,0.316905,14327.001449,0,0
8588343,"Matran, Ch. des Glycines",,0.000032,126,1,1,2,17825,17825,35650,8,0.187082,0.216256,332,0,0
8587255,"Fribourg, Tilleul/Cathédrale",,0.00021,126,8,5,13,175832,182736,358568,8,0.254408,0.316466,31630.774648,0,0
8588344,"Villars-sur-Glâne, Belle-Croix",,0.000105,126,5,3,8,83127,83099,166226,7,0.227397,0.278313,25716.457627,0,0
8588351,"Fribourg, Gambach",,0.000081,126,3,5,8,67405,67425,134830,7,0.261146,0.331852,18912.435166,0,0
8588352,"Fribourg/Freiburg, gare/Tivoli",,0.000031,126,2,8,10,34878,34892,69770,7,0.270903,0.358789,8727.30905,0,0
8588857,"Givisiez, Colombière",,0.000014,126,1,1,2,8957,8954,17911,8,0.208459,0.24215,0,0,0
8577803,"Givisiez, Bellevue",,0.000019,126,1,1,2,9211,9208,18419,16,0.111837,0.126428,0,0,0
8577805,"Givisiez, Toutvent",,0.00004,126,1,1,2,18162,18162,36324,14,0.141807,0.160241,270,0,0
8577868,"St. Ursen, alte Post",,0.000066,126,3,2,5,16147,14822,30969,9,0.207921,0.246274,2280.741342,0,0
8577871,"Brünisried, beim Kreuz",,0.000048,126,1,1,2,10548,10548,21096,9,0.204409,0.235543,204,0,0
8587103,"Fribourg, Vieux-Chênes",,0.000168,126,10,2,12,49889,54452,104341,8,0.253623,0.294841,21525.919732,0,0
8577744,"Ferpicloz, bif. Praroman",,0.000014,126,1,2,3,18885,18885,37770,19,0.08627,0.112341,3958,0,0
8577747,"La Roche FR, Le Stoutz",,0.00006,13,3,1,4,13235,13035,26270,16,0.11093,0.135884,3041.175758,0,0
8577779,"Riaz, Hôpital",,0.000038,13,2,1,3,28659,28515,57174,14,0.134744,0.169951,194.333333,0,0
8587237,"Bulle, Montcalia",,0.000129,13,6,1,7,32954,36081,69035,14,0.134744,0.169951,8484.004401,0,0
8577750,Pont-la-Ville,,0.000015,126,1,1,2,3855,3855,7710,2,0.666667,0.75,48,0,0
8577752,"Châtel-sur-Montsalv.,Chésalles",,0.000056,13,2,1,3,9955,9919,19874,18,0.090032,0.124384,6119,0,0
8577754,"Charmey (Gruyère), Corbettaz",,0.000081,13,2,1,3,11368,11367,22735,16,0.105675,0.14575,5261,0,0
8577756,"Charmey (Gruyère), La Tzintre",,0.000045,13,1,1,2,9955,9955,19910,14,0.124069,0.158182,2888,0,0
8577757,"Charmey (Gruyère),La Fulateyre",,0.000049,13,1,1,2,9955,9955,19910,13,0.13881,0.175569,2307,0,0
8577758,"Im Fang, Praz-Jean",,0.000052,13,1,1,2,9955,9955,19910,12,0.157895,0.20101,1724,0,0
8577759,"Im Fang, La Bochenaz",,0.000055,13,1,2,3,9955,9955,19910,11,0.183594,0.245357,1139,0,0
8588535,"Riaz, Champy",,0.000168,13,3,5,8,67892,59115,127007,13,0.15444,0.216129,10376.837734,0,0
8577760,"Jaun, Weidli",,0.000031,13,1,1,2,2345,2346,4691,12,0.156627,0.254093,1935,0,0
8577761,"Boltigen, Rohrmoos",,0.000037,13,1,1,2,2346,2346,4692,11,0.171429,0.27249,1792,0,0
8577762,"Boltigen, Schüpfen",,0.000042,13,1,1,2,2346,2346,4692,10,0.189655,0.296573,1647,0,0
8577764,"Boltigen, Bahnhof",,0.000078,13,2,2,4,4298,4298,8596,8,0.243243,0.413095,1431,0,0
8577765,"Ependes FR, Invuet",,0.000014,126,1,1,2,10334,10334,20668,6,0.269231,0.378571,3844,0,0
8577766,"Arconciel, Pelleret",,0.000023,126,1,1,2,10334,10334,20668,5,0.315789,0.422222,3240,0,0
8577767,"Arconciel, Sur-le-Moulin",,0.00003,126,1,1,2,10334,10334,20668,4,0.384615,0.483333,2634,0,0
8577768,"Treyvaux, Les Vernes",,0.000037,126,1,1,2,10334,10334,20668,3,0.5,0.583333,2026,0,0
8577770,"Treyvaux, Les Chaucisses",,0.000042,126,2,2,4,1543,1543,3086,1,1,1,520.5,0,0
8587793,"Ependes FR, La Pala",,0.000047,126,2,1,3,10334,1296,11630,1,1,1,236.5,0,0
8582245,"Lussy FR, Les Epenettes",,0.00008,13,1,2,3,6623,6623,13246,11,0.148148,0.183438,1089.616667,0,0
8577780,"Rossens FR, Illens",,0.000055,13,2,1,3,16013,16036,32049,16,0.124632,0.156399,895.5,0,0
8588347,"Avry-sur-Matran, Fontanettes",,0.000049,126,1,3,4,17825,17825,35650,9,0.207602,0.270244,7201.136219,0,0
8577820,"Fribourg, Vuille",,0.000099,126,7,4,11,82125,87612,169737,11,0.234657,0.29218,18889.296688,0,0
8577796,"Lentigny, La Chapelle",,0.000065,126,4,4,8,7767,7324,15091,14,0.142661,0.199399,4033.920241,0,0
8577802,"Nierlet-les-Bois, centre",,0.000043,126,1,2,3,2455,2455,4910,11,0.164706,0.203167,464.388889,0,0
8577794,"Lovens, Le Réservoir",,0.00005,126,4,1,5,1963,2216,4179,16,0.112886,0.141236,623.333333,0,0
8588826,"Ponthaux, Marterex",,0.000043,126,2,3,5,2480,2455,4935,10,0.170667,0.227443,5319.691775,0,0
8588828,"Noréaz, Pra-Moux",,0.00005,126,2,3,5,5193,5181,10374,10,0.17027,0.228408,336.507937,0,0
8577798,"Avry-sur-Matran, La Sonnaz",,0.000042,126,1,1,2,5079,5079,10158,14,0.113459,0.136122,1190.502525,0,0
8588832,"Lovens, Quemounaille",,0.000074,126,4,1,5,1870,1470,3340,10,0.164021,0.195533,62.333333,0,0
8577797,"Avry-sur-Matran, Courtaney",,0.000037,126,3,1,4,5060,5079,10139,15,0.102794,0.123233,1633.502525,0,0
8577799,"Noréaz, Laiterie",,0.00006,126,2,1,3,5304,5418,10722,13,0.126725,0.154085,2632.871717,0,0
8577800,"Ponthaux, Les Chalosys",,0.000062,126,1,2,3,5418,5418,10836,12,0.143678,0.183164,2185.871717,0,0
8577801,"Ponthaux, Les Ecovettes",,0.000037,126,1,1,2,2455,2455,4910,12,0.142651,0.16878,915.388889,0,0
8577804,"Givisiez, Place d'Affry",,0.000035,126,2,1,3,18165,18162,36327,15,0.125,0.140872,745,0,0
8577808,"Chésopelloz, Le Haut",,0.000054,126,2,1,3,4309,4309,8618,11,0.144144,0.180308,662.458333,0,0
8577809,"Niederurnen, Friedhof",,0.000076,106,1,1,2,9846,9359,19205,12,0.135678,0.18582,401.5,0,0
8577811,"Fribourg, Université",,0.000029,126,1,1,2,88079,88130,176209,13,0.190039,0.221139,8008.390831,0,0
8577821,"Givisiez, Escale",,0.000032,126,1,3,4,32861,32861,65722,10,0.231752,0.278493,12466.833333,0,0
8583723,"Avenches, Le Paon",,0.000108,126,4,3,7,13137,13414,26551,8,0.248826,0.297428,5157.499522,0,0
8587227,"Courtepin, gare",,0.000099,126,3,2,5,12855,9169,22024,8,0.241901,0.280835,114294.601587,0,0
8588340,"Villars-sur-Glâne, Rte Soleil",,0.000036,126,2,1,3,17800,17825,35625,10,0.170775,0.199448,7013.378847,0,0
8588341,"Villars-sur-Glâne, gare",,0.000049,126,2,3,5,61038,56235,117273,9,0.203822,0.25234,6990.370764,0,0
8588825,"Posieux, Vany",,0.000139,126,2,1,3,22104,22104,44208,9,0.198347,0.234298,3033.158009,0,0
8577813,"Granges-Paccot, Rte du Coteau",,0.000055,126,2,1,3,21280,16382,37662,16,0.115582,0.132533,3569.612121,0,0
8577815,"Granges-Paccot, Chavully",,0.000069,126,2,2,4,21428,16382,37810,14,0.147942,0.175808,3073.820455,0,0
8592374,"Fribourg/Freiburg, Pl. Gare",,0.000449,126,13,5,18,292033,155251,447284,3,0.55,0.681818,17989.585862,0,0
8594496,"Grolley, Rosière",,0.000048,126,3,1,4,13686,13686,27372,3,0.444444,0.541667,96.995455,0,0
8577818,"Granges-Paccot,ch. la Rappetta",,0.00004,126,1,1,2,11336,16382,27718,13,0.169666,0.195361,1053.5,0,0
8587451,"Givisiez, La Gaîté",,0.000033,126,1,1,2,18168,18162,36330,8,0.209068,0.24422,0,0,0
8577822,"Courtion, Oleyres bif.",,0.00002,126,1,1,2,6998,6998,13996,15,0.126,0.142119,4732,0,0
8577823,"Courtion, Moulin-Neuf",,0.000028,126,1,1,2,6998,6998,13996,14,0.143021,0.16147,4197,0,0
8577824,"Villarepos, La Tornalla",,0.000035,126,2,1,3,3717,3717,7434,14,0.143021,0.16147,204.333333,0,0
8577836,"Cournillens, Es Mottes",,0.000041,126,1,2,3,6968,6968,13936,9,0.202109,0.235335,6044,0,0
8577829,"St-Aubin FR, bif.",,0.000056,126,2,2,4,11849,11582,23431,11,0.172805,0.207891,3200.159109,0,0
8577833,"Portalban, Dessus",,0.000063,126,2,1,3,7513,7513,15026,11,0.16954,0.197283,478.335935,0,0
8577830,"St-Aubin FR, Le-Haut",,0.000035,126,1,1,2,7159,7159,14318,14,0.114583,0.130416,1760,0,0
8588605,"Cormérod, Paccoty",,0.000035,126,1,2,3,6968,6968,13936,4,0.470588,0.572917,8,0,0
8594782,"Givisiez, rte du Bleuet",,0.000156,126,1,2,3,49243,39777,89020,1,1,1,2358.378788,0,0
8577835,"Courtion, école",,0.000035,126,2,1,3,6968,6968,13936,10,0.169343,0.190931,6602,0,0
8577896,"Münchenwiler, Dorf",,0.000046,126,2,2,4,5947,5948,11895,9,0.201987,0.232761,119905.934921,0,0
8587226,"Courtaman, centre",,0.00006,126,2,1,3,3685,3685,7370,9,0.196181,0.219293,1363.666667,0,0
8577853,"Tafers, Muttacker",,0.000071,126,4,3,7,14639,14639,29278,11,0.157823,0.193395,1866.617857,0,0
8577840,"Alterswil FR, Geriwil",,0.000025,126,1,1,2,14260,14260,28520,13,0.118409,0.132811,1257,0,0
8577841,"Alterswil FR, Hofmatt",,0.000032,126,1,1,2,14260,14260,28520,12,0.133263,0.148865,760,0,0
8577843,"Brünisried, Riedgarten",,0.000071,126,3,1,4,24808,24808,49616,10,0.178571,0.203308,6039.583333,0,0
8577864,"Tafers, Spital",,0.000045,126,2,2,4,5599,5599,11198,10,0.175698,0.207937,1943.886941,0,0
8577866,"Düdingen, Kirche",,0.00005,126,2,2,4,10358,10358,20716,10,0.174629,0.205181,533.178211,0,0
8577845,"Plaffeien, Telmoos",,0.000043,126,2,1,3,9088,9088,18176,15,0.095808,0.111131,3774,0,0
8577846,"Plaffeien, Kloster",,0.000047,126,1,1,2,9088,9088,18176,14,0.105014,0.120264,3256,0,0
8577847,"Schwarzsee, Buntschena",,0.000051,126,1,1,2,9088,9088,18176,13,0.116279,0.131676,2736,0,0
8577848,"Schwarzsee, Tromooserli",,0.000054,126,1,1,2,9088,9088,18176,12,0.130383,0.146369,2214,0,0
8577849,"Schwarzsee, Gypsera",,0.000057,126,1,1,2,9088,9088,18176,11,0.148556,0.166079,1690,0,0
8577850,"Schwarzsee, Hostellerie",,0.000059,126,1,1,2,9088,9088,18176,10,0.172859,0.194196,1164,0,0
8588816,"Tafers, Oberdorf",,0.000135,126,2,4,6,20126,21015,41141,5,0.328125,0.442857,9133.993398,0,0
8577854,"Lehwil, Abzw.",,0.000067,126,3,1,4,11833,16720,28553,13,0.147092,0.16651,13146.598413,0,0
8577855,"Heitenried, Pfandmatta",,0.000067,126,1,1,2,16720,16720,33440,12,0.171123,0.19774,12651.598413,0,0
8577861,"Berg FR, Schulhaus",,0.000031,126,1,1,2,4281,2582,6863,11,0.151179,0.172572,548.335245,0,0
8577862,"Schmitten FR, Bahnhof",,0.000049,126,2,2,4,6859,9634,16493,10,0.176471,0.207521,280.835245,0,0
8583454,"Flamatt, Oberflamatt",,0.000049,126,2,2,4,794,521,1315,10,0.174194,0.201657,543.5,0,0
8577857,"Heitenried, Abzw. Schwenny",,0.000036,126,2,1,3,3548,3619,7167,12,0.134426,0.151896,10206.333333,0,0
8577858,"Heitenried, Sodbach",,0.000041,126,1,1,2,3619,3431,7050,11,0.15404,0.1754,9702.333333,0,0
8580043,"Riedacker BE, Schulhaus",,0.000047,126,1,2,3,830,830,1660,4,0.454545,0.616667,15,0,0
8581121,"Schwarzenburg, Zelg",,0.000033,126,1,1,2,1984,1984,3968,2,0.6,0.666667,10,0,0
8581664,"Zumholz, Guggersbachbrücke",,0.000057,126,1,1,2,501,501,1002,2,0.6,0.666667,18,0,0
8577863,"Oberurnen, im Horn",,0.000075,106,1,1,2,9359,9846,19205,11,0.151163,0.200932,402.5,0,0
8587794,"Bourguillon, Niquille",,0.000017,126,1,1,2,16147,5418,21565,1,1,1,1388.06746,0,0
8577869,"Rechthalten, Wolfeich",,0.000039,126,1,1,2,10548,10548,21096,11,0.147309,0.165435,1266,0,0
8577870,"Rechthalten, Weissenstein",,0.000044,126,1,1,2,10548,10548,21096,10,0.171096,0.192873,736,0,0
8577875,"Giffers, Vorderried",,0.000038,126,2,1,3,12056,12056,24112,8,0.222222,0.339732,1836,0,0
8577876,"Plasselb, March",,0.000043,126,1,1,2,12056,12056,24112,7,0.25,0.370408,1231,0,0
8577877,"Oberschrot, Gousmatte",,0.000047,126,1,1,2,12056,12056,24112,6,0.285714,0.408333,624,0,0
8577879,"Plaffeien, Schaferli",,0.000032,126,1,1,2,501,500,1001,8,0.204545,0.315873,4272,0,0
8577880,Vorder-Sangernboden,,0.000038,126,1,1,2,500,501,1001,7,0.228571,0.341964,3568,0,0
8577881,"Sangernboden, Steinbachbrücke",,0.000043,126,1,1,2,501,501,1002,6,0.259259,0.37381,2862,0,0
8577882,"Sangernboden, Rothenbach",,0.000048,126,1,1,2,501,501,1002,5,0.3,0.413889,2154,0,0
8577883,"Sangernboden, Hengstsense",,0.000051,126,1,1,2,501,501,1002,4,0.357143,0.466667,1444,0,0
8577884,"St. Silvester, Hangenried",,0.000088,126,5,1,6,7245,7532,14777,4,0.4,0.520833,2459,0,0
8577885,"St. Silvester, Abzw.",,0.000086,126,1,1,2,7532,7532,15064,3,0.5,0.611111,1846,0,0
8577886,"St. Silvester, Muschels",,0.000084,126,1,1,2,7532,7532,15064,2,0.666667,0.75,1231,0,0
8577889,"Bonnefontaine, bif.",,0.000017,126,1,1,2,6203,6203,12406,2,0.666667,0.75,1222,0,0
8577890,"Le Mouret, Moulin à Benz",,0.000025,126,1,1,2,6203,6203,12406,1,1,1,612,0,0
8577891,"Murten/Morat, Bahnhof",,0.000083,126,4,5,9,10702,12819,23521,10,0.177108,0.221801,148164.934921,0,0
8577892,"Muntelier, Schloss",,0.000025,126,1,2,3,3007,3007,6014,18,0.081081,0.109892,1193,0,0
8577895,"Murten, Neugut",,0.000025,126,1,1,2,2481,2482,4963,10,0.169188,0.189279,0,0,0
8593296,"Büchslen, Eintracht",,0.00003,126,1,2,3,2976,2976,5952,2,0.75,0.833333,12,0,0
8595682,"Wallenried, village",,0.000096,126,1,1,2,2482,2482,4964,3,0.5,0.611111,1726.333333,0,0
8577893,"Murten, Bernstrasse",,0.000036,126,2,2,4,3650,4258,7908,17,0.08701,0.117995,21464.166667,0,0
8587351,Altavilla,,0.000022,126,1,1,2,2976,2976,5952,5,0.333333,0.411111,4.5,0,0
8583453,"Murten, Schwimmbad",,0.000064,126,1,1,2,2118,2118,4236,12,0.175824,0.277284,251,0,0
8577897,"Salvenach, Schulhaus",,0.000026,126,1,1,2,4227,4227,8454,16,0.089168,0.104767,15553,0,0
8577898,"Jeuss, Dorf Eingang",,0.000033,126,1,1,2,4227,4227,8454,15,0.097172,0.1139,14492,0,0
8577901,"Gurmels, Kirche",,0.000051,126,2,2,4,7416,7416,14832,13,0.118705,0.144287,12708.666667,0,0
8577902,"Allerheiligenberg, Höhenklinik",,0.000011,94,0,1,1,0,619,619,27,0.078341,0.101953,0,0,0
8577903,"Allerheiligenberg, Rank",,0.00002,94,1,1,2,619,619,1238,26,0.084167,0.109688,101,0,0
8577904,"Hägendorf, Gnöd",,0.000028,94,1,1,2,619,5555,6174,25,0.090992,0.120106,200,0,0
8577905,"Hägendorf, Spitzacker",,0.000035,94,1,2,3,5555,4093,9648,24,0.099099,0.136988,297,0,0
8578026,"Hägendorf, Solothurnerstrasse",,0.000097,94,6,3,9,38143,36684,74827,22,0.090726,0.140404,1029.833333,0,0
8577906,"Hägendorf, Schulhaus",,0.000026,94,1,1,2,3918,5555,9473,23,0.108287,0.14237,384,0,0
8590412,"Allerheiligenberg, Rest. Aller",,0.00006,94,3,1,4,646,444,1090,1,1,1,4,0,0
8577913,"Grenchen, Postplatz",,0.000014,127,1,3,4,5630,89937,95567,16,0.129428,0.17763,239.333333,0,0
8577916,"Grenchen, BBZ",,0.000022,127,2,1,3,9693,9693,19386,18,0.106152,0.136849,264,0,0
8577935,"Arch, Arche",,0.000047,127,1,2,3,5822,5822,11644,18,0.106237,0.139374,1320,0,0
8577941,"Grenchen, Kirchstrasse",,0.000023,127,2,1,3,12455,12455,24910,16,0.122584,0.152681,1632,0,0
8577915,"Grenchen, Florastrasse",,0.000012,127,1,1,2,4847,4847,9694,19,0.096294,0.118814,0,0,0
8577940,"Grenchen, Oele",,0.000054,127,4,4,8,22025,22028,44053,17,0.118309,0.166828,2142.922222,0,0
8577943,"Grenchen Nord, Bahnhof",,0.000018,127,2,3,5,36959,37525,74484,14,0.151142,0.194107,2237.5,0,0
8577944,"Grenchen, Monbijou",,0.000017,127,2,3,5,30310,30325,60635,14,0.141364,0.175135,223.908333,0,0
8589214,"Grenchen, Güterstrasse",,0.000075,127,1,2,3,16598,10776,27374,7,0.25,0.30409,333,0,0
8577972,"Grenchen, Schmelzi",,0.000037,127,3,6,9,28897,28897,57794,8,0.276224,0.34676,1010.838889,0,0
8594102,"Grenchen, Allmend",,0.000043,127,2,3,5,7056,7062,14118,6,0.297521,0.363426,213.819444,0,0
8594096,"Bettlach, Kastels",,0.000032,127,1,2,3,11157,11157,22314,6,0.255814,0.309596,73.333333,0,0
8594105,"Grenchen, Altersiedlung",,0.00003,127,3,3,6,12544,12544,25088,5,0.327103,0.396667,146.963781,0,0
8577917,"Grenchen, Brücke",,0.000012,127,1,1,2,5807,5822,11629,22,0.075689,0.089815,15,0,0
8577918,"Arch, Aarestrasse",,0.000021,127,1,1,2,5822,5822,11644,21,0.081583,0.098198,280,0,0
8577928,"Arch, Bahnhofstrasse",,0.000029,127,1,2,3,5822,5822,11644,20,0.088499,0.109914,543,0,0
8577929,"Rüti b. Büren, Archfeld",,0.000023,127,1,1,2,2910,2910,5820,20,0.088196,0.106568,0,0,0
8577934,"Rüti b. Büren, Hauptstrasse",,0.000043,127,2,1,3,5822,5822,11644,19,0.096364,0.119757,1063,0,0
8577963,"Grenchen, Sunnepark Süd",,0.000035,127,1,3,4,21754,21754,43508,9,0.233429,0.287439,146,0,0
8594095,"Bettlach, Ischlag",,0.000032,127,1,3,4,12641,12641,25282,5,0.323232,0.397396,158.333333,0,0
8594104,"Grenchen, Alpenstrasse",,0.000023,127,3,3,6,12515,12532,25047,5,0.336634,0.407353,355.824098,0,0
8587445,"Bettlach, Bahnhof",,0.000015,127,2,1,3,17533,17633,35166,10,0.159763,0.199574,11.908333,0,0
8587625,"Biel/Bienne, Swiss Tennis",,0.000065,87,2,3,5,51456,52087,103543,17,0.154908,0.234602,59192.744444,0,0
8577971,"Selzach, Bahnhof",,0.000041,127,1,2,3,5825,5825,11650,13,0.132258,0.205509,147,0,0
8587631,"Pieterlen, Schulhaus",,0.00004,87,1,2,3,11530,11530,23060,15,0.157807,0.221393,95,0,0
8577946,"Lengnau BE, Grienberg",,0.000015,127,1,2,3,12222,12222,24444,17,0.130169,0.1579,1547,0,0
8577947,"Lengnau BE, Gemeindehaus",,0.000017,127,1,1,2,6015,6384,12399,17,0.129076,0.151667,18,0,0
8577949,"Lengnau BE, Rado",,0.000026,127,1,1,2,6384,6384,12768,16,0.147426,0.179267,189,0,0
8577953,"Lengnau BE, Friedhof",,0.000017,127,1,1,2,6207,5951,12158,16,0.147426,0.179267,1685,0,0
8588646,"Grenchen, Schlachthaus",,0.00007,127,1,2,3,11837,11646,23483,13,0.143911,0.236977,26565.8,0,0
8577957,"Auenstein, Steinbr. Jakobsberg",,0.000088,58,3,2,5,6294,3759,10053,3,0.555556,0.666667,65,0,0
8580896,"Auenstein, Obermatt",,0.000055,58,1,1,2,3033,3033,6066,2,0.666667,0.75,4,0,0
8577961,"Büren an der Aare, Rütifeld",,0.000042,127,2,1,3,5822,5822,11644,12,0.12336,0.156302,36,0,0
8577962,"Grenchen, Mc Donald's",,0.000028,127,3,1,4,21752,21754,43506,10,0.191142,0.221961,81,0,0
8588207,"Bettlach, Dorfplatz",,0.000028,127,2,2,4,19126,19315,38441,9,0.18662,0.246032,92.983333,0,0
8577964,"Grenchen, Flurstrasse Süd",,0.000025,127,4,2,6,7493,7496,14989,13,0.179293,0.233612,191.066667,0,0
8588208,"Bettlach, Krone",,0.000033,127,2,1,3,29914,30287,60201,8,0.198473,0.241071,43,0,0
8577965,"Bettlach, St. Urs",,0.000022,127,1,1,2,5825,5825,11650,16,0.100228,0.144039,78,0,0
8577966,"Selzach, Haag",,0.000029,127,1,1,2,5825,5825,11650,15,0.108861,0.156002,103,0,0
8577969,"Selzach, Schildmatte",,0.000036,127,1,1,2,5825,5825,11650,14,0.119318,0.173434,126,0,0
8577973,"Grenchen, Bergstrasse",,0.000016,127,1,1,2,5816,5816,11632,8,0.202643,0.242184,0,0,0
8587446,"Büren an der Aare, Gehrweg",,0.000047,127,1,1,2,5822,5822,11644,11,0.137725,0.171878,70,0,0
8577974,"Grenchen, Holzerhütte",,0.00003,127,2,3,5,11052,11052,22104,7,0.248619,0.315608,328.111111,0,0
8577980,"Grenchen, Unterer Grenchenberg",,0.000049,127,1,2,3,581,581,1162,7,0.283019,0.402857,75,0,0
8577975,"Grenchen, Cadotschstein",,0.000019,127,1,1,2,581,581,1162,12,0.13986,0.206273,105,0,0
8577976,"Grenchen, Bettlachrank",,0.000027,127,1,1,2,581,581,1162,11,0.154472,0.220992,103,0,0
8577977,Stierenberg b. Grenchen,,0.000034,127,1,1,2,581,581,1162,10,0.173077,0.240256,99,0,0
8577978,"Grenchen, Wäsmeli",,0.00004,127,1,1,2,581,581,1162,9,0.197674,0.26746,93,0,0
8577979,"Grenchen, Fuchsboden",,0.000045,127,1,1,2,581,581,1162,8,0.231884,0.311086,85,0,0
8594103,"Grenchen, Alpenblick",,0.00004,127,2,2,4,5525,5525,11050,6,0.304348,0.421429,208.777778,0,0
8594118,"Grenchen, Grubenweg",,0.000038,127,1,1,2,5236,5236,10472,6,0.32,0.43125,95.416667,0,0
8594120,"Grenchen, Halden",,0.000056,127,3,3,6,7062,7062,14124,4,0.371429,0.442308,215.105556,0,0
8594130,"Grenchen, M. Schürer-Strasse",,0.000045,127,2,2,4,12544,12157,24701,6,0.346154,0.494444,1385.691234,0,0
8594137,"Grenchen, Reibenstrasse",,0.000087,127,2,2,4,15561,15561,31122,6,0.357143,0.495,10124.533333,0,0
8594138,"Grenchen, Riederen",,0.000053,127,1,1,2,4846,4846,9692,6,0.32,0.43125,40,0,0
8577982,"Olten, Trimbacherbrücke",,0.000019,94,1,1,2,31332,31333,62665,23,0.089943,0.113799,135,0,0
8577983,"Olten, Gerolag Center",,0.000027,94,1,1,2,31333,31334,62667,22,0.098054,0.126098,216,0,0
8577984,"Olten, Industriewerk",,0.000034,94,1,1,2,31334,31334,62668,21,0.107852,0.143699,295,0,0
8577986,"Winznau, Ausserdorf",,0.00003,94,2,1,3,48217,48231,96448,24,0.090979,0.112995,986,0,0
8577987,"Winznau, Dorf",,0.000037,94,1,1,2,48231,48231,96462,23,0.099237,0.124063,1054,0,0
8577988,"Winznau, Säliblick",,0.000042,94,1,1,2,48231,48231,96462,22,0.109228,0.139092,1120,0,0
8578011,"Niedergösgen, Jurastrasse",,0.000022,94,1,1,2,8433,8390,16823,24,0.071429,0.098808,0,0,0
8577991,"Lostorf, Kreisschule",,0.000027,94,2,2,4,40583,40583,81166,22,0.122727,0.167012,672.166667,0,0
8577993,"Lostorf, Mitte",,0.000036,94,2,4,6,40496,32756,73252,20,0.155653,0.229504,910.066667,0,0
8577999,"Stüsslingen, Kreuz",,0.000031,94,1,1,2,15619,15619,31238,22,0.124844,0.17046,204,0,0
8578001,"Stüsslingen, Mühle",,0.00002,94,1,1,2,7477,7477,14954,22,0.123116,0.165436,5,0,0
8578049,"Trimbach, Zentrum",,0.00006,94,1,2,3,38630,37723,76353,24,0.107198,0.176976,533.4,0,0
8577997,"Lostorf, Büechlen",,0.000015,94,1,1,2,13084,15619,28703,24,0.101594,0.130196,124,0,0
8577998,"Stüsslingen, Garage",,0.000023,94,1,1,2,15619,15619,31238,23,0.111973,0.146314,165,0,0
8578012,"Niedergösgen, Falkenstein",,0.00004,94,2,1,3,16832,16836,33668,23,0.076113,0.105694,367.333333,0,0
8578013,"Niedergösgen, Knoblez",,0.000045,94,1,1,2,16836,16837,33673,22,0.081507,0.114691,403.333333,0,0
8578015,"Niedergösgen, Mühledorf",,0.000049,94,1,1,2,16837,16837,33674,21,0.087786,0.127459,437.333333,0,0
8588649,"Olten, Bornblick",,0.000071,94,3,3,6,34219,32442,66661,16,0.13986,0.310703,2094.833333,0,0
8578019,"Kestenholz, Kastanienbaum",,0.000038,94,3,1,4,19565,19559,39124,22,0.094518,0.118368,312,0,0
8578020,"Niederbuchsiten, Linde",,0.000043,94,1,1,2,19559,19559,39118,21,0.10334,0.129957,362,0,0
8578021,"Neuendorf, Hardeck",,0.000047,94,1,1,2,19559,19559,39118,20,0.114086,0.145949,410,0,0
8578022,"Neuendorf, Unterdorf",,0.000051,94,1,2,3,19559,19559,39118,19,0.127464,0.171533,456,0,0
8578029,"Wangen b. Olten, Kleider Frey",,0.000067,94,3,3,6,34711,34712,69423,19,0.116598,0.187211,1986.066667,0,0
8578055,"Olten, Jurastrasse",,0.000092,94,1,4,5,66835,66835,133670,22,0.123047,0.225056,954.059524,0,0
8578027,"Hägendorf, Gässli",,0.000038,94,1,1,2,33967,33973,67940,21,0.096452,0.133606,881.833333,0,0
8578030,"Wangen b. Olten, Dorf",,0.00003,94,1,1,2,34216,34222,68438,25,0.083582,0.1076,728.1,0,0
8578031,"Wangen b. Olten, Ochsen",,0.000036,94,1,1,2,34222,34221,68443,24,0.090119,0.114668,722.1,0,0
8578032,"Wangen b. Olten, Neuhüsli",,0.000042,94,1,1,2,34221,34222,68443,23,0.097852,0.123324,714.1,0,0
8578033,"Olten, Chalchofen",,0.000046,94,1,1,2,34222,34222,68444,22,0.107143,0.1342,704.1,0,0
8578034,"Olten, Usego",,0.00005,94,1,1,2,34222,34222,68444,21,0.118519,0.148331,692.1,0,0
8578035,"Olten, Hammermühle",,0.000054,94,1,1,2,34222,34222,68444,20,0.132773,0.167548,678.1,0,0
8578038,"Olten, Konradstrasse",,0.000087,94,4,1,5,79096,79194,158290,18,0.175799,0.241036,3849.140476,0,0
8578916,"Egerkingen, Bahnhof",,0.000076,94,4,2,6,28445,28838,57283,21,0.112754,0.181995,1680.966667,0,0
8582255,"Oensingen, Jurastrasse",,0.000064,94,1,2,3,18520,18520,37040,17,0.128834,0.262995,318.666667,0,0
8588076,"Egerkingen, Gäu Park",,0.000055,94,1,2,3,14412,14412,28824,17,0.12963,0.270931,357,0,0
8590419,"Olten, Feldstrasse",,0.000043,94,2,4,6,30516,30516,61032,7,0.291667,0.429819,846.083333,0,0
8590420,"Olten, Friedhof",,0.000056,94,2,2,4,40454,40457,80911,7,0.263889,0.352256,726,0,0
8590421,"Olten, Gartenstrasse",,0.00002,94,1,1,2,15023,15023,30046,7,0.253521,0.31627,0,0,0
8578040,"Wisen SO, Sonne",,0.000019,94,1,1,2,5705,5705,11410,31,0.065756,0.095827,135,0,0
8578042,"Hauenstein, Löwen",,0.000027,94,1,1,2,5705,5705,11410,30,0.06947,0.100421,166,0,0
8578044,"Trimbach, Rankbrünneli",,0.000034,94,1,1,2,5705,5705,11410,29,0.073674,0.105903,195,0,0
8578046,"Trimbach, Eisenbahn",,0.000053,94,2,1,3,37712,29062,66774,27,0.084005,0.121087,470.4,0,0
8578047,"Trimbach, Baselbieter",,0.000056,94,1,1,2,29062,38632,67694,26,0.090452,0.132354,493.4,0,0
8578048,"Trimbach, Rössli",,0.000058,94,1,1,2,38632,38630,77262,25,0.098066,0.148616,514.4,0,0
8578051,"Trimbach, Rankwog",,0.000046,94,1,1,2,31826,31826,63652,24,0.101404,0.150846,208.829762,0,0
8578052,"Trimbach, Industrie",,0.000046,94,1,2,3,5705,5705,11410,24,0.104037,0.168731,424.829762,0,0
8578050,"Trimbach, Leinfeld",,0.000083,94,6,2,8,35939,37531,73470,25,0.096774,0.156064,780.659524,0,0
8578053,"Trimbach, Fähre",,0.000031,94,1,1,2,2728,2728,5456,1,1,1,109,0,0
8578054,"Olten, Spital",,0.000096,94,3,1,4,66821,66835,133656,23,0.111111,0.175096,1001.059524,0,0
8587635,"Wangen b. Olten, Gäuerstübli",,0.000073,94,1,4,5,15170,15170,30340,13,0.158879,0.295811,1311.307143,0,0
8589883,"Egerkingen, Gäupark Kreisel",,0.000052,94,1,2,3,14426,13931,28357,13,0.147619,0.243793,62,0,0
8578064,"Solothurn, Postplatz",,0.000045,56,1,1,2,2134,2134,4268,4,0.384615,0.483333,19,0,0
8578082,"Frauenfeld, Bruder-K. Kapelle",,0.000048,65,1,1,2,6780,6780,13560,12,0.153846,0.258601,2040,0,0
8578137,"Illighausen, Dorf",,0.000039,65,1,1,2,4607,4607,9214,20,0.094421,0.171454,446,0,0
8578167,Schönenbuch Dorf,,0.000052,2,1,2,3,3247,3247,6494,12,0.17263,0.207289,966,0,0
8589293,Allschwilerplatz,,0.000087,2,7,9,16,12689,12681,25370,9,0.237931,0.308742,7330.452056,0,0
8589298,Brombacherstrasse,,0.000079,2,5,5,10,14778,14777,29555,9,0.229706,0.283945,3356.783666,0,0
8589303,Burgfelderplatz,,0.000062,2,2,4,6,24074,24075,48149,9,0.232108,0.280241,527.216859,0,0
8589305,Clarastrasse,,0.000073,2,5,5,10,27651,27617,55268,9,0.234286,0.286821,1144.14239,0,0
8588487,Steinenschanze,,0.000024,2,1,2,3,19424,19424,38848,11,0.180639,0.208945,21.246429,0,0
8588488,Metzerstrasse,,0.000044,2,2,2,4,20282,20282,40564,11,0.191898,0.225946,434.85798,0,0
8589307,Eglisee,,0.000072,2,7,1,8,21127,21121,42248,9,0.215867,0.245486,231.263233,0,0
8578158,Paradies,,0.000012,2,1,1,2,31,5727,5758,13,0.14367,0.163715,15,0,0
8578160,Binningerstrasse,,0.000035,2,5,2,7,14096,14254,28350,12,0.167224,0.195002,330.903514,0,0
8578173,Hagmattstrasse,,0.000033,2,1,1,2,6227,6227,12454,12,0.16524,0.18864,399.333333,0,0
8578162,Rosenberg,,0.000026,2,1,1,2,3247,3247,6494,17,0.094376,0.105516,201,0,0
8578163,Reservoir,,0.000033,2,1,1,2,3247,3247,6494,16,0.103684,0.115659,358,0,0
8578164,Ziegelhof,,0.000039,2,1,1,2,3247,3247,6494,15,0.115091,0.128558,513,0,0
8578165,Im Pfeiffensack,,0.000044,2,1,1,2,3247,3247,6494,14,0.129396,0.145621,666,0,0
8578166,Niederfeld,,0.000048,2,1,1,2,3247,3247,6494,13,0.147866,0.169584,817,0,0
8588489,Universität,,0.000064,2,5,4,9,39115,37406,76521,10,0.218027,0.263909,1111.31675,0,0
8588782,Voltaplatz,,0.000059,2,3,5,8,14674,14673,29347,10,0.216049,0.273608,953.898736,0,0
8588952,Karl Barth-Platz,,0.000029,2,1,3,4,12151,12152,24303,10,0.201742,0.245815,1024.289006,0,0
8589290,Ziegelei,,0.000063,2,2,3,5,17068,17068,34136,9,0.218898,0.267597,712.636441,0,0
8578170,Basel Bachgraben,,0.000024,2,2,3,5,14256,14425,28681,10,0.181987,0.210708,349.397042,0,0
8578306,Breite,,0.00009,2,8,6,14,54020,54020,108040,15,0.160197,0.205243,8810.282907,0,0
8578171,Kreuzstrasse,,0.000018,2,1,1,2,6227,6227,12454,14,0.125241,0.138678,99.333333,0,0
8578172,Im Brühl,,0.000026,2,1,1,2,6227,6227,12454,13,0.142438,0.159085,250.333333,0,0
8578193,Muttenz Bahnhof,,0.000011,2,0,1,1,0,2706,2706,18,0.109064,0.122804,0,0,0
8578194,Fachhochschule,,0.00002,2,1,1,2,2706,2706,5412,17,0.122002,0.139793,295,0,0
8578240,Oberdorf Station,,0.000043,2,1,1,2,6455,6455,12910,13,0.13,0.184448,1612,0,0
8578241,Winkelweg,,0.000048,2,1,1,2,6455,6455,12910,12,0.143678,0.1984,1553,0,0
8578334,Arboldswil Renggelts,,0.000032,2,1,1,2,10588,10588,21176,4,0.4,0.520833,409,0,0
8578247,Reigoldswil Marchmatt,,0.000038,2,3,1,4,2896,2896,5792,15,0.126588,0.149218,111.166667,0,0
8578321,Liestal Altmarkt,,0.000076,2,2,3,5,63323,63309,126632,8,0.2625,0.383844,3194.083333,0,0
8578250,Hölstein Station,,0.000052,2,1,1,2,6455,6455,12910,11,0.161074,0.217015,1492,0,0
8578256,Lampenberg Station,,0.000055,2,1,1,2,6455,6455,12910,10,0.184,0.243823,1429,0,0
8578258,Bubendorf Talhaus,,0.000057,2,1,1,2,6455,6455,12910,9,0.215686,0.287734,1364,0,0
8578309,Birsfelden Stausee,,0.000037,2,1,1,2,28051,28051,56102,15,0.119048,0.131736,580,0,0
8578313,Pratteln Saline,,0.000058,2,1,2,3,28103,28103,56206,13,0.155089,0.180581,2654,0,0
8588946,Leimgrubenweg,,0.000049,2,3,2,5,17497,17448,34945,11,0.157277,0.182475,996.764574,0,0
8578307,Birsfelden Kirchmatt,,0.000024,2,1,1,2,28051,28051,56102,17,0.096721,0.10596,160,0,0
8578308,Birsfelden Friedhof,,0.000031,2,1,1,2,28051,28051,56102,16,0.106711,0.117214,371,0,0
8578311,Muttenz Auhafen,,0.000055,2,2,1,3,28103,28103,56206,14,0.134669,0.151411,2449,0,0
8578316,Füllinsdorf Kittler,,0.000052,2,2,1,3,28369,28369,56738,14,0.138224,0.159986,1920.333333,0,0
8579714,Arisdorf Hofacker,,0.000108,2,7,2,9,12252,9580,21832,7,0.271605,0.357251,1193.445238,0,0
8588069,Muttenz Schweizerhalle,,0.000086,2,3,3,6,28103,28103,56206,6,0.298507,0.405,980.356227,0,0
8589426,Liestal Munzach,,0.000058,2,2,2,4,23930,23930,47860,4,0.4375,0.559524,145.166667,0,0
8594067,Mülizelg,,0.000036,2,1,2,3,23903,23903,47806,4,0.428571,0.569444,1,0,0
8594158,Frenkendorf Friedhof,,0.000056,2,3,1,4,29847,22440,52287,4,0.384615,0.483333,25.833333,0,0
8589402,Frenkendorf Mühlacker,,0.000024,2,1,3,4,23876,23876,47752,6,0.301887,0.433333,162,0,0
8589403,Frenkendorf Schule Egg,,0.00003,2,2,3,5,29847,29847,59694,6,0.326087,0.454444,281.166667,0,0
8578323,Bubendorf Unterdorf,,0.000045,2,2,1,3,39840,39854,79694,7,0.26,0.349451,2013.25,0,0
8578324,Bubendorf Steingasse,,0.000049,2,1,3,4,39854,39840,79694,6,0.324324,0.477778,1862.25,0,0
8578331,Reigoldswil Gemeindezentrum,,0.000051,2,1,1,2,24751,24751,49502,1,1,1,5,0,0
8589399,Bubendorf Grosstannen,,0.000062,2,1,1,2,10588,10588,21176,1,1,1,19.75,0,0
8578325,Ziefen Diegmatt,,0.000025,2,1,1,2,24751,24751,49502,6,0.285714,0.408333,825,0,0
8578326,Ziefen Mühlegasse,,0.000032,2,1,1,2,24751,24751,49502,5,0.333333,0.456667,665,0,0
8578327,Ziefen Hofmatt,,0.000038,2,1,1,2,24751,24751,49502,4,0.4,0.520833,503,0,0
8578329,Reigoldswil Bütschen,,0.000043,2,1,1,2,24751,24751,49502,3,0.5,0.611111,339,0,0
8578330,Reigoldswil Linde,,0.000048,2,1,1,2,24751,24751,49502,2,0.666667,0.75,173,0,0
8578333,Arboldswil Mühletal,,0.000025,2,1,1,2,10588,10588,21176,5,0.333333,0.456667,570,0,0
8578335,Arboldswil Dorf,,0.000058,2,3,1,4,11145,11145,22290,3,0.5,0.611111,351.75,0,0
8578336,Titterten March,,0.00006,2,1,1,2,11145,10588,21733,2,0.666667,0.75,186.75,0,0
8578355,Pratteln Krummeneich,,0.000026,2,1,1,2,13790,13790,27580,8,0.226415,0.287946,82.285714,0,0
8578353,Pratteln Schloss,,0.000023,2,1,3,4,14107,14107,28214,10,0.213115,0.327808,545.854762,0,0
8588163,Pratteln Münchacker,,0.000035,2,1,1,2,11922,11922,23844,7,0.25,0.347186,24.311905,0,0
8588621,Pratteln Lindli,,0.000084,2,3,1,4,13948,13948,27896,7,0.25,0.347186,392.180952,0,0
8578354,Pratteln Gehrenacker,,0.000017,2,1,1,2,13790,13790,27580,9,0.19084,0.242635,177.285714,0,0
8581070,"Rheinfelden, Kloos",,0.000044,2,1,3,4,14974,14974,29948,7,0.272727,0.408413,65,0,0
8578359,"Rheinfelden, Augarten Zentrum",,0.000034,2,2,1,3,14974,14974,29948,9,0.193182,0.264519,239,0,0
8578360,"Rheinfelden, Strandbad",,0.000039,2,1,1,2,14974,14974,29948,8,0.225352,0.307961,153,0,0
8578362,Beggingen Neumühle,,0.000017,66,1,1,2,5865,5865,11730,23,0.074251,0.119525,33,0,0
8578364,Schleitheim Gemeindehaus,,0.000042,66,4,1,5,4570,4570,9140,22,0.07772,0.121422,99,0,0
8578367,Schleitheim Juliomagus,,0.000057,66,2,1,3,7554,7554,15108,21,0.082865,0.133392,243,0,0
8578373,Beringen Hägli,,0.000039,66,1,1,2,9570,9570,19140,18,0.099083,0.152829,192.083333,0,0
8578372,Siblingen Am Stei,,0.000067,66,3,2,5,15511,15511,31022,19,0.092593,0.15621,260.083333,0,0
8588546,Beringen Höhenweg,,0.000054,66,2,3,5,9570,7956,17526,2,0.8,0.875,90.25,0,0
8578374,Beringerfeld,,0.000067,66,2,2,4,9668,9668,19336,17,0.107943,0.182352,543.75,0,0
8578377,Scheidegg,,0.000053,66,2,3,5,28016,28016,56032,15,0.129114,0.222788,597.75,0,0
8578375,Engestrasse,,0.000039,66,1,1,2,7652,7652,15304,16,0.116331,0.177207,472.5,0,0
8578376,Zentrum - Rheinfall,,0.000031,66,2,3,5,36565,36565,73130,15,0.131841,0.225387,904.75,0,0
8582102,Neuhausen SBB,,0.00002,66,1,1,2,13219,13219,26438,15,0.119171,0.174541,0,0,0
8578385,Wilchingen Dorf,,0.000011,95,0,1,1,0,7681,7681,7,0.25,0.370408,0,0,0
8578386,Wilchingen Kapellenweg,,0.00002,95,1,1,2,7681,7681,15362,6,0.285714,0.408333,6,0,0
8578387,Wilchingen-Hallau Bahnhof,,0.000028,95,1,1,2,7681,7675,15356,5,0.333333,0.456667,10,0,0
8578388,Hallau Brugg,,0.000035,95,1,1,2,7675,7681,15356,4,0.4,0.520833,12,0,0
8578389,Hallau Gemeindehaus,,0.00004,95,1,1,2,7681,7682,15363,3,0.5,0.611111,12,0,0
8578391,Hallau Atlingen,,0.000045,95,1,1,2,7682,7682,15364,2,0.666667,0.75,10,0,0
8578392,Oberhallau Trottengasse,,0.000049,95,1,1,2,7682,7682,15364,1,1,1,6,0,0
8578398,"Stein am Rhein, Untertor",,0.000038,65,2,1,3,13326,13326,26652,3,0.5,0.566667,327,0,0
8578410,"Naters, Weingarten",,0.000025,40,1,1,2,8913,8913,17826,16,0.114286,0.189592,240,0,0
8578411,"Weissbad, Bötz",,0.00002,96,1,1,2,5444,5444,10888,3,0.5,0.611111,3,0,0
8578412,"Weissbad, Berg",,0.000028,96,1,1,2,5444,5444,10888,2,0.666667,0.75,4,0,0
8578413,"Weissbad, Zidler",,0.000035,96,1,1,2,5444,5444,10888,1,1,1,3,0,0
8578422,"Naters, Junkerbiel",,0.000032,40,1,1,2,8913,8913,17826,15,0.122581,0.198766,236,0,0
8578427,"St. Margrethen SG, Heldsberg",,0.000029,73,1,1,2,16747,16747,33494,12,0.142857,0.21912,475,0,0
8578428,"Au SG, Gemeindehaus",,0.000036,73,1,1,2,16747,16747,33494,11,0.156863,0.233261,396,0,0
8578429,"Au SG, Oberdorf",,0.000041,73,1,1,2,16747,16747,33494,10,0.174419,0.250899,315,0,0
8578430,"Au SG, Zinggen",,0.000046,73,1,1,2,16747,16747,33494,9,0.197183,0.274178,232,0,0
8578431,"Heerbrugg, Kloteren",,0.00005,73,1,1,2,16747,16747,33494,8,0.22807,0.307784,147,0,0
8578433,"Heerbrugg, Dornacherhof",,0.000074,73,2,3,5,37383,32038,69421,6,0.34375,0.50303,1111,0,0
8591850,"Widnau, Wiesenrain Zoll",,0.000032,73,1,1,2,6954,6954,13908,6,0.285714,0.408333,0,0,0
8578434,"Naters, Venezia",,0.000038,40,1,1,2,8913,8913,17826,14,0.132353,0.209412,230,0,0
8578440,"Widnau, Rhydorf",,0.000029,73,1,1,2,29038,28201,57239,37,0.046022,0.066452,570,0,0
8578441,"Widnau, Gemeindehaus",,0.000036,73,1,1,2,28201,28201,56402,36,0.047868,0.068916,603,0,0
8578442,"Widnau, Auenstrasse",,0.000041,73,1,1,2,28201,27422,55623,35,0.049882,0.071967,634,0,0
8578443,"Widnau, Güetli",,0.000046,73,1,1,2,27422,28259,55681,34,0.052088,0.076172,663,0,0
8578446,"Diepoldsau, Heimstrasse",,0.000032,73,1,1,2,27077,27856,54933,34,0.051367,0.070681,100,0,0
8578453,"Heerbrugg, Schloss",,0.000078,73,3,1,4,44588,17821,62409,32,0.056299,0.075959,5174,0,0
8578454,"Balgach, Optik",,0.000078,73,1,1,2,17821,17821,35642,31,0.059169,0.079126,4856,0,0
8578455,"Balgach, Ländern",,0.000077,73,1,1,2,17821,17821,35642,30,0.06237,0.082753,4536,0,0
8578456,"Balgach, Dorf",,0.000076,73,1,1,2,17821,17821,35642,29,0.065965,0.086957,4214,0,0
8578457,"Rebstein, Steinacker",,0.000076,73,1,1,2,17821,17821,35642,28,0.07003,0.091902,3890,0,0
8578458,"Rebstein, Ausserdorf",,0.000075,73,1,1,2,17821,17821,35642,27,0.074665,0.097826,3564,0,0
8578459,"Rebstein, Betten",,0.000075,73,1,1,2,17821,17821,35642,26,0.08,0.105085,3236,0,0
8578460,"Marbach SG, Ranft",,0.000074,73,1,1,2,17821,17821,35642,25,0.086207,0.114263,2906,0,0
8578461,"Marbach SG, Gehren",,0.000074,73,1,1,2,17821,17821,35642,24,0.093519,0.126394,2574,0,0
8578462,"Lüchingen, Kesselbrücke",,0.000074,73,1,1,2,17821,17821,35642,23,0.102262,0.143641,2240,0,0
8578487,"Eichberg, Dorf",,0.000061,73,1,2,3,7432,7432,14864,10,0.182692,0.253258,190,0,0
8588128,"Altstätten SG, Fleuben",,0.000034,73,1,1,2,16623,16389,33012,10,0.181818,0.2401,7886.733333,0,0
8588215,"Altstätten SG, Bächler",,0.00009,73,2,1,3,890,890,1780,10,0.181818,0.2401,4549.466667,0,0
8578467,"Altstätten SG, Traube",,0.000045,73,2,1,3,890,890,1780,18,0.085069,0.121577,4337,0,0
8578468,"Altstätten SG, Wieswanne",,0.000049,73,1,1,2,890,890,1780,17,0.091082,0.127597,3917,0,0
8578469,"Altstätten SG, Ziel-Kornberg",,0.000053,73,1,1,2,890,890,1780,16,0.098121,0.134811,3495,0,0
8578470,"Altstätten SG, Sägentobel",,0.000056,73,1,1,2,890,890,1780,15,0.106481,0.143685,3071,0,0
8578471,"Altstätten SG, Tannenbaum",,0.000058,73,1,1,2,890,890,1780,14,0.11658,0.154992,2645,0,0
8578472,"Altstätten SG, Baumert",,0.00006,73,1,1,2,890,890,1780,13,0.129032,0.170159,2217,0,0
8578473,"Altstätten SG, Ergeten-Loch",,0.000062,73,1,1,2,890,890,1780,12,0.144781,0.192334,1787,0,0
8578474,"Altstätten SG, Ruppenhalde",,0.000064,73,1,2,3,890,890,1780,11,0.165354,0.231964,1355,0,0
8582241,"Oberegg AI, Landmark",,0.000123,73,2,2,4,1398,1398,2796,11,0.160643,0.222729,5121.466667,0,0
8578475,"Altstätten SG, Ruppen",,0.000038,73,1,1,2,327,327,654,12,0.141379,0.187488,411,0,0
8582240,"Trogen, Eugst",,0.000094,73,1,1,2,1071,1071,2142,12,0.141379,0.187488,5188.466667,0,0
8578480,"Altstätten SG, Hirschen",,0.000046,73,2,1,3,7432,7432,14864,15,0.104116,0.142414,2345,0,0
8578481,"Altstätten SG, Unterlitten",,0.00005,73,1,1,2,7432,7432,14864,14,0.113514,0.152174,1918,0,0
8578482,"Altstätten SG, Altersh. Forst",,0.000054,73,1,1,2,7432,7432,14864,13,0.125,0.164723,1489,0,0
8578483,"Hinterforst, Widenbach/Bächis",,0.000057,73,1,1,2,7432,7432,14864,12,0.139373,0.181759,1058,0,0
8578486,"Eichberg, Härdli",,0.000059,73,1,1,2,7432,7432,14864,11,0.157895,0.207073,625,0,0
8588217,"Altstätten SG, Elsenacker",,0.000164,73,4,4,8,45591,45825,91416,9,0.216374,0.320024,14725.366667,0,0
8578488,"Naters, Schulhaus Bammatte",,0.000044,40,1,1,2,8913,8913,17826,13,0.144068,0.222081,222,0,0
8578489,"Weesen, Biäsche",,0.000043,106,2,1,3,16736,17232,33968,12,0.164706,0.263325,49,0,0
8578491,"Weesen, Post",,0.000047,106,1,1,2,17232,17232,34464,11,0.183099,0.296401,55,0,0
8578492,"Weesen, See",,0.000051,106,1,2,3,17232,17232,34464,10,0.206897,0.369081,59,0,0
8578498,"Amden, Vorderdorf",,0.000072,106,2,2,4,17236,17236,34472,4,0.461538,0.597222,84,0,0
8578502,"Arvenbüel, Obern",,0.000053,106,1,1,2,7242,6742,13984,2,0.666667,0.75,6,0,0
8589197,"Mollis, Haltli",,0.000085,106,2,1,3,6354,5955,12309,2,0.666667,0.75,20,0,0
8578493,"Weesen, Autis",,0.000033,106,1,1,2,16736,16736,33472,9,0.189655,0.285317,55,0,0
8578494,"Fli, Hirschen",,0.000039,106,1,1,2,16736,16736,33472,8,0.212766,0.308452,55,0,0
8578495,"Amden, Bellevue",,0.000044,106,1,1,2,16736,16736,33472,7,0.243243,0.338095,53,0,0
8578496,"Amden, Montana",,0.000048,106,1,1,2,16736,16736,33472,6,0.285714,0.379167,49,0,0
8578499,"Amden, Stocksitten",,0.000041,106,1,1,2,7242,7242,14484,5,0.333333,0.456667,48,0,0
8578500,"Amden, Mennweg",,0.000046,106,1,1,2,7242,7242,14484,4,0.4,0.520833,36,0,0
8578501,"Amden, Sell",,0.00005,106,1,1,2,7242,7242,14484,3,0.5,0.611111,22,0,0
8578503,"Naters, Tschill-Bammatte",,0.000048,40,1,1,2,8913,8913,17826,12,0.158416,0.237701,212,0,0
8581667,"Waldstatt, Dorf",,0.000024,71,1,1,2,4623,4623,9246,13,0.1455,0.167855,0,0,0
8581741,"Waldstatt, Hirschenkreuzung",,0.00005,71,3,1,4,5892,5892,11784,12,0.169291,0.203198,172,0,0
8588062,"Herisau, am Bach",,0.000077,71,4,2,6,14512,9646,24158,12,0.169458,0.206105,615.793612,0,0
8588239,"Herisau, Obstmarkt",,0.000157,71,7,9,16,96489,97381,193870,11,0.202607,0.270756,30811.974042,0,0
8589895,"St. Gallen, Stahl KV-Schule",,0.000206,71,9,2,11,129704,40269,169973,14,0.128713,0.212943,2253.681841,0,0
8589896,"St. Gallen, Biderstrasse",,0.000121,71,2,1,3,40269,64,40333,14,0.124378,0.181461,205.5,0,0
8590320,"Gossau SG, Talstrasse",,0.000044,71,1,1,2,14693,14825,29518,14,0.124378,0.181461,25,0,0
8578511,"Gähwil, Schmid Garage",,0.000028,20,1,1,2,17684,17151,34835,28,0.060927,0.109251,628,0,0
8578513,"Gähwil, Waldwies",,0.000035,20,1,1,2,17151,17151,34302,27,0.06347,0.112813,516,0,0
8578514,"Kirchberg SG, Tüfrüti",,0.00004,20,1,1,2,17151,17151,34302,26,0.066265,0.116905,402,0,0
8578515,"Kirchberg SG, Salen",,0.000045,20,1,1,2,17151,16618,33769,25,0.069355,0.121716,286,0,0
8578517,"Kirchberg SG, Neudorf",,0.000088,20,4,1,5,23008,23175,46183,23,0.076636,0.134904,1783,0,0
8578518,"Wolfikon SG, Freihof",,0.000085,20,1,1,2,23175,23175,46350,22,0.080972,0.144772,1485,0,0
8578519,"Wolfikon SG, Engel",,0.000083,20,1,1,2,23175,23175,46350,21,0.085903,0.15927,1185,0,0
8578522,"Rickenbach bei Wil, Mühle",,0.00003,20,1,1,2,14282,14282,28564,2,0.6,0.666667,0,0,0
8582463,"Kirchberg SG, Florastrasse",,0.00003,20,1,1,2,17684,16618,34302,2,0.6,0.666667,0,0,0
8587780,"Kirchberg SG, Husen",,0.000102,20,1,2,3,7411,2816,10227,2,0.666667,0.75,2702,0,0
8578523,"Naters, Naterloch",,0.000052,40,1,1,2,8913,8913,17826,11,0.176471,0.257992,200,0,0
8578525,"Rapperswil SG, Zeughaus",,0.000026,67,1,1,2,32192,32187,64379,14,0.130288,0.158941,421,0,0
8578530,"Jona, Feldli",,0.000026,67,1,4,5,23874,23875,47749,11,0.165909,0.234883,653.62619,0,0
8578531,"Jona, Jona-Center",,0.000032,67,2,2,4,18716,18716,37432,12,0.14876,0.191971,601.5,0,0
8578532,"Jona, Erlen",,0.000045,67,3,1,4,27495,27495,54990,11,0.165854,0.198804,3279,0,0
8578533,"Jona, St. Dionys",,0.000049,67,1,2,3,27495,27495,54990,10,0.195906,0.245126,2943,0,0
8588035,"Jona, Busskirchstrasse",,0.000026,67,2,1,3,10757,23539,34296,9,0.207207,0.292667,6379.583333,0,0
8591722,"Jona, Allmeindstrasse",,0.000021,67,1,1,2,14049,14034,28083,9,0.207207,0.292667,429.416667,0,0
8578535,"Wagen, St. Wendelin",,0.000032,67,1,1,2,22451,22451,44902,8,0.203125,0.280311,2016,0,0
8578536,"Wagen, Käserei",,0.000038,67,1,1,2,22451,22451,44902,7,0.235294,0.311905,1623,0,0
8578537,"Wagen, Alte Post",,0.000043,67,1,1,2,22451,22451,44902,6,0.282051,0.362121,1228,0,0
8578547,"St. Gallenkappel, Unterdorf",,0.000061,67,1,5,6,21466,21466,42932,3,0.666667,0.791667,2519.916667,0,0
8580537,"Kaltbrunn, Gasterstrasse",,0.000096,67,2,3,5,14972,14690,29662,2,0.8,0.875,928,0,0
8583215,"Uznach, Spital West",,0.000038,67,1,1,2,4560,4842,9402,2,0.666667,0.75,0,0,0
8578539,"Naters, Seniorenzentrum",,0.000055,40,1,1,2,8913,8913,17826,10,0.2,0.286593,186,0,0
8578540,"Naters, alte Post",,0.000057,40,1,1,2,8913,8913,17826,9,0.232143,0.332998,170,0,0
8578541,"Naters, Judengasse",,0.00006,40,1,2,3,8913,8913,17826,8,0.27907,0.434821,152,0,0
8582448,"Bitsch, Bahnhof",,0.000102,40,4,2,6,19823,19605,39428,6,0.346154,0.494444,348,0,0
8578545,"Brig, Simplonhalle",,0.000014,40,1,1,2,2617,3829,6446,11,0.172093,0.211809,21,0,0
8578546,"St. Gallenkappel, Berg",,0.000059,67,3,1,4,21466,21466,42932,4,0.428571,0.490741,2920.916667,0,0
8581903,"Eschenbach SG, Bildstöckli",,0.000066,67,2,2,4,6501,6515,13016,2,0.666667,0.75,412.483333,0,0
8582140,"Hintergoldingen, Austrasse",,0.000039,67,1,1,2,5903,5656,11559,2,0.6,0.666667,0,0,0
8578554,"Wattwil, Spital",,0.000036,67,1,1,2,6800,6800,13600,1,1,1,2,0,0
8588335,"Neuhaus SG, Industrie",,0.00014,67,5,1,6,11122,241,11363,1,1,1,230.133333,0,0
8578556,"Glis, Spital",,0.000097,40,4,5,9,22042,22039,44081,8,0.298246,0.416001,4607,0,0
8578648,"Glis, Holowistrasse",,0.000066,40,1,1,2,7811,7811,15622,5,0.34375,0.412121,66,0,0
8578552,"Ricken SG, Kirche",,0.000021,67,1,1,2,6800,6800,13600,3,0.5,0.611111,822,0,0
8578553,"Wattwil, Brendi",,0.000029,67,1,1,2,6800,6800,13600,2,0.666667,0.75,413,0,0
8578684,"Glis, Klosmatten",,0.000045,40,1,1,2,4664,4664,9328,8,0.225,0.329762,27,0,0
8578557,"Eschenbach SG, Riet",,0.000082,67,5,1,6,17774,17774,35548,12,0.150376,0.215061,1344,0,0
8578558,"Eschenbach SG, Lettengasse",,0.000081,67,1,1,2,17774,17774,35548,11,0.168142,0.233565,915,0,0
8578559,"Eschenbach SG, Kählen",,0.000079,67,1,1,2,17774,17287,35061,10,0.191489,0.259546,484,0,0
8578562,"Ermenswil, Post",,0.000062,67,2,1,3,16319,17137,33456,7,0.223881,0.288413,941,0,0
8578563,"Rüti ZH, Weier",,0.000064,67,1,1,2,17137,17137,34274,6,0.269231,0.336905,502,0,0
8578566,"Naters, Tünnelstrasse",,0.000025,40,1,1,2,8835,8835,17670,12,0.148515,0.233071,345,0,0
8578569,"Walenstadt, Schnabelweid",,0.000022,124,1,1,2,5233,5094,10327,7,0.235294,0.34494,60,0,0
8578571,"Walenstadtberg, Stauffacher",,0.00003,124,1,1,2,5094,5094,10188,6,0.269231,0.378571,53,0,0
8578572,"Walenstadtberg, alte Post",,0.000036,124,1,1,2,5094,4936,10030,5,0.315789,0.422222,44,0,0
8578573,"Walenstadtberg, Alpenblick",,0.000042,124,1,1,2,4936,5080,10016,4,0.384615,0.483333,33,0,0
8578574,"Walenstadtberg, Reha-Klinik",,0.000046,124,1,1,2,5080,5108,10188,3,0.5,0.583333,20,0,0
8588539,"Berschis, Unterdorf",,0.000057,124,1,2,3,6795,6795,13590,3,0.555556,0.666667,86,0,0
8588541,"Flums, Lochriet",,0.000035,124,1,1,2,6613,6613,13226,3,0.5,0.583333,0,0,0
8578575,"Naters, Sportplatz",,0.000032,40,1,1,2,8835,8835,17670,11,0.162791,0.248018,336,0,0
8578576,"Naters, Saaser Müra",,0.000038,40,1,1,2,8835,8835,17670,10,0.180556,0.266331,325,0,0
8578578,"Lichtensteig, Untertor",,0.000044,97,1,1,2,21074,21074,42148,17,0.088571,0.143283,1590,0,0
8578579,"Lichtensteig, Rosengarten",,0.000049,97,1,1,2,21074,21074,42148,16,0.094044,0.148696,1266,0,0
8578580,"Wattwil, Bunt",,0.000052,97,1,1,2,21074,21074,42148,15,0.100346,0.154812,940,0,0
8578582,"Glis, Kapelle Englisch-Gruss",,0.000055,40,2,1,3,7811,7811,15622,11,0.142857,0.217836,1626,0,0
8578583,"Glis, Manus",,0.000058,40,1,1,2,7811,7811,15622,10,0.156863,0.2313,1371,0,0
8578584,"Wattwil, Rietwis",,0.000087,97,3,1,4,23111,23112,46223,13,0.116379,0.170005,5644,0,0
8578585,"Wattwil, Wis",,0.000085,97,1,1,2,23112,23112,46224,12,0.126829,0.179763,5312,0,0
8578586,Ulisbach,,0.000083,97,1,1,2,23112,23112,46224,11,0.139665,0.191733,4978,0,0
8578587,"Wattwil, Hegis",,0.000081,97,1,1,2,23112,23112,46224,10,0.155844,0.206961,4642,0,0
8578588,"Ebnat, Kapplerhof",,0.00008,97,1,1,2,23112,23112,46224,9,0.176923,0.227312,4304,0,0
8578589,"Ebnat, Au",,0.000079,97,1,1,2,23112,23112,46224,8,0.205607,0.256494,3964,0,0
8578590,"Ebnat, Kappel",,0.000078,97,1,1,2,23112,23112,46224,7,0.247059,0.303288,3622,0,0
8578591,"Ebnat-Kappel, Bahnhof",,0.000077,97,1,2,3,23112,23112,46224,6,0.3125,0.3975,3278,0,0
8578593,"Ebnat, Gemeindehaus",,0.000048,97,1,1,2,11550,11550,23100,6,0.295082,0.358333,18,0,0
8578592,"Ebnat, Mühlau",,0.000044,97,1,1,2,11550,11550,23100,7,0.2375,0.291353,366,0,0
8580479,"Bazenheid, Bahnhof",,0.000016,20,1,1,2,7353,7353,14706,7,0.253731,0.321148,104,0,0
8588425,"Rickenbach bei Wil, Breite",,0.000125,20,4,2,6,36757,58,36815,1,1,1,358,0,0
8591906,"Ebnat, Gieselbach",,0.000107,73,2,1,3,1100,562,1662,1,1,1,1265.5,0,0
8578603,"Sirnach, Weberei",,0.000048,20,1,1,2,10633,10633,21266,21,0.075248,0.12705,92.5,0,0
8578596,"Wil SG, Winkelriedstrasse",,0.000047,20,2,1,3,12639,12639,25278,17,0.104364,0.152683,206,0,0
8578599,"Sirnach, Gloten",,0.00005,20,2,1,3,23207,22834,46041,22,0.083994,0.131474,2338,0,0
8578601,"Sirnach, Bahnhof",,0.000087,20,2,2,4,36896,36705,73601,20,0.096958,0.168264,2298.5,0,0
8578602,"Glis, Jesuitenweg",,0.00006,40,1,1,2,7811,7811,15622,9,0.174419,0.247725,1114,0,0
8578604,"Wiezikon b. S., Wies",,0.000071,20,2,1,3,12639,12639,25278,20,0.079229,0.13222,742,0,0
8578605,"Oberwangen TG, Grueb",,0.000071,20,1,1,2,12639,12639,25278,19,0.083721,0.138544,611,0,0
8578607,"Dussnang, Frohsinn",,0.000071,20,1,1,2,12639,12639,25278,18,0.088832,0.146844,478,0,0
8578608,"Fischingen, Scheidweg",,0.000072,20,1,1,2,12639,12639,25278,17,0.094708,0.159308,343,0,0
8578610,"Glis, Grundbiel",,0.000062,40,1,1,2,7811,7811,15622,8,0.197183,0.268622,855,0,0
8578618,"Sirnach, Hofen",,0.000067,20,2,1,3,22328,22328,44656,18,0.098191,0.156911,1869,0,0
8578619,"Sirnach, Rosenberg",,0.000068,20,1,1,2,22328,22328,44656,17,0.106017,0.173021,1739,0,0
8578620,"Eschlikon TG, altes Schulhaus",,0.000069,20,1,1,2,22328,22328,44656,16,0.115385,0.199393,1607,0,0
8578621,"Eschlikon TG, Mitteldorf",,0.000069,20,1,3,4,22328,22328,44656,15,0.126812,0.257743,1473,0,0
8578624,"Ifwil b. B., Ausserdorf",,0.000037,20,1,1,2,2541,2541,5082,15,0.113971,0.186161,31,0,0
8578623,"Ifwil b. B., Aadorferstrasse",,0.000031,20,1,1,2,2487,2541,5028,16,0.105263,0.168068,171,0,0
8578625,"Balterswil, Dorf",,0.000062,20,2,2,4,17325,17655,34980,14,0.124481,0.222443,682,0,0
8578626,"Balterswil, Schulhaus",,0.000037,20,1,1,2,12574,12574,25148,13,0.123404,0.17868,504,0,0
8578627,"Bichelsee, Volg",,0.000043,20,1,1,2,12574,12574,25148,12,0.135922,0.196163,358,0,0
8578792,"Busswil TG, Dorfplatz",,0.000053,20,1,1,2,16563,16563,33126,12,0.135922,0.196163,636,0,0
8578628,"Glis, Giardino",,0.000063,40,1,1,2,7811,7811,15622,7,0.22807,0.296886,594,0,0
8578629,"Wallenwil, Schulhaus",,0.000031,20,1,2,3,5057,5209,10266,3,0.571429,0.708333,202,0,0
8587412,"Wallenwil, Schlangenzoo",,0.000108,20,2,2,4,20260,20260,40520,1,1,1,387,0,0
8588625,"Sirnach, Kett",,0.000057,20,1,1,2,12574,12201,24775,1,1,1,0,0,0
8578630,"Wallenwil, Frohsinn",,0.000024,20,1,1,2,2605,2605,5210,2,0.6,0.666667,13,0,0
8587256,"Balterswil,  Rietwies",,0.000091,20,2,1,3,17655,17655,35310,2,0.6,0.666667,572,0,0
8578632,"Dussnang, Tannegg",,0.000042,20,1,1,2,2744,2747,5491,2,0.666667,0.75,98,0,0
8578640,"Glis, Heilpädagogische Schule",,0.000065,40,1,1,2,7811,7811,15622,6,0.272727,0.338889,331,0,0
8588650,"Schönenwerd SO, Bahnhof",,0.000053,94,2,1,3,16842,16362,33204,15,0.139535,0.244531,1933.333333,0,0
8590132,"Aarau, Allmendweg",,0.00002,57,2,1,3,3269,3269,6538,11,0.173184,0.237725,100.883333,0,0
8590150,"Aarau, Keba-Brügglifeld",,0.00006,57,1,1,2,5829,5829,11658,5,0.315789,0.422222,54,0,0
8588428,"Aarau, Achenbergstrasse",,0.000058,57,1,2,3,11849,11849,23698,11,0.2,0.278944,248.153846,0,0
8578645,"Aarau, Alte Badanstalt",,0.00002,57,2,1,3,14921,14921,29842,14,0.12426,0.192026,750,0,0
8578646,"Erlinsbach, Rebberg",,0.000028,57,1,1,2,14921,14921,29842,13,0.135135,0.203094,695,0,0
8578647,"Erlinsbach, Sugen",,0.000034,57,1,1,2,14921,14921,29842,12,0.148438,0.216669,638,0,0
8578649,"Erlinsbach, Kilbig",,0.00004,57,1,1,2,14921,14921,29842,11,0.165138,0.234107,579,0,0
8578650,"Erlinsbach, Rössli",,0.000045,57,1,1,2,14921,14921,29842,10,0.186813,0.258147,518,0,0
8578653,"Erlinsbach, Breitmis",,0.000037,57,1,1,2,3876,3876,7752,3,0.5,0.611111,249,0,0
8578654,Laurenzenbad,,0.000043,57,1,1,2,3876,3876,7752,2,0.666667,0.75,168,0,0
8578655,"Hard, Abzw.",,0.000047,57,1,1,2,3876,3876,7752,1,1,1,85,0,0
8578659,"Rombach, Obstgarten",,0.000017,57,2,1,3,11849,11849,23698,19,0.088838,0.132962,600.153846,0,0
8578660,"Küttigen, Aabach",,0.000026,57,1,1,2,11849,11849,23698,18,0.095,0.139012,563.153846,0,0
8578661,"Küttigen, Kirchberg",,0.000033,57,1,1,2,11849,11849,23698,17,0.10221,0.146147,524.153846,0,0
8578662,"Biberstein, Wissenbach",,0.000039,57,1,1,2,11849,11849,23698,16,0.110769,0.154756,483.153846,0,0
8578663,"Biberstein, Post",,0.000044,57,1,1,2,11849,11849,23698,15,0.121107,0.165455,440.153846,0,0
8578664,"Biberstein, Dorf",,0.000048,57,1,1,2,11849,11849,23698,14,0.133858,0.179284,395.153846,0,0
8578665,"Biberstein, Ihegi",,0.000052,57,1,1,2,11849,11849,23698,13,0.15,0.198195,348.153846,0,0
8578669,"Baden, Schellenacker",,0.000031,22,1,1,2,23102,23102,46204,24,0.095459,0.107248,1071,0.00003,0
8578670,"Baden, Kapelle",,0.000037,22,1,1,2,23102,23102,46204,23,0.105336,0.120844,1422,0,0
8578671,"Baden, Ifang",,0.000042,22,1,1,2,23102,23102,46204,22,0.117518,0.139762,1771,0,0
8590185,"Baden, Pinte",,0.000091,22,4,5,9,17723,17723,35446,20,0.083522,0.117941,7776.779909,0.000108,0.000178
8578675,"Glis, Gstipf",,0.000027,40,1,1,2,4664,4664,9328,11,0.164384,0.263561,813,0,0
8578676,"Glis, Tennisplatz",,0.000034,40,1,1,2,4664,4664,9328,10,0.180328,0.281421,553,0,0
8590174,"Baden, Grand Casino",,0.000083,22,1,7,8,27928,27928,55856,20,0.084231,0.123564,3366.444872,0,0.000295
8590175,"Baden, Kehl",,0.000047,22,2,3,5,23487,23487,46974,21,0.077531,0.105412,782.193978,0.000003,0.000072
8590183,"Baden, Obere Kehlstrasse",,0.000027,22,1,2,3,4603,4603,9206,21,0.077097,0.101541,504.311905,0,0.000056
8590184,"Baden, Oberstadt",,0.000024,22,1,1,2,5931,5931,11862,21,0.076985,0.0991,14,0.00002,0.000049
8590187,"Baden, Römerstrasse",,0.000068,22,5,3,8,17083,17083,34166,20,0.082643,0.108906,1483.371032,0.000269,0.00006
8590189,"Baden, Rütistrasse",,0.000061,22,2,2,4,9995,9817,19812,20,0.083116,0.112298,2067.166667,0,0.000158
8590193,"Baden, Schwimmbad",,0.000041,22,4,4,8,22718,22718,45436,19,0.089174,0.122806,2032.294303,0.000443,0.00018
8590196,"Baden, Grosse Bäder",,0.000045,22,3,2,5,11466,11466,22932,20,0.082328,0.109863,420.469873,0.0002,0.000128
8590197,"Baden, Trafo",,0.0002,22,12,9,21,67965,62672,130637,19,0.089303,0.130858,29683.56758,0.000716,0.000157
8590249,"Neuenhof, Posthorn",,0.00005,22,1,3,4,28415,28415,56830,18,0.091775,0.113104,5888,0,0.000021
8578680,"Glis, Oberdorf",,0.00004,40,1,1,2,4664,4664,9328,9,0.2,0.302897,291,0,0
8578687,"Glis, untere Briggasse",,0.000066,40,2,1,3,9334,9334,18668,7,0.258065,0.365774,2200,0,0
8578758,"Glis, Holzackerweg",,0.000067,40,1,1,2,9334,9334,18668,6,0.304348,0.421429,1932,0,0
8578759,"Glis, untere Haselgasse",,0.000068,40,1,2,3,9334,9334,18668,5,0.375,0.547222,1662,0,0
8578761,"Glis, Polenstrasse",,0.00004,40,1,1,2,4670,4670,9340,5,0.333333,0.456667,0,0,0
8578762,"Glis, obere Haselgasse",,0.000073,40,2,1,3,9334,9334,18668,4,0.4,0.520833,1116,0,0
8578763,"Glis, Wickert",,0.000073,40,1,1,2,9334,9334,18668,3,0.5,0.611111,840,0,0
8578777,"Glis, Holzji",,0.000073,40,1,1,2,9334,4670,14004,2,0.666667,0.75,562,0,0
8578778,"Glis, Napoleon",,0.000073,40,1,1,2,4670,4670,9340,1,1,1,282,0,0
8578781,"Bad Zurzach, Seesteg",,0.000019,98,1,1,2,2272,2272,4544,5,0.35,0.445238,868,0,0
8578783,"Rekingen AG, Dorf",,0.000027,98,1,2,3,2272,2520,4792,4,0.461538,0.597222,750,0,0
8578785,"Böbikon, Schulhaus",,0.00003,98,1,1,2,2175,2175,4350,4,0.4,0.520833,4,0,0
8578784,"Böbikon, Dorfplatz",,0.000022,98,1,1,2,2116,2175,4291,5,0.333333,0.456667,126,0,0
8578786,"Baldingen, Unterdorf",,0.000048,98,2,1,3,2579,2579,5158,3,0.5,0.611111,384,0,0
8578787,"Baldingen, Mitteldorf",,0.000052,98,1,1,2,2579,2579,5158,2,0.666667,0.75,258,0,0
8578788,"Baldingen, Oberdorf",,0.000055,98,1,1,2,2579,2272,4851,1,1,1,130,0,0
8578789,"Littenheid, Klinik",,0.00008,20,3,2,5,18569,18569,37138,15,0.107744,0.183555,1240,0,0
8578790,"Littenheid, Sonnenmatt",,0.000045,20,1,1,2,16563,16563,33126,14,0.113208,0.166557,926,0,0
8578791,"Busswil TG, Hauptstrasse",,0.000049,20,1,1,2,16563,16563,33126,13,0.123404,0.17868,782,0,0
8578796,"Wil SG, Kantonsschule",,0.000085,20,2,1,3,27495,27495,54990,9,0.190476,0.253158,1464,0,0
8578825,"Wil SG, Bergholz",,0.000051,20,1,1,2,28131,28131,56262,9,0.190476,0.253158,126,0,0
8578798,"Bischofszell, Obertor",,0.000015,121,1,1,2,3461,3461,6922,10,0.181818,0.292897,13,0,0
8578799,"Bischofszell, Sattelbogen",,0.000024,121,1,1,2,3461,3461,6922,9,0.2,0.31433,20,0,0
8578800,"Bischofszell, Pflegeheim",,0.000031,121,1,1,2,3461,3461,6922,8,0.222222,0.339732,25,0,0
8578802,"Eberswil, Abzw. Lütschwil",,0.00005,121,2,1,3,3770,3957,7727,6,0.285714,0.408333,36,0,0
8578803,"Wilen (Gottshaus), Rehalp",,0.000053,121,1,1,2,3957,3957,7914,5,0.333333,0.456667,33,0,0
8578805,"Wilen (Gottshaus), Hoferberg",,0.000065,121,2,1,3,4279,4092,8371,3,0.5,0.611111,30,0,0
8578806,"Wilen (Gottshaus), Lauften",,0.000066,121,1,1,2,4092,4092,8184,2,0.666667,0.75,21,0,0
8578813,"Frauenfeld, Ochsen",,0.000052,65,1,1,2,6780,6780,13560,11,0.166667,0.274534,1881,0,0
8578815,"Gerlikon, Huggenbergerhaus",,0.000055,65,1,1,2,6780,6780,13560,10,0.181818,0.292897,1720,0,0
8578816,"Gerlikon, Bausel",,0.000058,65,1,1,2,6780,6780,13560,9,0.2,0.31433,1557,0,0
8578817,"Gachnang, Hofen",,0.00006,65,1,1,2,6780,6780,13560,8,0.222222,0.339732,1392,0,0
8578818,"Gachnang, Oberwilerstrasse",,0.000062,65,1,1,2,6780,6780,13560,7,0.25,0.370408,1225,0,0
8578819,"Gachnang, Trotte",,0.000063,65,1,1,2,6780,6780,13560,6,0.285714,0.408333,1056,0,0
8578821,"Wilen bei Wil, Langwiesen",,0.000019,20,1,1,2,27650,27650,55300,13,0.12069,0.173157,326,0,0
8578822,"Wilen bei Wil, Scheidweg",,0.000027,20,1,1,2,27650,27650,55300,12,0.132353,0.18491,190,0,0
8578824,"Wil SG, Wilenstrasse",,0.000047,20,2,1,3,28131,28131,56262,10,0.165563,0.221095,268,0,0
8578828,"Malvaglia, Orino",,0.000026,108,1,1,2,12415,12415,24830,20,0.115917,0.155414,2205,0,0
8578829,"Dongio, Municipio",,0.000033,108,1,1,2,12415,12415,24830,19,0.129159,0.178436,2169,0,0
8578831,Grumo (Blenio),,0.000045,108,2,1,3,12558,12422,24980,17,0.101587,0.130061,2174,0,0
8578832,"Torre, alla Baracca",,0.00005,108,1,1,2,12422,12422,24844,16,0.111307,0.140801,2132,0,0
8578833,"Torre, Portera",,0.000053,108,1,1,2,12422,12422,24844,15,0.12326,0.154833,2088,0,0
8578834,"Dangio, Paese",,0.000056,108,1,1,2,12422,12422,24844,14,0.138322,0.174167,2042,0,0
8578835,"Aquila, Bivio Ponto-Aquilesco",,0.000058,108,1,1,2,12422,12422,24844,13,0.157895,0.203175,1994,0,0
8588132,"Dongio, Industrie",,0.000051,108,1,2,3,12415,12415,24830,2,0.666667,0.75,3997,0,0
8578838,Larescia,,0.000023,108,1,1,2,643,643,1286,10,0.181818,0.292897,1140,0,0
8578839,"Camperio, Pianezza",,0.000031,108,1,1,2,643,643,1286,9,0.2,0.31433,1035,0,0
8578840,"Camperio, Ospizio",,0.000037,108,1,1,2,643,643,1286,8,0.222222,0.339732,928,0,0
8578841,"Camperio, Alta",,0.000042,108,1,1,2,643,643,1286,7,0.25,0.370408,819,0,0
8578842,"Camperio, Piera",,0.000047,108,1,1,2,643,643,1286,6,0.285714,0.408333,708,0,0
8578843,"Camperio, Monte di Sacco",,0.000051,108,1,1,2,643,643,1286,5,0.333333,0.456667,595,0,0
8578844,"Campra, Bivio",,0.000054,108,1,1,2,643,643,1286,4,0.4,0.520833,480,0,0
8578845,"Campra, Centro nordico",,0.000057,108,1,1,2,643,643,1286,3,0.5,0.611111,363,0,0
8578847,Pian Segno,,0.000059,108,1,1,2,643,643,1286,2,0.666667,0.75,244,0,0
8578848,Alpe Casaccia,,0.000061,108,1,1,2,643,643,1286,1,1,1,123,0,0
8578849,"Olivone, Bivio Sommascona",,0.000023,108,1,1,2,4888,4888,9776,4,0.375,0.458333,456,0,0
8578851,"Ghirone, Aquilesco",,0.000046,108,2,3,5,5030,2994,8024,2,0.8,0.875,240,0,0
8591476,"Dangio, Chiesa",,0.000045,108,2,2,4,12511,12422,24933,2,0.75,0.833333,536.5,0,0
8591477,"Malvaglia, Filovia",,0.000052,108,2,2,4,12279,12415,24694,1,1,1,1507,0,0
8578854,"Corzoneso, Sasso Rorina",,0.000026,108,1,1,2,4890,4890,9780,9,0.2,0.31433,63,0,0
8578855,"Corzoneso, Paese",,0.000033,108,1,1,2,4890,4890,9780,8,0.222222,0.339732,64,0,0
8578856,"Corzoneso, Valasci",,0.000039,108,1,1,2,4890,4890,9780,7,0.25,0.370408,63,0,0
8578857,"Cumiasca, Campiroi",,0.000044,108,1,1,2,4890,4890,9780,6,0.285714,0.408333,60,0,0
8578858,"Cumiasca, Chiesa",,0.000048,108,1,1,2,4890,4890,9780,5,0.333333,0.456667,55,0,0
8578859,"Leontica, Combrescherio",,0.000052,108,1,1,2,4890,4890,9780,4,0.4,0.520833,48,0,0
8578860,"Comprovasco, Piazza",,0.000026,108,1,1,2,5362,5362,10724,7,0.25,0.370408,49,0,0
8578861,"Comprovasco, Biv. per Leontica",,0.000033,108,1,1,2,5362,5362,10724,6,0.285714,0.408333,48,0,0
8578862,"Prugiasco, Valle",,0.000039,108,1,1,2,5362,5362,10724,5,0.333333,0.456667,45,0,0
8578863,"Prugiasco, Paese",,0.000044,108,1,1,2,5362,5362,10724,4,0.4,0.520833,40,0,0
8578864,"Castro, Molino",,0.000048,108,1,1,2,5362,5362,10724,3,0.5,0.611111,33,0,0
8578865,"Castro, Paese",,0.000052,108,1,1,2,5362,5362,10724,2,0.666667,0.75,24,0,0
8578866,Traversa (Marolta),,0.000055,108,1,1,2,5362,5362,10724,1,1,1,13,0,0
8578868,"Mendrisio, Ospedale (OBV)",,0.000089,99,6,1,7,72034,71853,143887,12,0.176471,0.218277,1596.219048,0,0
8578874,"Melano, Piazza",,0.000069,99,1,1,2,16935,6771,23706,12,0.160878,0.199239,1408,0,0
8578876,"Riva S. Vitale, Piazza",,0.000036,99,1,1,2,8039,8039,16078,13,0.13,0.189411,312,0,0
8578879,"Brusino Arsizio, Funivia",,0.000041,99,1,1,2,8039,8039,16078,12,0.143678,0.206782,271,0,0
8578880,"Brusino Arsizio, Confine",,0.000046,99,1,1,2,8039,8039,16078,11,0.161074,0.233169,228,0,0
8578942,"Minusio, Mappo",,0.000088,101,3,2,5,58709,60139,118848,30,0.102252,0.132477,2624.25,0,0
8578938,"Muralto, Croce Bianca",,0.000046,101,2,2,4,29695,27710,57405,31,0.093192,0.116971,331.583333,0,0
8578904,"Cevio, Centro Scolastico",,0.000054,101,2,1,3,17387,17582,34969,13,0.169811,0.198072,405,0,0
8578921,"Brissago, Piazza del Sole",,0.000046,101,1,1,2,13747,13747,27494,13,0.169811,0.198072,405,0,0
8578987,"Brione s. Minusio, Chiesa",,0.000121,101,2,2,4,40965,40965,81930,13,0.172794,0.207019,3847,0,0
8578988,"Brione s. Minusio, Cimitero",,0.000062,101,1,2,3,23647,23842,47489,13,0.17284,0.207307,892,0,0
8580031,"Contra, Costa",,0.00009,101,2,2,4,17797,17478,35275,13,0.178336,0.214688,828,0,0
8580984,"Tenero, Stella d'Oro",,0.000087,101,2,2,4,60139,60139,120278,13,0.172285,0.207051,11767.7,0,0
8580988,"Minusio, Via Borenco",,0.000055,101,1,1,2,18085,18085,36170,13,0.169811,0.198072,270,0,0
8578888,"Avegno, di Fuori",,0.000036,101,1,2,3,17582,17582,35164,15,0.129093,0.151413,531,0,0
8578895,"Maggia, Ospedale",,0.000026,101,1,2,3,8792,8792,17584,14,0.146996,0.172663,156.5,0,0
8578894,"Naters, Massegga",,0.000044,40,1,1,2,8835,8835,17670,9,0.20339,0.289914,312,0,0
8578900,"Riveo, Chiesa",,0.000037,101,2,1,3,12377,12182,24559,14,0.146079,0.166579,156.5,0,0
8578896,"Mörel, Schulhaus",,0.000011,40,0,1,1,0,218,218,7,0.277778,0.375952,0,0,0
8579340,"Naters, Amerika",,0.000052,40,1,1,2,8835,8835,17670,7,0.277778,0.375952,280,0,0
8582445,"Bitsch, Chavez",,0.000036,40,1,2,3,8836,9691,18527,7,0.297297,0.432684,102,0,0
8582447,"Bitsch, Baletscha",,0.000026,40,1,1,2,855,1934,2789,7,0.277778,0.375952,0,0,0
8578898,"Ausserbinn, Hubel",,0.000044,16,2,2,4,1789,1789,3578,4,0.444444,0.552083,25,0,0
8579363,"Ernen, Z'Brigg",,0.000039,16,1,2,3,2827,2827,5654,1,1,1,8,0,0
8578901,"Naters, Fiischter-Fäld",,0.000048,40,1,1,2,8835,8835,17670,8,0.234043,0.322835,297,0,0
8580637,"Mägenwil, Gemeindehaus",,0.000044,22,1,2,3,7391,7274,14665,21,0.140923,0.170757,1349.439456,0,0.000101
8580730,"Birmenstorf AG, Chrüz",,0.000053,22,4,2,6,19145,19145,38290,23,0.067922,0.08663,400.794678,0.000479,0.000124
8590165,"Baden, Baldegg",,0.000026,22,1,1,2,4864,9817,14681,26,0.05656,0.065663,0,0.000128,0.00002
8590179,"Baden, Liebenfels",,0.000046,22,1,3,4,11860,11860,23720,19,0.089869,0.122507,1194.564286,0,0.000133
8590190,"Baden, Bahnhof Ost",,0.000146,22,9,6,15,39240,39240,78480,20,0.083232,0.118345,5070.019366,0.000322,0.000163
8590191,"Baden, Schadenmühle",,0.000095,22,4,4,8,28090,28090,56180,20,0.083028,0.115536,1730.399544,0.000045,0.000137
8590194,"Baden, Spitalmatt",,0.000037,22,2,1,3,4603,2213,6816,20,0.082142,0.106713,0,0.000067,0.000109
8578917,"Brissago, Miralago",,0.00003,101,1,1,2,13747,13747,27494,16,0.114428,0.129596,528,0,0
8578918,"Brissago, Clinica Hildebrand",,0.000036,101,1,1,2,13747,13747,27494,15,0.128277,0.145219,489,0,0
8578919,"Brissago, Municipio",,0.000042,101,1,1,2,13747,13747,27494,14,0.146079,0.166579,448,0,0
8578920,"Klus, Bahnhof",,0.000044,94,1,1,2,3787,3787,7574,1,1,1,118,0,0
8578941,"Minusio, Paradiso di Vacanze",,0.000049,101,2,1,3,17515,18085,35600,31,0.09298,0.114741,328.583333,0,0
8578929,Münsingen Traube,,0.000027,100,3,3,6,18013,18002,36015,9,0.185185,0.270873,172,0,0
8578930,Münsingen Krankenhausweg,,0.000019,100,1,1,2,9400,9400,18800,9,0.165714,0.2091,0,0,0
8578931,"Gruppaldo, Bivio",,0.000036,101,2,1,3,9753,9753,19506,15,0.131256,0.152402,562,0,0
8578932,Münsingen Spital,,0.000034,100,2,1,3,11330,9400,20730,8,0.191781,0.23682,116,0,0
8578933,"Ronco s. Ascona, Cimitero",,0.000041,101,1,2,3,9753,9753,19506,14,0.15,0.180329,521,0,0
8578934,"Ronco s. Ascona,Via Barcone",,0.000029,101,1,1,2,4888,4888,9776,14,0.149075,0.174346,0,0,0
8578935,Münsingen Höheacker,,0.00004,100,1,1,2,9400,9400,18800,7,0.228814,0.28157,121,0,0
8580991,"Locarno, Centro",,0.000113,101,1,10,11,174173,170206,344379,11,0.244936,0.328972,26522.605952,0,0
8581378,"Losone, Scuola Media",,0.000047,101,3,1,4,1027,601,1628,7,0.236364,0.321978,48.492857,0,0
8580983,"Gordola, Municipio",,0.000091,101,1,2,3,29654,29654,59308,14,0.156532,0.189012,14693.4,0,0
8578952,Rosenweg,,0.000019,100,1,1,2,6672,6672,13344,3,0.5,0.583333,56,0,0
8579074,Schützenhaus,,0.00003,100,1,1,2,5657,5656,11313,3,0.5,0.583333,8,0,0
8578954,PZM,,0.000019,100,1,1,2,3728,3728,7456,9,0.170455,0.245608,12,0,0
8578957,"Muralto, Casa S. Agnese",,0.00003,101,1,2,3,23139,23649,46788,19,0.090169,0.113029,3099.5,0,0
8578958,"Minusio, Bivio via Frizzi",,0.000023,101,1,1,2,17318,17318,34636,18,0.095052,0.108695,1984,0,0
8578959,"Minusio, S. Martino",,0.000031,101,1,1,2,17318,17318,34636,17,0.104317,0.118573,1952,0,0
8578960,"Minusio, Via ai Colli",,0.000037,101,1,1,2,17318,17318,34636,16,0.115663,0.13111,1918,0,0
8578961,"Minusio, ai Foll",,0.000042,101,1,1,2,17318,17318,34636,15,0.129882,0.147643,1882,0,0
8578962,"Brione s. Minusio, Albaredo",,0.000047,101,1,1,2,17318,17318,34636,14,0.148225,0.170758,1844,0,0
8578985,"Orselina, Chiesa",,0.000082,101,1,1,2,23647,23647,47294,14,0.148225,0.170758,1916,0,0
8578963,Aarweg,,0.000041,100,2,1,3,7460,7460,14920,7,0.220339,0.292491,50,0,0
8578964,"Brione s. Minusio, Carmelo",,0.000023,101,1,1,2,6331,6331,12662,21,0.075253,0.088484,916.5,0,0
8578965,Stierenmatte,,0.000046,100,1,1,2,7460,7460,14920,6,0.26087,0.331944,48,0,0
8578966,"Brione s. Minusio, ai Fanghi",,0.000031,101,1,1,2,6331,6331,12662,20,0.08083,0.094065,887.5,0,0
8578968,Brückreuti,,0.000061,100,2,3,5,14919,14919,29838,4,0.434783,0.566667,170,0,0
8578969,"Contra, Diga",,0.000037,101,1,1,2,6331,6331,12662,19,0.087344,0.100692,856.5,0,0
8578970,Allmendweg,,0.000028,100,1,1,2,7459,7459,14918,3,0.454545,0.533333,90,0,0
8578971,"Mergoscia, Bivio per Rivapiana",,0.000042,101,1,1,2,6331,6331,12662,18,0.095052,0.108695,823.5,0,0
8578972,"Mergoscia, Busada",,0.000047,101,1,1,2,6331,6331,12662,17,0.104317,0.118573,788.5,0,0
8578981,"Orselina, Stazione Funivia",,0.000042,101,1,1,2,17316,17316,34632,17,0.104317,0.118573,1120.5,0,0
8578973,Erlenau,,0.000035,100,1,2,3,7459,7459,14918,2,0.666667,0.75,76,0,0
8578976,"Locarno, Villa India",,0.000072,101,2,1,3,17493,17493,34986,21,0.077726,0.094287,1324.5,0,0
8578977,"Locarno, Paradiso",,0.000072,101,1,1,2,17493,17493,34986,20,0.08371,0.101854,1294.5,0,0
8578978,"Locarno, Casa Bianca",,0.000072,101,1,1,2,17493,17493,34986,19,0.090741,0.111927,1262.5,0,0
8578979,"Locarno, Pensione Olanda",,0.000072,101,1,2,3,17493,17493,34986,18,0.099117,0.127661,1228.5,0,0
8580990,"Locarno, Debarcadero",,0.000359,101,11,3,14,185543,184050,369593,12,0.20303,0.252162,31506.605952,0,0
8587501,"Locarno, Residenza Lido",,0.00002,101,1,3,4,18257,18288,36545,6,0.317073,0.460256,435.25,0,0
8578980,Zelgweg,,0.000026,100,1,1,2,2958,540,3498,1,1,1,20,0,0
8578983,"Orselina, Clinica S. Croce",,0.000086,101,2,1,3,23647,23647,47294,16,0.115663,0.13111,2010,0,0
8578984,"Orselina, Case di Sotto",,0.000084,101,1,1,2,23647,23647,47294,15,0.129882,0.147643,1964,0,0
8578989,"Muralto, Lorio",,0.000037,101,1,1,2,6526,6331,12857,17,0.10635,0.121123,698,0,0
8578990,"Orselina, ai Gerbi",,0.000043,101,1,1,2,6331,6331,12662,16,0.118151,0.134194,637,0,0
8578991,"Orselina, Clinica Varini",,0.000047,101,1,1,2,6331,6331,12662,15,0.13301,0.151536,574,0,0
8578993,Lugaggia,,0.000046,102,4,1,5,20785,21459,42244,14,0.1448,0.160846,1256.625,0,0
8578995,"Canobbio, Cioss",,0.000077,102,5,1,6,55376,55545,110921,14,0.162385,0.18838,2152.609055,0,0
8578997,"Lugano, Gerra",,0.000056,102,2,6,8,58317,113068,171385,12,0.214724,0.267281,1628.512088,0,0
8579001,"Lugano, Piazza Molino Nuovo",,0.000019,102,1,2,3,32167,32167,64334,13,0.173,0.202984,0,0,0
8591603,"Lugano, Centro",,0.000527,102,18,14,32,388690,357027,745717,8,0.346939,0.462171,22518.689286,0,0
8591610,"Lugano, Resega",,0.000143,102,5,3,8,110751,110709,221460,12,0.195402,0.266895,1162.472222,0,0
8591611,"Lugano, Ronchetto",,0.000061,102,2,1,3,35606,35846,71452,12,0.192529,0.24849,25,0,0
8591615,"Lugano, Scuole Molino Nuovo 2",,0.000051,102,1,1,2,22814,22814,45628,12,0.192529,0.24849,0,0,0
8579003,"Sureggio, al Loco",,0.000069,102,5,1,6,17623,21459,39082,13,0.186754,0.218884,405.790293,0,0
8579019,"Lugano, Sacro Cuore",,0.000035,102,2,2,4,47491,47491,94982,12,0.201354,0.242551,42.361111,0,0
8579616,Crêt Jura,,0.000042,48,3,1,4,16798,16802,33600,19,0.120433,0.148273,3996.361905,0,0
8579720,Morgarten,,0.000049,134,4,2,6,49508,49029,98537,11,0.183486,0.231366,12346.290645,0,0
8579722,Notre-Dame,,0.000037,134,2,3,5,60944,81987,142931,11,0.183767,0.235533,9162.588264,0,0
8579018,"Lugano, Campus Universitario",,0.000075,102,3,5,8,111705,111238,222943,11,0.219643,0.281359,1335.271429,0,0
8581597,"Lugano, Studio Radio",,0.000037,102,2,3,5,61374,61374,122748,10,0.234592,0.281965,2860.836364,0,0
8581644,"Paradiso, Stazione/Scuole",,0.000125,102,5,5,10,104080,105483,209563,11,0.251984,0.320491,4577.925566,0,0
8588107,"Lugano, Cimitero",,0.000067,102,4,3,7,77222,77222,154444,11,0.209964,0.257627,4378.788889,0,0
8587432,"Lugano, Piazza Manzoni",,0.000126,102,4,3,7,87697,88165,175862,9,0.271709,0.327643,3003.348052,0,0
8588108,"Lugano, Via Ginevra",,0.00008,102,5,6,11,118534,118534,237068,10,0.257709,0.327947,3940.27381,0,0
8588970,"Castagnola, Tamporiva",,0.000034,102,2,1,3,24456,24456,48912,13,0.136646,0.155408,220,0,0
8581654,"Paradiso, Riva Paradiso",,0.000087,102,4,4,8,48915,46022,94937,9,0.269542,0.327313,2266.778497,0,0
8583592,"Piodella, Mondino",,0.000052,102,2,1,3,6102,6284,12386,9,0.259819,0.304628,212.122727,0,0
8588902,"Davesco, Ponte di Valle",,0.000071,102,3,3,6,6813,6813,13626,10,0.248352,0.303715,1475.749603,0,0
8589075,"Gandria, Paese",,0.00003,102,1,1,2,6615,6615,13230,9,0.259819,0.304628,688,0,0
8591507,"Sonvico, Scuole",,0.000085,102,1,1,2,19966,19471,39437,9,0.259819,0.304628,644.45,0,0
8591573,"Bissone, Arco di Campione",,0.000047,102,1,2,3,9616,9983,19599,9,0.263473,0.31475,544,0,0
8591575,"Campione, Via Tagliaferri",,0.000037,102,1,1,2,5000,5000,10000,9,0.259819,0.304628,86,0,0
8591586,"Aldesago, Via Rava",,0.000055,102,1,2,3,17813,17841,35654,9,0.263473,0.31475,1164,0,0
8591588,"Brè, S. Antonio",,0.00004,102,1,1,2,13909,13909,27818,9,0.259819,0.304628,86,0,0
8591599,"Lugano, ai Frati",,0.000141,102,5,3,8,180143,180143,360286,9,0.265672,0.32245,2293.611111,0,0
8591602,"Lugano, Cassarina",,0.000067,102,1,1,2,36121,36121,72242,9,0.259819,0.304628,86,0,0
8579010,Villa Luganese,,0.000049,102,4,3,7,25030,24563,49593,12,0.169089,0.2098,1744.65,0,0
8579016,"Sonvico, S. Nicolao",,0.000038,102,1,1,2,19471,20433,39904,12,0.163827,0.189578,250,0,0
8591616,"Lugano, Stadio",,0.000236,102,7,9,16,153369,151131,304500,11,0.234875,0.355153,8779.070491,0,0
8579011,Sägematt,,0.000028,100,1,1,2,3732,3732,7464,1,1,1,18,0,0
8579012,Ligaino,,0.000025,102,1,1,2,19966,20433,40399,14,0.125,0.141865,424,0,0
8579015,"Sonvico, Opera Charitas",,0.000032,102,1,1,2,20433,19471,39904,13,0.141732,0.161407,338,0,0
8580976,"Bioggio, Pianoni",,0.000077,102,1,2,3,22904,15246,38150,11,0.189935,0.226866,2066.833333,0,0
8588903,"Canobbio, Mercato Resega",,0.00007,102,4,3,7,59642,59642,119284,10,0.229508,0.27692,2229.236111,0,0
8579029,"Bissone, Autostrada",,0.000067,102,2,5,7,19156,19418,38574,13,0.176471,0.224691,1686.511966,0,0
8579032,"Campione, Casinò",,0.000041,102,2,2,4,9983,9893,19876,13,0.174084,0.209273,133,0,0
8581655,"Paradiso, Piscina",,0.000053,102,2,1,3,9681,9981,19662,10,0.215385,0.245023,74.191667,0,0
8579031,"Campione, Via Totone",,0.000022,102,1,1,2,5000,5000,10000,14,0.14922,0.172279,0,0,0
8580238,"Vico Morcote, Chiesa",,0.000044,102,1,2,3,5967,5967,11934,14,0.166033,0.197765,920,0,0
8579034,"Choëx, Combasse",,0.00004,103,1,1,2,545,545,1090,16,0.100917,0.148579,312,0,0
8579035,"Choëx, Bercla",,0.000045,103,1,1,2,545,545,1090,15,0.108844,0.155983,305,0,0
8579036,"Choëx, Croix du Têt",,0.000049,103,1,1,2,545,545,1090,14,0.118321,0.164811,296,0,0
8579037,"Choëx, Fin de Choëx",,0.000053,103,1,1,2,545,545,1090,13,0.12987,0.175608,285,0,0
8579038,"Choëx, anc. poste",,0.000056,103,1,1,2,545,545,1090,12,0.144279,0.189246,272,0,0
8579039,"Choëx, Les Condémines",,0.000058,103,1,1,2,545,545,1090,11,0.162791,0.207215,257,0,0
8579043,"Choëx, Champmagnin",,0.00006,103,1,1,2,545,545,1090,10,0.1875,0.23229,240,0,0
8579044,"Choëx, Le Sépey",,0.000062,103,1,1,2,545,545,1090,9,0.222222,0.270345,221,0,0
8579375,"Collombey, église",,0.000072,103,2,2,4,5107,5107,10214,3,0.473684,0.555556,181,0,0
8582425,"Collombey, Les Perraires",,0.00014,103,2,2,4,5076,5078,10154,2,0.75,0.833333,181,0,0
8579054,"Troistorrents, La Tine",,0.000084,103,3,1,4,1009,620,1629,7,0.214286,0.291071,216,0,0
8579057,"Morgins, En Archoz",,0.000083,103,1,1,2,620,620,1240,6,0.25,0.322727,209,0,0
8579058,"Morgins, Bayèse",,0.000081,103,1,1,2,620,620,1240,5,0.30303,0.37,200,0,0
8579059,"Morgins, La Cergnat",,0.00008,103,1,1,2,620,620,1240,4,0.391304,0.453704,189,0,0
8579373,"Muraz (Collombey), Millière",,0.000048,103,1,1,2,4609,4609,9218,4,0.344828,0.408333,133,0,0
8579386,"Collombey, gare",,0.000109,103,2,3,5,5696,5076,10772,3,0.571429,0.666667,278,0,0
8579062,"Val-d'Illiez, gare",,0.000055,0,2,1,3,562,562,1124,4,0.384615,0.483333,30,0,0
8579063,"Val-d'Illiez, Les Châbles",,0.000058,0,1,1,2,562,562,1124,3,0.5,0.583333,28,0,0
8579064,"Val-d'Illiez, bif. Champoussin",,0.00006,0,1,2,3,562,562,1124,2,0.75,0.833333,24,0,0
8579066,"Val-d'Illiez, Frâchette",,0.000036,0,1,1,2,235,235,470,1,1,1,9,0,0
8579068,Bärenmatte,,0.000031,100,2,2,4,6545,6553,13098,4,0.4375,0.559524,75,0,0
8579069,Bärenstutz,,0.000024,100,1,1,2,5657,5657,11314,4,0.4,0.486111,0,0,0
8579070,Juraweg,,0.000044,100,2,2,4,6553,6553,13106,3,0.555556,0.666667,51,0,0
8579084,Sonnhalde,,0.000052,100,2,2,4,12328,6672,19000,2,0.75,0.833333,45,0,0
8580415,"Richigen, Graben",,0.000073,100,2,1,3,4441,4441,8882,2,0.666667,0.75,24,0,0
8581791,"Rubigen, Wydenhof",,0.000024,100,1,1,2,3196,3196,6392,2,0.666667,0.75,10,0,0
8581860,"Rüfenacht, Sperlisacher",,0.000042,100,1,1,2,2706,2706,5412,2,0.666667,0.75,8,0,0
8579071,"L'Auberson, Vers-le-Bois",,0.00003,35,1,1,2,5854,5854,11708,7,0.210526,0.274702,132,0,0
8579075,"L'Auberson, musée",,0.000037,35,1,1,2,5854,5854,11708,6,0.25,0.317778,81,0,0
8579079,"Allaman, gare",,0.000106,32,4,2,6,16202,16202,32404,9,0.253165,0.355615,504,0,0
8579080,"Aubonne, Roveray",,0.000056,32,1,1,2,11640,11640,23280,8,0.26,0.356502,250,0,0
8579082,"Montherod, Battoir",,0.000027,32,1,1,2,8239,8239,16478,9,0.22,0.332937,0,0,0
8579086,"Gimel, La Vernette",,0.000061,32,2,2,4,7624,4096,11720,7,0.275862,0.449107,298,0,0
8579091,"Vallorbe, Les Jurats",,0.000083,35,3,2,5,9159,9215,18374,11,0.19883,0.282762,8098.5,0,0
8579095,"Ballaigues, poste",,0.000039,35,2,2,4,6692,6692,13384,8,0.224638,0.301767,2447.333333,0,0
8579092,"Vallorbe, Les Pontets",,0.000046,35,1,2,3,5990,5970,11960,10,0.202454,0.274772,3401.333333,0,0
8579293,"Vallorbe, gare",,0.000074,35,3,3,6,7707,7707,15414,7,0.287671,0.394898,4313.5,0,0
8579907,"Ballaigues, cure",,0.00006,35,2,2,4,5705,5704,11409,8,0.22619,0.315476,317,0,0
8579908,"Ballaigues, collège",,0.000036,35,1,1,2,405,405,810,8,0.216867,0.277447,0,0,0
8579097,"Lignerolle, Le Daillard",,0.000037,35,2,1,3,5318,5318,10636,10,0.162921,0.206185,1846,0,0
8579099,"Lignerolle, église",,0.000049,35,2,1,3,5345,5345,10690,8,0.22314,0.272619,1384.5,0,0
8579100,"Les Clées-La Russille, croisée",,0.000053,35,1,2,3,5345,5345,10690,7,0.276596,0.350366,1125.5,0,0
8579102,Sergey,,0.000013,35,1,1,2,2006,2001,4007,8,0.220339,0.271566,120.666667,0,0
8579103,"Montcherand, poste",,0.000045,35,2,2,4,6150,6155,12305,7,0.271739,0.347714,895.666667,0,0
8579110,"Baulmes, gare",,0.00003,35,1,1,2,1941,1941,3882,7,0.263736,0.320536,0,0,0
8579105,"Vogorno, di Dentro",,0.000082,101,2,1,3,8355,8355,16710,14,0.131579,0.208437,2002.166667,0,0
8579113,"Bönigen, Sand",,0.000046,43,3,1,4,3433,3433,6866,15,0.126615,0.183393,419,0,0
8579114,"Villars-sur-Ollon, gare",,0.000033,103,1,1,2,1734,1734,3468,6,0.285714,0.408333,216,0,0
8579127,"Chesières, Aiglon Collège",,0.000039,103,1,1,2,1734,1734,3468,5,0.333333,0.456667,185,0,0
8579128,"Chesières, Hôtel du Soleil",,0.000044,103,1,1,2,1734,1734,3468,4,0.4,0.520833,152,0,0
8579129,"Chesières, La Palette",,0.000048,103,1,1,2,1734,1734,3468,3,0.5,0.611111,117,0,0
8579130,"Chesières, cimetière",,0.000052,103,1,1,2,1734,1734,3468,2,0.666667,0.75,80,0,0
8579131,"Huémoz, Bellevue",,0.000055,103,1,1,2,1734,1734,3468,1,1,1,41,0,0
8579177,"Unterseen, Dorf",,0.00003,43,1,1,2,389,389,778,4,0.4,0.520833,33.333333,0,0
8583218,"Interlaken, Mittleres Moos",,0.00009,43,5,1,6,10174,4094,14268,4,0.4,0.520833,363,0,0
8579174,"Vevey, gare",,0.00003,12,1,1,2,7623,7623,15246,6,0.285714,0.408333,17,0,0
8579178,"Waldenburg, Bürgerschopf",,0.000043,2,1,1,2,7255,71,7326,1,1,1,84,0,0
8579179,"Chandolin, Les Litettes",,0.000049,39,1,1,2,2395,2468,4863,3,0.5,0.611111,30,0,0
8579180,"Vouvry, Riond Vert",,0.000043,103,1,1,2,1147,1147,2294,3,0.5,0.611111,72,0,0
8581573,"Wädenswil, Hallenbad/Frohmatt",,0.000054,63,2,3,5,12105,12008,24113,11,0.184343,0.258595,901.333333,0,0
8579184,"Mts-de-Corsier, Petit Hautigny",,0.000062,12,2,1,3,9736,9738,19474,4,0.4,0.520833,76,0,0
8579185,"Villeneuve VD, Eau-Froide",,0.000096,103,3,3,6,7584,7583,15167,7,0.279412,0.398747,1024,0,0
8580410,"Monthey, home les Tilleuls",,0.000064,103,1,1,2,2238,2115,4353,5,0.315789,0.422222,6,0,0
8579186,"Oberrieden, Bahnhof",,0.000012,63,1,1,2,2165,2165,4330,16,0.097054,0.131191,21,0,0
8579187,"Monts-de-Corsier, Mur-Blanc",,0.000063,12,1,1,2,9738,9738,19476,3,0.5,0.611111,60,0,0
8579188,"Oberrieden, Seehalde",,0.000021,63,1,1,2,2165,2165,4330,15,0.105566,0.141897,69,0,0
8579189,"Horgen, Scheller",,0.000029,63,1,1,2,2165,2165,4330,14,0.11588,0.157071,115,0,0
8579192,"Horgen, Spital",,0.000027,63,2,2,4,8482,8491,16973,12,0.144044,0.204458,252.876623,0,0
8590660,"Horgen, Schinzenhof",,0.000033,63,1,3,4,4752,4755,9507,3,0.625,0.766667,73,0,0
8590877,"Wädenswil, Weinrebe",,0.000069,63,1,2,3,21953,11076,33029,2,0.75,0.833333,111.666667,0,0
8579222,"Mont-sur-Rolle, Mont-Dessus",,0.000037,32,1,1,2,3989,3989,7978,6,0.285714,0.408333,206,0,0
8579223,"Mont-sur-Rolle, La Ferme",,0.000042,32,1,1,2,3989,3989,7978,5,0.333333,0.456667,161,0,0
8579224,"Mont-sur-Rolle,Maison de Ville",,0.000047,32,1,1,2,3989,3989,7978,4,0.4,0.520833,114,0,0
8579228,"Bürgenstock, Ost",,0.000042,62,2,1,3,3381,2388,5769,5,0.333333,0.456667,156,0,0
8579234,"Ecublens VD, EPFL Piccard",,0.000023,5,1,2,3,16464,16465,32929,17,0.125733,0.16759,193,0,0
8592227,"St-Sulpice VD, Pâqueret",,0.000073,5,2,2,4,67530,67542,135072,10,0.176136,0.221057,14144.166667,0,0
8592239,"Denges, La Pale",,0.000051,5,2,1,3,16035,16035,32070,10,0.165605,0.198184,544.333333,0,0
8579231,"St-Sulpice VD, Venoge sud",,0.000031,5,2,1,3,50287,49616,99903,23,0.093294,0.105229,6634.5,0,0
8579233,"Ecublens VD, EPFL (bus)",,0.000015,5,1,1,2,15740,16464,32204,18,0.112204,0.140372,59,0,0
8588872,"Denges, Les Oches",,0.000025,5,2,1,3,16035,16035,32070,17,0.125163,0.163255,2955,0,0
8588874,"Echandens, poste",,0.000022,5,1,1,2,34620,34620,69240,17,0.125163,0.163255,3078,0,0
8579245,"Lausanne, Le Foyer",,0.000032,10,2,4,6,81606,81679,163285,19,0.116319,0.148779,63757.448296,0,0
8579240,"Montpreveyres, Balances",,0.00002,13,1,2,3,3223,3027,6250,20,0.110532,0.139357,57795.045554,0,0
8581429,"Servion, Grange Rouge",,0.000123,10,3,3,6,9846,6265,16111,8,0.242038,0.319831,12449.697619,0,0
8583395,"Villars-Tiercelin, La Sapelle",,0.000056,13,1,1,2,4067,4067,8134,13,0.180952,0.236601,7350.420757,0,0
8587546,"Epalinges, Lion d'Or",,0.000112,13,4,2,6,20451,20134,40585,12,0.215116,0.300795,16740.718376,0,0
8587548,"Lausanne, Vers-chez-les-Blanc",,0.000028,13,1,2,3,32791,32785,65576,13,0.179612,0.2475,37,0,0
8579242,"Obbürgen, Moos",,0.000047,62,1,1,2,2388,2388,4776,4,0.4,0.520833,121,0,0
8579244,"Obbürgen, Abzw. Trogen",,0.00005,62,1,1,2,2388,2388,4776,3,0.5,0.611111,84,0,0
8579256,"Pully, Val-Vert",,0.000021,10,1,3,4,57317,113755,171072,17,0.127187,0.156395,23322.32215,0,0
8579246,"Lausanne, Rovéréaz",,0.000018,10,1,1,2,5847,5847,11694,13,0.118785,0.153703,1336.933333,0,0
8579247,"Montblesson, Centenaire",,0.000026,10,1,1,2,5847,5847,11694,12,0.131661,0.166546,1051.933333,0,0
8579248,"Pully, Trois-Chasseurs",,0.000033,10,1,1,2,5847,5847,11694,11,0.148014,0.183615,764.933333,0,0
8579250,"Mollie-Margot, centre",,0.000058,10,2,1,3,5923,6155,12078,9,0.19898,0.245492,333.2,0,0
8580690,"Maracon, La Crosettaz",,0.000049,10,3,1,4,3062,2397,5459,9,0.19898,0.245492,175.5,0,0
8588442,"Pully, Osches",,0.000029,10,1,2,3,34340,34335,68675,16,0.135169,0.165471,1587.666667,0,0
8588443,"Pully, Préau",,0.000031,10,3,1,4,33351,54806,88157,16,0.134803,0.162846,0,0,0
8588436,"Belmont-sur-L., Grands Champs",,0.000041,10,1,3,4,34342,61498,95840,20,0.110354,0.142332,1855.676382,0,0
8588446,"Pully, Clergère",,0.000036,10,3,3,6,110603,110412,221015,17,0.133498,0.167141,6805.477787,0,0
8588983,"Renens VD, gare sud",,0.000096,5,5,4,9,125132,127792,252924,18,0.139018,0.179154,33764.186076,0,0
8591981,"Lausanne, avenue du Léman",,0.000024,10,2,2,4,87657,87656,175313,16,0.14826,0.184438,1099.490529,0,0
8579255,"Lausanne, Pont-de-Chailly",,0.000023,10,2,2,4,90677,90685,181362,18,0.114185,0.137147,24935.32215,0,0
8588432,"Lausanne, Chailly-Village",,0.000021,10,1,1,2,57318,57320,114638,17,0.125938,0.149982,13824.05,0,0
8579257,"Belmont-sur-L., centre",,0.000017,10,1,1,2,34335,34345,68680,24,0.077825,0.090831,8820,0,0
8579258,"Belmont-sur-Lausanne,Blessoney",,0.000025,10,1,1,2,34345,34344,68689,23,0.084149,0.099826,8835,0,0
8579259,"Lutry, Landar",,0.000032,10,1,2,3,34344,52182,86526,22,0.091613,0.112317,8848,0,0
8579260,"Lutry, Croix/Lutry",,0.000025,10,1,2,3,34731,34730,69461,21,0.097187,0.120034,6737.480952,0,0
8579264,"Saanen, Steigenberger",,0.000033,42,1,1,2,2561,2561,5122,10,0.189394,0.251302,52,0,0
8579267,"Saanen, Oberdorf",,0.000112,42,5,3,8,5591,5065,10656,8,0.26506,0.378084,558,0,0
8581187,"Gstaad, Sportzentrum",,0.000201,42,5,3,8,8669,8679,17348,8,0.27451,0.434609,502,0,0
8581189,"Gstaad, Ober-Gstaad",,0.000068,42,1,1,2,4996,5000,9996,8,0.219512,0.324206,0,0,0
8581359,"Saanen, Gemeindeverwaltung",,0.000118,42,2,1,3,2561,2453,5014,8,0.219512,0.324206,27,0,0
8579268,"Saanen, Schwimmbad",,0.000043,42,1,1,2,4508,5469,9977,10,0.21,0.281992,160,0,0
8579269,"Saanen, Wyssmülleri",,0.000047,42,1,2,3,5469,5469,10938,9,0.253165,0.362282,150,0,0
8579273,"Jonschwil, Steinacker",,0.00007,20,2,1,3,14666,14759,29425,5,0.333333,0.436111,579,0,0
8579275,"Schwarzenbach SG, Kapelle",,0.00007,20,1,1,2,14759,14666,29425,4,0.416667,0.516667,393,0,0
8579279,"Lenk im Simmental, Bahnhof",,0.00015,23,4,8,12,14149,17664,31813,10,0.280374,0.48541,660,0,0
8589114,"Lenk, Aegerten",,0.000027,23,1,1,2,1095,1210,2305,10,0.19,0.261174,0,0,0
8589118,"Lenk, Marktplatz",,0.000053,23,1,3,4,1965,1964,3929,8,0.269841,0.417227,137.5,0,0
8589119,"Lenk, Talstation Betelberg",,0.000042,23,2,2,4,2524,2650,5174,10,0.205128,0.340352,6,0,0
8589120,"Lenk, Tennisplatz",,0.000045,23,2,2,4,7417,7217,14634,10,0.197368,0.329709,27,0,0
8595619,"Lenk, Guggernäll",,0.000034,23,1,1,2,1583,1583,3166,5,0.333333,0.456667,5,0,0
8579281,"Unterseen, Stadtfeld",,0.000048,43,2,2,4,6567,6445,13012,16,0.098795,0.164753,458,0,0
8579283,"Unterseen, Camping Jungfrau",,0.000031,43,1,1,2,3221,3221,6442,16,0.096618,0.143872,0,0,0
8579286,"Ste-Croix, rue des Rasses",,0.00008,35,3,1,4,6483,6483,12966,5,0.289474,0.365152,71.5,0,0
8579288,"Unterseen, Schulhaus Steindler",,0.000058,43,2,1,3,6445,6445,12890,15,0.104278,0.154653,256,0,0
8579295,"Yverdon, Général-Guisan",,0.000034,35,1,2,3,15663,15664,31327,6,0.261905,0.340152,8100.07381,0,0
8579644,"Cortaillod, Cort'Agora",,0.000039,105,2,3,5,14217,13128,27345,19,0.116201,0.174498,4350.6,0,0
8594014,"Montagny-près-Yverdon, village",,0.000054,35,1,1,2,18797,18797,37594,8,0.214765,0.258147,128,0,0
8582051,"Yverdon-les-Bains, 14 Avril",,0.000034,35,2,3,5,35379,35379,70758,5,0.328125,0.419841,4352.514286,0,0
8579298,"Treycovagnes, Châtelard",,0.000034,35,1,2,3,10786,10620,21406,4,0.387097,0.472222,8565.333333,0,0
8579299,"Treycovagnes, Champ-Muraz",,0.000025,35,1,2,3,6387,6386,12773,5,0.322581,0.436667,2892,0,0
8579301,"Chamblon, casernes",,0.000022,35,1,1,2,6255,6255,12510,5,0.3,0.374074,0,0,0
8579302,"Chamblon, réservoir",,0.00004,35,2,1,3,6386,6387,12773,4,0.380952,0.447917,1462,0,0
8579303,"Chamblon, village-hôpital",,0.000045,35,1,2,3,6387,6385,12772,3,0.538462,0.619048,744,0,0
8579740,"Champvent, Croix fédérale",,0.00003,35,1,1,2,6254,6154,12408,3,0.5,0.555556,0,0,0
8582423,"Suscévaz, Au Coin",,0.000025,35,1,1,2,4233,4356,8589,3,0.5,0.555556,4239.333333,0,0
8594049,"Yverdon-les-Bains, Les Moulins",,0.000046,35,2,2,4,22956,23169,46125,3,0.533333,0.604167,310.957143,0,0
8594050,"Yverdon-les-Bains, Les Pins",,0.000044,35,2,2,4,23087,21564,44651,3,0.538462,0.619048,24.5,0,0
8594055,"Yverdon-les-Bains, Plaisance",,0.000044,35,2,1,3,12004,10349,22353,3,0.5,0.555556,22.5,0,0
8594061,"Yverdon-les-Bains, Blancherie",,0.000088,35,4,2,6,16946,15664,32610,4,0.444444,0.520833,210.333333,0,0
8594062,"Yverdon-les-Bains,Maison Rouge",,0.000139,35,5,3,8,65577,48395,113972,3,0.52381,0.606061,2477.333333,0,0
8579305,"Nyon, CESSOUEST",,0.000018,125,1,1,2,28099,28099,56198,15,0.159292,0.240584,61.80303,0,0
8593880,"Nyon, chemin des Pensées",,0.000062,125,2,2,4,29297,21552,50849,5,0.35,0.442857,591.136364,0,0
8593882,"Nyon, chemin des Tines",,0.000044,125,1,2,3,28087,28084,56171,5,0.363636,0.461111,144.977273,0,0
8579308,"Eysins, est",,0.000046,125,2,2,4,10275,10289,20564,2,0.75,0.833333,72,0,0
8580603,"Chéserex, Au Courtillet",,0.00003,125,1,1,2,10198,10199,20397,2,0.666667,0.75,0,0,0
8579309,"Eysins, centre",,0.000018,125,1,1,2,10765,10764,21529,27,0.055099,0.071385,179.416667,0,0
8579310,Arnex-sur-Nyon,,0.000027,125,1,1,2,10764,10765,21529,26,0.058094,0.077376,427.416667,0,0
8579312,"Borex, centre",,0.000033,125,1,2,3,10765,10765,21530,25,0.061446,0.086711,673.416667,0,0
8588935,"Crassier, Levrioux",,0.000033,125,2,3,5,10366,10355,20721,5,0.347826,0.457292,163.666667,0,0
8579313,"Crassier, collège secondaire",,0.000025,125,1,1,2,10674,10674,21348,24,0.064745,0.085186,853.416667,0,0
8595597,"Nyon, Martavaux",,0.000116,125,3,2,5,38845,15849,54694,1,1,1,92.416667,0,0
8579316,Bogis-Bossey,,0.000043,125,3,1,4,10478,10479,20957,22,0.072981,0.097117,2280,0,0
8587707,"Chavannes-de-B., Champs-Blancs",,0.00002,125,1,2,3,10363,10364,20727,6,0.274194,0.363725,128.666667,0,0
8579322,"St. Niklaus VS, Biffig",,0.000011,6,0,1,1,0,276,276,7,0.253968,0.320387,0,0,0
8579920,"Herbriggen, Mattsand",,0.00004,6,1,1,2,276,276,552,3,0.428571,0.5,54,0,0
8579333,"Interlaken, Heimwehfluhbahn",,0.000071,43,2,1,3,6586,6588,13174,12,0.126761,0.181442,1885,0,0
8579337,"Matten b. I., Hotel Regina",,0.000041,43,1,1,2,6445,6445,12890,10,0.144737,0.201533,1639,0,0
8579339,"Matten b. I., Mattenstrasse",,0.000046,43,1,1,2,6445,6445,12890,9,0.161538,0.216818,1513,0,0
8579348,"Fiesch, Bahnhof",,0.000066,16,3,2,5,6033,6033,12066,2,0.625,0.7,42,0,0
8579354,"Mühlebach (Goms), Brücke",,0.00004,16,2,1,3,1544,1559,3103,2,0.666667,0.75,10,0,0
8580044,"Oberwald VS, Muttbach",,0.00007,108,3,1,4,384,193,577,2,0.666667,0.75,70,0,0
8579365,"Ausserbinn, Wengi",,0.000046,16,2,1,3,1789,1605,3394,1,1,1,9,0,0
8579367,"Fieschertal, Wichel",,0.000039,16,1,1,2,3206,3206,6412,1,1,1,13,0,0
8579369,"Vionnaz, Les Nayaz",,0.000038,103,1,1,2,4609,4609,9218,6,0.230769,0.302778,257,0,0
8579371,"Vionnaz, Crébellay",,0.000043,103,1,1,2,4609,4609,9218,5,0.275,0.342424,196,0,0
8579377,"Matten b. I., Kesslergasse",,0.00005,43,1,1,2,6445,6445,12890,8,0.183486,0.236905,1385,0,0
8582056,"Vouvry, Le Culat",,0.000116,103,1,1,2,4609,4609,9218,3,0.5,0.583333,150,0,0
8579394,"Produit, bif.",,0.000034,39,1,1,2,2553,2553,5106,15,0.113333,0.203033,1007,0,0
8579395,Montagnon,,0.00004,39,1,1,2,2553,2553,5106,14,0.120301,0.212151,956,0,0
8579396,"Les Places, bif.",,0.000045,39,1,1,2,2553,2553,5106,13,0.128205,0.222265,903,0,0
8579397,Dugny,,0.000049,39,1,1,2,2553,2553,5106,12,0.137255,0.233563,848,0,0
8579398,"Morthey, En Rion",,0.000052,39,1,1,2,2553,2553,5106,11,0.147727,0.246284,791,0,0
8579399,"Morthey, Pont-de-Pierre",,0.000055,39,1,1,2,2553,2553,5106,10,0.16,0.260747,732,0,0
8579400,"Morthey, centre",,0.000058,39,1,1,2,2553,2553,5106,9,0.174603,0.277381,671,0,0
8579401,"Ovronnaz, Centre therm. Melley",,0.00006,39,1,1,2,2553,2553,5106,8,0.192308,0.296786,608,0,0
8579402,"Ovronnaz, croisée du centre",,0.000062,39,1,1,2,2553,2553,5106,7,0.214286,0.319841,543,0,0
8579403,"Ovronnaz, Plein soleil",,0.000064,39,1,1,2,2553,2553,5106,6,0.242424,0.347917,476,0,0
8579404,"Grône, coutoulaz",,0.000011,39,0,2,2,0,1649,1649,15,0.132597,0.227629,0,0,0
8579405,Itravers,,0.000016,39,1,1,2,1336,1336,2672,15,0.127778,0.194048,0,0,0
8579406,Loye,,0.000029,39,2,1,3,1649,1649,3298,14,0.140127,0.209288,44,0,0
8579407,"Erdesson, bif.",,0.000035,39,1,1,2,1649,1649,3298,13,0.155556,0.230592,63,0,0
8579414,"Noës, village",,0.000014,39,1,1,2,1480,1480,2960,17,0.126607,0.151414,758,0,0
8579416,"Granges VS, La Millière",,0.000023,39,1,1,2,1480,1480,2960,16,0.143828,0.176181,842,0,0
8579421,"Réchy, Grampraz",,0.000022,39,1,1,2,7184,7184,14368,19,0.107884,0.130434,181,0,0
8579424,"Walkringen, Zihlstrasse",,0.000059,100,1,1,2,4445,4445,8890,2,0.666667,0.75,32,0,0
8579428,"Grône, poste",,0.000033,39,1,1,2,7181,7184,14365,16,0.143828,0.176181,1591,0,0
8579434,"Wettswil a.A., Dettenbühl",,0.00004,85,1,1,2,1623,1610,3233,26,0.069871,0.075201,3768,0,0
8579440,"Wettswil a.A., Chilenholzstr.",,0.000045,85,1,1,2,1610,1624,3234,25,0.075013,0.080915,4137,0,0
8579442,"Wettswil a.A., Oberhusen",,0.000049,85,1,1,2,1624,1624,3248,24,0.080982,0.087682,4504,0,0
8579443,"Wettswil a.A., Eggächer",,0.000053,85,1,1,2,1624,1624,3248,23,0.087993,0.095835,4869,0,0
8579445,"Issert, Les Arlaches",,0.000055,104,2,1,3,1271,1271,2542,5,0.315789,0.377778,61,0,0
8579447,"Praz-de-Fort, Chalet Bérard",,0.000035,104,1,1,2,955,955,1910,6,0.232558,0.318333,30,0,0
8579448,"Praz-de-Fort, Branche d'en-Bas",,0.000041,104,1,1,2,955,955,1910,5,0.272727,0.353704,29,0,0
8579449,La Seiloz,,0.000046,104,1,1,2,955,955,1910,4,0.333333,0.40625,26,0,0
8579452,"Orsières, gare",,0.000133,104,4,3,7,3761,3801,7562,2,0.666667,0.75,120,0,0
8593537,"Champex, Le Signal",,0.000052,104,1,1,2,1424,1351,2775,2,0.666667,0.75,2,0,0
8579453,"Wettswil a.A., Heissächerstr.",,0.000056,85,1,1,2,1624,1624,3248,22,0.096346,0.105868,5232,0,0
8579454,"Sierre, Riondaz",,0.000027,39,2,1,3,12198,12198,24396,26,0.063675,0.086506,799,0,0
8579455,"Veyras, Fontanettes",,0.000034,39,1,1,2,12198,12198,24396,25,0.067653,0.094962,927,0,0
8579457,"Veyras, Signèse",,0.00003,39,2,1,3,15048,23771,38819,23,0.076675,0.111956,625.1,0,0
8587111,"Venthône, village",,0.000116,39,2,2,4,12198,12198,24396,2,0.666667,0.75,96.333333,0,0
8579459,"Venthône, Anchettes",,0.000036,39,2,2,4,9368,12198,21566,31,0.048793,0.07492,568.5,0,0
8587110,"Bluche, village",,0.000106,39,4,1,5,11945,11989,23934,3,0.454545,0.533333,217.833333,0,0
8579460,"Venthône, Rétana",,0.000026,39,1,1,2,11989,11989,23978,30,0.050269,0.06529,665,0,0
8579461,"Mollens VS, Panorama",,0.000033,39,1,1,2,11989,11989,23978,29,0.052646,0.068165,781,0,0
8579463,"Mollens VS, bif. Aminona",,0.000039,39,1,1,2,11989,11989,23978,28,0.055273,0.071461,895,0,0
8579464,"Randogne, La Côte",,0.000044,39,1,1,2,11989,11989,23978,27,0.058191,0.075293,1007,0,0
8579465,"Randogne, village",,0.000048,39,1,1,2,11989,11989,23978,26,0.061451,0.079822,1117,0,0
8579466,"Randogne, centre scolaire",,0.000052,39,1,1,2,11989,11989,23978,25,0.065116,0.08529,1225,0,0
8579467,"Montana, Pradouvan",,0.000055,39,1,1,2,11989,11989,23978,24,0.069269,0.092085,1331,0,0
8579470,"Montana, gare",,0.000141,39,5,2,7,29997,29248,59245,21,0.085866,0.132492,3469.166667,0,0
8579493,"Montana, Violettes",,0.000046,39,3,5,8,15230,16767,31997,6,0.409091,0.552778,1817.566667,0,0
8594710,"Montana, Centre Moubra",,0.000062,39,1,1,2,4625,4625,9250,2,0.6,0.666667,216,0,0
8579472,"Wettswil a.A., Strumbergächer",,0.000058,85,1,1,2,1624,1624,3248,21,0.106467,0.118561,5593,0,0
8579488,Les Briesses,,0.000059,39,1,1,2,8785,8785,17570,9,0.180723,0.221124,389,0,0
8579489,"Crans-s.-S., bif.Route du Golf",,0.000068,39,2,1,3,13084,13084,26168,8,0.213235,0.25587,405,0,0
8579492,"Montana, Victoria",,0.000018,39,1,1,2,2314,2314,4628,8,0.215909,0.280388,0,0,0
8579475,"Sierre, Hôpital",,0.000026,39,1,1,2,8086,8086,16172,6,0.295455,0.370513,95.066667,0,0
8594605,"Sierre, Notre-Dame-de-Lourdes",,0.000055,39,2,2,4,24622,24622,49244,6,0.298507,0.3825,1441.5,0,0
8594612,"Noës, Ecole",,0.000063,39,1,3,4,16534,16534,33068,6,0.351351,0.489744,2988,0,0
8579476,"Loc, bif.",,0.000039,39,3,2,5,8785,8785,17570,24,0.076392,0.09649,5501,0,0
8579477,Loc,,0.000027,39,1,1,2,3506,3506,7012,24,0.075967,0.091014,0,0,0
8579478,"Corin-de-la-Crête, village",,0.00005,39,2,1,3,8785,8785,17570,23,0.081714,0.097881,5571,0,0
8579479,"Corin-de-la-Crête, Corinna",,0.000054,39,1,1,2,8785,8785,17570,22,0.088443,0.106641,5603,0,0
8579480,"Ollon VS, bif.",,0.000057,39,1,2,3,8785,8785,17570,21,0.096429,0.119398,5633,0,0
8579481,"Ollon VS, village",,0.000035,39,1,1,2,5355,5355,10710,21,0.09589,0.113928,0,0,0
8579482,"Ollon VS, bif. Valençon",,0.000065,39,2,1,3,8785,8785,17570,20,0.105402,0.126528,5687,0,0
8579483,"Chermignon, Diogne",,0.000066,39,1,1,2,8785,8785,17570,19,0.117084,0.143868,5711,0,0
8579486,"Chermignon, Maze",,0.000054,39,2,1,3,8785,8785,17570,11,0.139738,0.180916,607,0,0
8579487,"Montana, bif. Centre Valaisan",,0.000056,39,1,1,2,8785,8785,17570,10,0.15736,0.197811,499,0,0
8579490,"Crans-s.-S., Vernaziet",,0.000076,39,2,1,3,22028,22028,44056,7,0.261682,0.314626,595.466667,0,0
8579494,Aminona,,0.000019,39,1,3,4,11452,11452,22904,6,0.382353,0.521795,359,0,0
8594699,"Crans-s.-S., Pirazilina",,0.000025,39,1,2,3,8944,8944,17888,6,0.354839,0.480303,11,0,0
8594702,"Crans-s.-S., Rive du Golf",,0.000038,39,1,2,3,4299,4299,8598,5,0.366667,0.472727,33,0,0
8594626,"Sierre, Longs-Prés",,0.000075,39,1,1,2,8086,8086,16172,1,1,1,243.066667,0,0
8594704,"Crans-s.-S., Sporting",,0.000067,39,5,3,8,10757,10757,21514,5,0.416667,0.561667,905.966667,0,0
8594709,"Montana, Clairière",,0.000046,39,3,3,6,11452,6988,18440,2,0.8,0.875,25.5,0,0
8594707,"Mollens VS, St-Maurice-Laques",,0.000124,39,2,2,4,9159,5981,15140,1,1,1,91.666667,0,0
8579495,"Wettswil a.A., Rehweid",,0.00006,85,1,1,2,1624,1624,3248,20,0.118983,0.135236,5952,0,0
8579500,"La Tzoumaz, télécabine",,0.000029,122,2,1,3,1842,1524,3366,13,0.137255,0.233646,28,0,0
8579501,"Isérables, téléphérique",,0.000036,122,1,1,2,1524,1524,3048,12,0.147727,0.246401,39,0,0
8579502,"Isérables, Auddes",,0.000041,122,1,1,2,1524,1524,3048,11,0.16,0.260916,48,0,0
8579505,"La Tzoumaz, Rosselin (bif.)",,0.000046,122,1,1,2,1524,1524,3048,10,0.174603,0.277633,55,0,0
8579506,"Riddes, Les Combes",,0.00005,122,1,1,2,1524,1524,3048,9,0.192308,0.297183,60,0,0
8579507,"La Tzoumaz, Som de Proz",,0.000053,122,1,1,2,1524,1524,3048,8,0.214286,0.320503,63,0,0
8582432,"Bramois, Est",,0.000081,39,1,1,2,2005,2006,4011,18,0.134069,0.176961,1334,0,0
8582452,"Sion, Casernes",,0.000219,39,5,4,9,17945,17945,35890,16,0.178495,0.285792,9487.833333,0,0
8583263,"Sion, Centre Funéraire",,0.000088,39,2,3,5,8841,8841,17682,15,0.158129,0.240784,1204.333333,0,0
8583266,"Sion, EMS Gravelone",,0.000061,39,2,1,3,2038,2038,4076,17,0.137066,0.196532,789.833333,0,0
8583269,"Sion, Furet",,0.000059,39,1,2,3,9714,9714,19428,17,0.138672,0.208973,284,0,0
8582969,"Sion, Vieux-Moulin",,0.000129,39,3,3,6,8867,8867,17734,15,0.151139,0.225152,7056.833333,0,0
8583278,"Sion, Petit Chasseur",,0.000066,39,2,1,3,1094,106,1200,16,0.118765,0.174567,306,0,0
8583367,"Uvrier, Le Pont",,0.000134,39,2,3,5,3577,2052,5629,14,0.142857,0.227303,5608.833333,0,0
8579509,"Duggingen, Seewenstrasse",,0.000059,53,2,1,3,4571,328,4899,1,1,1,16,0,0
8589992,Sulgenau,,0.000022,44,1,3,4,22194,22214,44408,10,0.184211,0.289612,2202.116667,0,0
8579517,"Vex, bif. d'Hérémence",,0.000065,39,2,2,4,4680,4680,9360,18,0.141337,0.197939,1714,0,0
8579518,"Vex, La Tueille",,0.000039,39,1,1,2,1383,1383,2766,21,0.099886,0.127303,500,0,0
8579519,"Les Mayens-de-Sion, Ste-Anne",,0.000044,39,1,1,2,1383,1383,2766,20,0.10971,0.140368,462,0,0
8579520,"Les Mayens-de-Sion, Coliore",,0.000048,39,1,1,2,1383,1383,2766,19,0.121813,0.158158,422,0,0
8579521,"Les Mayens-de-Sion,Les Plans",,0.000052,39,1,1,2,1383,1383,2766,18,0.137097,0.184281,380,0,0
8579522,"Les Mayens-de-S., Bon Accueil",,0.000055,39,1,2,3,1383,1383,2766,17,0.157009,0.228857,336,0,0
8579528,Prolin,,0.000039,39,1,2,3,3297,3297,6594,17,0.156757,0.22751,1057,0,0
8579533,Méribé,,0.00004,39,1,1,2,552,552,1104,17,0.153005,0.21381,168,0,0
8581165,"Evolène, Planchet",,0.000041,39,1,1,2,2469,2469,4938,17,0.153005,0.21381,2024,0,0
8582433,"Bramois, Pont de Bramois",,0.000116,39,3,1,4,10925,10925,21850,17,0.153005,0.21381,6199.833333,0,0
8588814,"Sion, Les Cèdres",,0.000221,39,6,2,8,26415,4551,30966,7,0.294118,0.442619,3595,0,0
8579530,Prapperot,,0.000027,39,1,1,2,552,552,1104,19,0.119444,0.153595,252,0,0
8579531,Léteygeon,,0.000034,39,1,1,2,552,552,1104,18,0.134069,0.176961,211,0,0
8579532,"Näfels, Schönegg",,0.000075,106,1,1,2,9846,9846,19692,10,0.171233,0.221317,401.5,0,0
8579534,"Oberurnen, im Grütli",,0.000075,106,1,1,2,9846,9846,19692,9,0.198347,0.250959,398.5,0,0
8579537,"Leuk, St. Barbara",,0.000027,40,1,1,2,13458,13458,26916,8,0.234375,0.300079,33,0,0
8579540,"Albinen, Rhodania",,0.000048,40,2,2,4,9439,9439,18878,7,0.3,0.424405,93,0,0
8579542,"Turtmann, Bahnhof",,0.000011,40,0,2,2,0,3101,3101,8,0.222222,0.314881,0,0,0
8579545,"Ergisch, Linden",,0.000024,40,1,1,2,2014,2014,4028,8,0.208333,0.271369,20,0,0
8579544,"Ergisch, Tuminen",,0.000016,40,1,1,2,1987,2014,4001,9,0.179487,0.237377,1,0,0
8579547,"Albinenleitern, Abzw. Flaschen",,0.000031,40,1,1,2,5986,4908,10894,6,0.285714,0.408333,34.5,0,0
8579548,"Albinen, Schreinerei",,0.000038,40,1,1,2,4908,5986,10894,5,0.333333,0.456667,7.5,0,0
8588123,"Leuk, Hammerschmiede",,0.000131,40,6,4,10,31490,17051,48541,5,0.444444,0.660417,269.5,0,0
8579550,"Ziegelbrücke, Post",,0.000074,106,1,1,2,9846,10305,20151,8,0.237113,0.299741,393.5,0,0
8579949,"Näfels, Kino",,0.000036,106,1,1,2,9664,9664,19328,8,0.237113,0.299741,209,0,0
8579551,"Salgesch, Swiss-Plage",,0.000014,39,1,1,2,6437,6437,12874,4,0.333333,0.391667,43,0,0
8579553,"Ettingen, Holle",,0.000036,54,1,1,2,7194,7355,14549,10,0.181818,0.292897,306,0,0
8579556,"Steg VS, Kirche",,0.000044,40,3,2,5,13482,9527,23009,7,0.273585,0.348604,154.583333,0,0
8579559,"Niedergesteln, Industrie",,0.000059,40,2,2,4,10255,10242,20497,6,0.296703,0.366049,1369,0,0
8579564,"Raron, Schulhaus",,0.000034,40,2,4,6,7576,7576,15152,5,0.403509,0.497826,37,0,0
8579567,"Raron, Bahnhof",,0.000022,40,2,2,4,4282,4282,8564,4,0.388889,0.452381,10.666667,0,0
8579560,"Niedergesteln, Weiderli",,0.000036,40,1,1,2,10018,10031,20049,7,0.211382,0.252015,377,0,0
8579561,"Niedergesteln, Kiesfang",,0.000041,40,1,1,2,10031,10031,20062,6,0.257732,0.301333,326,0,0
8587836,"Steg VS, Zentrum Metropol",,0.000054,40,3,1,4,2787,2563,5350,5,0.351351,0.412821,94.266667,0,0
8588188,"Susten, Kreuzung Agarn",,0.000061,40,1,2,3,3318,3096,6414,4,0.45,0.546296,123.35,0,0
8588285,"Susten, Kreuzmatten",,0.000061,40,1,2,3,8189,3293,11482,4,0.45,0.546296,123.35,0,0
8579595,"St-Sulpice NE, Terminus",,0.000042,49,1,2,3,7438,8958,16396,10,0.216216,0.316534,48,0,0
8579599,"Les Bayards, Quartier du Vent",,0.000102,49,3,4,7,9664,9659,19323,8,0.307692,0.458393,777,0,0
8579601,Croix-Blanche,,0.000047,49,2,3,5,10627,11052,21679,7,0.321429,0.446825,594.5,0,0
8580773,"Couvet, Viaduc",,0.000031,49,1,1,2,3840,3840,7680,6,0.289474,0.359091,25,0,0
8580386,"Couvet, hôpital",,0.000071,49,1,3,4,9391,9564,18955,5,0.424242,0.532143,1065.5,0,0
8583698,"La Brévine, bif. Petit Baillod",,0.000056,49,2,1,3,4577,1947,6524,5,0.37037,0.445,10,0,0
8587504,Frambourg,,0.000049,49,1,2,3,3875,3875,7750,5,0.4,0.511667,77.5,0,0
8579593,bas du village,,0.00003,49,1,1,2,9130,16848,25978,12,0.160494,0.218912,944,0,0
8579594,"St-Sulpice NE, poste",,0.000036,49,1,1,2,16848,7438,24286,11,0.183824,0.251954,497,0,0
8587726,"Couvet, espaceVAL",,0.000118,49,4,4,8,8674,8647,17321,4,0.529412,0.675926,3970,0,0
8579596,La Foule,,0.000047,49,2,1,3,11562,11490,23052,9,0.22549,0.292978,2886,0,0
8579600,"Törbel, Leischa",,0.000094,40,2,1,3,3140,3142,6282,2,0.666667,0.75,52,0,0
8579603,La Borcarderie,,0.000021,48,1,1,2,9132,9131,18263,18,0.097238,0.113006,473,0,0
8579613,Bas des Crêts,,0.000026,48,1,1,2,16780,16770,33550,19,0.103011,0.148424,51,0,0
8579608,sous l'Usine,,0.000039,48,2,1,3,21162,21156,42318,15,0.119718,0.143932,4432.5,0,0
8588595,Rebatte,,0.000077,48,2,3,5,23123,6574,29697,15,0.141274,0.249602,6667.47381,0,0
8593592,"Neuchâtel, Poste",,0.000056,48,3,1,4,39090,39151,78241,15,0.112903,0.187026,10507.209524,0,0
8593594,Jardin Anglais,,0.000058,48,1,1,2,39794,39805,79599,15,0.112903,0.187026,35,0,0
8579610,Crêt Debély,,0.000048,48,4,1,5,23014,23091,46105,14,0.140461,0.167725,4187.166667,0,0
8579630,Av. des Cadolles,,0.00003,48,1,4,5,57779,57786,115565,21,0.107843,0.202241,132,0,0
8579631,Pierre-à-Bot,,0.00002,48,2,3,5,30572,21884,52456,21,0.106383,0.189968,4620.033333,0,0
8579614,"Dombresson, temple",,0.000045,48,2,2,4,16799,16766,33565,18,0.113074,0.173914,5119.133333,0,0
8579632,Stand,,0.000038,48,3,1,4,6795,7746,14541,22,0.085135,0.122598,3228.333333,0,0
8579615,La Champey,,0.00003,48,1,1,2,16737,16737,33474,17,0.113734,0.166156,1497.633333,0,0
8579639,Moulin des Sauges,,0.000031,48,1,1,2,6297,6297,12594,17,0.113734,0.166156,253,0,0
8579618,"Fontainemelon, collège",,0.000033,48,1,2,3,16802,16802,33604,17,0.117271,0.187387,7290.17381,0,0
8579638,"Savagnier, Petit-Savagnier",,0.000072,48,2,3,5,7807,7807,15614,17,0.131034,0.236118,2391.833333,0,0
8587854,"Engollon, village",,0.000045,48,2,3,5,1514,1502,3016,16,0.13012,0.223619,7305.840476,0,0
8587862,"Engollon, piscine",,0.000024,48,1,1,2,737,737,1474,1,1,1,0,0,0
8579619,Rue du Collège,,0.000021,49,1,1,2,29,29,58,1,1,1,429,0,0
8595199,"Môtiers, collège",,0.000194,49,4,1,5,6711,999,7710,1,1,1,81,0,0
8593564,Pont des Parcs,,0.000075,48,3,1,4,24056,26266,50322,8,0.217647,0.272426,6719.433333,0,0
8593565,Grise-Pierre,,0.00005,48,1,4,5,48110,48110,96220,8,0.23494,0.339652,117,0,0
8579625,"Neuchâtel, gare (Nord)",,0.000066,48,6,5,11,149218,150398,299616,15,0.192063,0.267893,18666.330952,0,0
8579662,"Boudry Littorail, gare",,0.000067,105,2,2,4,10267,10267,20534,15,0.167939,0.225823,9415.007143,0,0
8593540,"Corcelles NE, Collège",,0.000088,48,4,2,6,52663,52620,105283,15,0.147727,0.20734,31090.040476,0,0
8593559,Caselle,,0.00003,48,1,2,3,13626,13626,27252,15,0.171091,0.235255,58,0,0
8593561,Draizes,,0.000047,48,2,1,3,52588,52583,105171,15,0.162465,0.210112,936,0,0
8593563,Beauregard,,0.000141,48,5,3,8,58925,56700,115625,14,0.190635,0.267996,29402.711905,0,0
8593548,Longchamps,,0.000025,48,2,2,4,48322,48322,96644,15,0.112952,0.165765,4521.166667,0,0
8593590,"Neuchâtel, Vallon de l'Ermitage",,0.000122,48,4,1,5,74421,74259,148680,19,0.106452,0.183985,1861.904762,0,0
8593566,"Neuchâtel, Trois-Chênes",,0.000085,48,5,3,8,50553,48974,99527,20,0.108262,0.222042,2179.080952,0,0
8593577,Acacias,,0.000095,48,3,2,5,50140,54085,104225,20,0.101449,0.188693,1703.752381,0,0
8593587,Pierre-qui-Roule,,0.000051,48,1,1,2,28969,28972,57941,20,0.098837,0.164831,0,0,0
8579628,Plan,,0.000014,48,1,1,2,57788,57791,115579,23,0.091031,0.138412,1448,0,0
8579629,Verger-Rond,,0.000023,48,1,1,2,57791,57779,115570,22,0.098675,0.158972,791,0,0
8588620,Esplanade du Mail,,0.000023,48,2,1,3,1332,1342,2674,21,0.1,0.177388,0,0,0
8579633,Fenin,,0.000062,48,2,1,3,7775,7802,15577,21,0.091581,0.13227,5761.833333,0,0
8579634,Vilars NE,,0.000064,48,1,1,2,7802,7807,15609,20,0.099187,0.145298,5091.833333,0,0
8579635,Saules NE,,0.000065,48,1,1,2,7807,7807,15614,19,0.108303,0.164429,4419.833333,0,0
8579636,Grand-Savagnier,,0.000066,48,1,2,3,7807,7807,15614,18,0.119433,0.198453,3745.833333,0,0
8579637,Les Prayes,,0.000039,48,1,1,2,7778,7778,15556,18,0.117647,0.184633,0,0,0
8579640,"Areuse Littorail, gare",,0.000037,105,2,2,4,58,16238,16296,21,0.097649,0.140875,8696.6,0,0
8579641,"Cortaillod, Chanélaz",,0.000027,105,1,2,3,16180,16180,32360,21,0.097096,0.139855,1518,0,0
8579642,"Cortaillod, Bas-de-Sachet",,0.000038,105,2,2,4,14809,14809,29618,20,0.105894,0.151805,6377.6,0,0
8579643,"Cortaillod, Temple",,0.000027,105,1,2,3,14751,14751,29502,19,0.115894,0.165467,1127,0,0
8579805,"Gorgier-St-Aubin, collège",,0.000067,35,3,1,4,680,680,1360,5,0.333333,0.456667,223.5,0,0
8581065,"Fresens, bas du village",,0.000083,35,2,1,3,1132,1132,2264,4,0.4,0.520833,4,0,0
8579649,"Bursinel, village",,0.000041,32,2,2,4,4486,4486,8972,7,0.24,0.323016,166.916667,0,0
8581660,"Gilly-Bursinel, gare sud",,0.000028,32,1,1,2,3653,3653,7306,7,0.232323,0.293582,0,0,0
8579651,"Chez-le-Bart, Poste",,0.00003,35,1,1,2,58,58,116,22,0.083551,0.106886,6152,0,0
8579652,Platanes,,0.000036,35,1,1,2,58,58,116,21,0.090218,0.114877,5454,0,0
8579654,Les Jonchères,,0.000042,35,1,1,2,58,58,116,20,0.098121,0.124983,4754,0,0
8579655,"Bevaix, Centre",,0.000046,35,1,1,2,58,58,116,19,0.107639,0.138328,4052,0,0
8579656,Les Yères,,0.00005,35,1,1,2,58,58,116,18,0.119326,0.157237,3348,0,0
8579657,"Bevaix, Giratoire 3 Communes",,0.000033,105,2,2,4,12568,12569,25137,18,0.120466,0.166299,1920,0,0
8579658,"Cortaillod, Les Jordils",,0.000025,105,1,1,2,12074,10238,22312,18,0.119326,0.157237,0,0,0
8581625,"Concise, La Raisse",,0.000053,35,2,1,3,4703,4704,9407,17,0.118497,0.155901,24971.666667,0,0
8579663,"Boudry, Bellevue",,0.000039,105,1,1,2,10238,10238,20476,7,0.25,0.370408,5614,0,0
8579664,"Boudry, Addoz",,0.000044,105,1,1,2,10238,10238,20476,6,0.285714,0.408333,4818,0,0
8579665,"Boudry, Praz",,0.000049,105,1,1,2,10238,10238,20476,5,0.333333,0.456667,4020,0,0
8579666,"Perreux, Pontareuse",,0.000052,105,1,1,2,10238,10238,20476,4,0.4,0.520833,3220,0,0
8579667,"Perreux, Est",,0.000055,105,1,1,2,10238,10238,20476,3,0.5,0.611111,2418,0,0
8579668,"Perreux, Carrefour",,0.000058,105,1,1,2,10238,10238,20476,2,0.666667,0.75,1614,0,0
8579670,"Sion, Auto-Pôle",,0.00007,39,3,1,4,1232,1232,2464,2,0.666667,0.75,64,0,0
8579674,"Triesenberg, Almeina",,0.000047,73,2,1,3,1114,1114,2228,3,0.5,0.611111,69,0,0
8579675,"Gamprin, Badäl",,0.000066,73,4,1,5,3594,3521,7115,9,0.182879,0.214168,1292,0,0
8579676,"Gamprin, Grossabünt",,0.000067,73,1,1,2,3521,3485,7006,8,0.219048,0.257842,813,0,0
8579679,"Nendeln, Oberwiesen",,0.000089,73,4,2,6,6734,6376,13110,9,0.209756,0.282761,1065.225227,0,0
8582877,"Schaan, Quader",,0.000141,73,4,1,5,6706,6035,12741,1,1,1,54.983333,0,0
8579682,"Schaan, Fürstenweg",,0.000034,73,1,1,2,767,767,1534,4,0.4,0.520833,1936,0,0
8579690,"Mont-sur-Rolle, Sans Souci",,0.000051,32,1,1,2,3989,3989,7978,3,0.5,0.611111,65,0,0
8579815,"Fislisbach, Alterszentrum",,0.000073,22,3,2,5,15281,14949,30230,22,0.135611,0.160064,2263.496244,0.000162,0.000016
8579695,"Sevelen, Abzw. Bad Rans",,0.000031,73,2,1,3,17320,17320,34640,27,0.106996,0.127963,22153.854575,0,0
8579696,"Sevelen, Büeli",,0.000038,73,1,2,3,17320,18888,36208,26,0.119304,0.147944,21848.854575,0,0
8579886,"Mels, Pizolcenter",,0.000113,73,4,4,8,41532,41532,83064,24,0.152247,0.206868,61861.678848,0,0
8580770,"Sargans, Kantonsschule",,0.000078,73,3,2,5,20458,20458,40916,24,0.15,0.197638,3677,0,0
8579702,"Entlebuch, Zeug",,0.000029,92,1,1,2,1992,1987,3979,2,0.666667,0.75,61,0,0
8579705,"Hasle LU, Hofstatt",,0.000038,92,3,1,4,1338,1324,2662,6,0.23913,0.315152,494,0,0
8579706,"Hasle LU, Büelweid",,0.000043,92,1,1,2,1324,1324,2648,5,0.285714,0.356667,446,0,0
8579707,"Hasle LU, Haldenegg",,0.000047,92,1,1,2,1324,1324,2648,4,0.36,0.425926,396,0,0
8579709,"Hasle LU, Sandboden",,0.000044,92,2,4,6,1571,1594,3165,2,0.7,0.785714,324,0,0
8582261,"Hasle LU, Farbschachen",,0.000042,92,2,2,4,626,589,1215,3,0.5,0.611111,85,0,0
8582390,"Hasle LU, Ussercher",,0.000029,92,1,1,2,391,493,884,3,0.454545,0.533333,0,0,0
8582757,"Hasle LU, Heiligkreuzstrasse",,0.000063,92,3,2,5,1324,1324,2648,2,0.666667,0.75,8,0,0
8584989,"Schüpfheim, Schwändi",,0.000051,92,1,1,2,1284,1284,2568,2,0.666667,0.75,2,0,0
8579710,"Matten b. I., Brunnen-Haus",,0.000053,43,1,1,2,6445,6445,12890,7,0.213483,0.265038,1255,0,0
8587261,"Bullet, Grande Salle",,0.000071,35,2,1,3,6483,4598,11081,4,0.384615,0.483333,4,0,0
8587358,Allée du Quartz,,0.000033,134,3,1,4,15412,15849,31261,11,0.170144,0.206432,0,0,0
8583697,"La Brévine, bif. Chobert",,0.000076,134,4,2,6,3847,3287,7134,13,0.138627,0.178354,1432.804762,0,0
8583701,"Le Cachot, Cachot de Vent",,0.000074,134,1,1,2,2567,2002,4569,13,0.136486,0.167034,101,0,0
8587361,Grand-Pont,,0.000082,134,5,6,11,131030,105771,236801,10,0.203095,0.27277,18692.79697,0,0
8587364,"Les Eplatures, aéroport",,0.000035,134,3,2,5,21983,22009,43992,11,0.178947,0.230941,4774.371429,0,0
8579726,centre commercial,,0.000065,49,3,2,5,9600,9393,18993,7,0.261538,0.347619,2502.5,0,0
8580383,"Couvet, bif. de Plancemont",,0.000038,49,1,1,2,3840,3840,7680,7,0.25,0.306845,0,0,0
8579727,"Grabs, Hochhaus",,0.000048,73,1,1,2,15269,14795,30064,26,0.106267,0.13905,30970.733333,0,0
8579728,"Grabs, Pflegeheim",,0.000052,73,1,1,2,14795,15269,30064,25,0.117886,0.15985,30751.733333,0,0
8579733,"Suchy, Grande Salle",,0.000023,35,1,1,2,2745,2745,5490,19,0.104418,0.147349,702.4,0,0
8582675,"Yvonand, En Brit",,0.000055,13,1,1,2,2786,2786,5572,1,1,1,1,0,0
8579744,"Grandsivaz, Marais Martin",,0.000011,116,0,1,1,0,1078,1078,5,0.307692,0.389583,0,0,0
8580004,"Ortschwaben, Weissenstein Abzw",,0.00008,44,2,3,5,11328,11206,22534,22,0.127381,0.171534,8401.666667,0,0
8579765,"Riazzino, Montedato Paese",,0.000059,101,1,1,2,11569,11569,23138,17,0.108314,0.124145,950,0,0
8579771,"Waldkirch, Bisihus",,0.000063,71,3,1,4,9046,9046,18092,4,0.4,0.520833,1220,0,0
8579806,"Unterseen, am Lauener",,0.000056,43,1,1,2,6445,6445,12890,6,0.257143,0.308333,1123,0,0
8579808,"Quartino, Gerrascia",,0.000051,108,1,1,2,13966,13966,27932,14,0.128492,0.154155,41969,0,0
8579963,"Fislisbach, Steinäcker",,0.000078,22,2,3,5,13439,14091,27530,22,0.135776,0.161929,1087.210566,0.000006,0.004215
8581604,"Maienfeld, Im Loretscher",,0.000056,109,3,1,4,5782,5621,11403,2,0.666667,0.75,855.3,0,0
8579838,"Schlatt TG, Turnhallenstrasse",,0.00004,66,1,1,2,5109,4954,10063,3,0.5,0.611111,93,0,0
8579839,"Hauptikon, Dorf",,0.000044,115,1,1,2,1796,1908,3704,7,0.225,0.325132,41.666667,0,0
8579841,"Obbürgen, Grabacher",,0.000054,62,1,1,2,2388,2388,4776,2,0.666667,0.75,45,0,0
8579844,"Häggenschwil, Agen",,0.000028,71,1,1,2,5021,5021,10042,5,0.333333,0.456667,1525,0,0
8579845,"Waldkirch, Edlischwil",,0.000065,71,1,1,2,9046,9046,18092,3,0.5,0.611111,918,0,0
8579846,"Wittenbach, Oberlören",,0.000034,71,1,1,2,5021,5021,10042,4,0.4,0.520833,1224,0,0
8579847,"Wittenbach, Unterlören",,0.00004,71,1,1,2,5021,5021,10042,3,0.5,0.611111,921,0,0
8579855,"Grandson, croisée de Fiez",,0.000057,35,2,2,4,980,950,1930,3,0.555556,0.666667,3615,0,0
8580481,"Villars-Burquin, Douvaz",,0.000035,35,1,2,3,890,890,1780,3,0.571429,0.708333,724,0,0
8581510,"Mauborget, anc. poste",,0.000026,35,1,2,3,822,822,1644,2,0.75,0.833333,1,0,0
8580401,"St. Urban, Chlisonnhalde",,0.000101,94,1,2,3,6562,6562,13124,2,0.75,0.833333,47,0,0
8579865,"Kirchenthurnen, Mösli",,0.000084,44,3,1,4,4796,4686,9482,3,0.5,0.611111,264,0,0
8579868,"Oberscherli, Lehmackerweg",,0.000042,44,2,1,3,3422,3422,6844,4,0.4,0.520833,3376,0,0
8579869,"Fehraltorf, Schrännenbrunnen",,0.000022,84,1,1,2,5280,5288,10568,8,0.225352,0.295908,79,0,0
8579870,"Rodi, Dazio Grande",,0.000026,108,2,1,3,13940,13940,27880,16,0.145492,0.204552,672.633333,0,0
8580130,"Faido, Centrale elettrica",,0.000053,108,1,1,2,4007,4007,8014,16,0.145492,0.204552,426,0,0
8579873,"Savièse, Le Belvédère",,0.000043,39,1,1,2,30,30,60,2,0.666667,0.75,44,0,0
8579880,"Heiligkreuz (Mels), Untergasse",,0.000025,73,1,1,2,7912,7912,15824,28,0.097052,0.114327,540,0,0
8579883,"Mels, Bahnhofstrasse",,0.000047,73,2,2,4,14761,14761,29522,26,0.119205,0.148703,38652.912883,0,0
8579888,"Mels, Schwarzackerstrasse",,0.000035,73,1,2,3,14754,14754,29508,25,0.131887,0.167422,2798,0,0
8580033,"Plons (Mels), Kaserne",,0.000033,73,1,1,2,7912,7912,15824,25,0.130945,0.162197,223,0,0
8579889,"Plons (Mels), Dorf",,0.000026,73,1,1,2,7912,7912,15824,26,0.116243,0.139418,1400,0,0
8579890,"Sargans, Neue Stadtergasse",,0.000033,73,1,1,2,6849,6849,13698,3,0.5,0.611111,1638,0,0
8579891,"Vilters, Rosengarten",,0.000035,73,1,1,2,15366,7687,23053,1,1,1,561.453035,0,0
8594789,"Mels, Wolfriet",,0.000098,73,3,2,5,20458,11219,31677,1,1,1,3454.546965,0,0
8594790,"Heiligkreuz (Mels), Ragnatsch",,0.000053,73,1,1,2,7912,3845,11757,1,1,1,0,0,0
8579893,"Sargans, Zürcherstrasse",,0.000039,73,1,1,2,6849,6849,13698,2,0.666667,0.75,1094,0,0
8579895,"Worb, Blümlisalpstrasse",,0.000067,100,1,2,3,4441,4441,8882,3,0.571429,0.708333,70,0,0
8580414,"Schlosswil, Mühlestrasse",,0.000039,100,1,1,2,3576,3576,7152,3,0.5,0.611111,0,0,0
8590009,Kaufmännischer Verband,,0.000097,44,6,5,11,61568,62646,124214,11,0.207792,0.325539,15635.782857,0,0
8579898,Bümpliz Unterführung,,0.000031,44,3,2,5,47518,47617,95135,11,0.182195,0.23268,6109,0,0
8579901,Statthalterstrasse,,0.000038,44,1,1,2,23845,23805,47650,11,0.178197,0.219324,170,0,0
8579899,Bümpliz Höhe,,0.000024,44,1,1,2,23825,23819,47644,13,0.133846,0.158312,2440,0,0
8579900,Bümpliz Post,,0.000031,44,1,1,2,23819,23845,47664,12,0.152753,0.18225,1306,0,0
8579903,"Frasco, Mora di Fuori",,0.000081,101,1,2,3,8355,8355,16710,13,0.146465,0.257442,1856.166667,0,0
8580994,"Locarno, Palexpo",,0.000036,101,2,3,5,55801,55801,111602,12,0.186757,0.23394,2285.633333,0,0
8580995,"Muralto, Palazzo dei Congressi",,0.000031,101,2,3,5,30429,30429,60858,14,0.191071,0.260173,846,0,0
8581771,"Tenero, Brere",,0.000141,101,5,1,6,68487,68626,137113,13,0.142132,0.230922,4071.7,0,0
8579904,"Lömmenschwil, Romanshornerstr.",,0.000045,71,1,1,2,5021,5021,10042,2,0.666667,0.75,616,0,0
8579909,"Vallorbe, Le Creux",,0.000108,35,4,1,5,9194,9215,18409,7,0.261538,0.330952,927,0,0
8579915,"St. Niklaus VS, Schulhaus",,0.000033,6,2,1,3,554,552,1106,7,0.25,0.323299,100,0,0
8579917,"St. Niklaus VS, Ballacker",,0.000028,6,1,1,2,276,276,552,5,0.275862,0.366667,74,0,0
8579918,"St. Niklaus VS, Gehri",,0.000034,6,1,1,2,276,276,552,4,0.333333,0.416667,65,0,0
8579921,"Herbriggen, Breitmatten",,0.000054,6,2,2,4,414,276,690,2,0.625,0.7,53,0,0
8579924,"Gasenried, Hubeln",,0.00009,6,3,2,5,1913,1803,3716,2,0.625,0.7,79,0,0
8585206,"Herbriggen, Biel",,0.00004,6,1,1,2,138,138,276,2,0.6,0.666667,3,0,0
8585810,"Gasenried, Dorfplatz",,0.000053,6,1,1,2,1743,547,2290,2,0.6,0.666667,3,0,0
8579925,"Müllheim Dorf, Himmelbrunnen",,0.000054,65,1,1,2,2530,2530,5060,4,0.375,0.458333,84.5,0,0
8579926,"Gasenried, Erbji",,0.000049,6,1,1,2,1725,1743,3468,3,0.444444,0.541667,18,0,0
8579928,Hohlenbaum,,0.000039,66,2,1,3,18803,18803,37606,10,0.2,0.254691,431.5,0,0
8592562,Krummacker,,0.000048,66,1,2,3,19412,19412,38824,4,0.428571,0.527778,426,0,0
8579932,"Frauenfeld, Fliederstrasse",,0.000065,65,1,1,2,6780,6780,13560,5,0.333333,0.456667,885,0,0
8580519,"Arbedo, Polveriera",,0.000029,108,1,1,2,18437,15695,34132,16,0.11482,0.137556,0,0,0
8580979,"Gerra Piano, Centro Prof.",,0.000047,101,2,2,4,18503,18252,36755,14,0.158361,0.213643,14890.066667,0,0
8581157,"Cresciano, Palazzi",,0.000061,108,1,2,3,16265,16687,32952,11,0.239394,0.297645,109,0,0
8581241,"Bellinzona, Ospedale",,0.000029,108,1,1,2,23946,23962,47908,11,0.225714,0.272027,0,0,0
8581242,"Bellinzona, Casa Greina",,0.00008,108,4,3,7,23271,23785,47056,11,0.237389,0.30321,24278.446429,0,0
8581244,"Giubiasco, Seghezzone",,0.000033,108,1,1,2,17320,17728,35048,11,0.225714,0.272027,0,0,0
8581258,"Bellinzona, Via Vela",,0.000029,108,1,1,2,24318,24468,48786,11,0.225714,0.272027,0,0,0
8581259,"Bellinzona, Ramarro",,0.000049,108,1,1,2,30241,30311,60552,11,0.225714,0.272027,407.166667,0,0
8580806,"Roveredo GR, Terra Bianca",,0.000042,17,1,1,2,121,121,242,8,0.231481,0.286429,500,0,0
8581721,"Biasca, Prada",,0.000081,108,3,4,7,30196,28969,59165,8,0.285714,0.393929,12079.733333,0,0
8582992,"Giubiasco, Via Ferriere",,0.00011,108,2,2,4,41917,39287,81204,8,0.266667,0.348597,4503.666667,0,0
8583000,"Bellinzona, Via Gerretta",,0.000088,108,2,1,3,23122,23538,46660,8,0.231481,0.286429,88,0,0
8581095,"Andeer, Tgavugl",,0.00011,109,2,1,3,1902,1593,3495,1,1,1,95.166667,0,0
8579937,"Eglisau, Oberseglingen",,0.000016,68,1,1,2,2894,2895,5789,5,0.291667,0.390476,142,0,0
8579939,"Eglisau, Kaiserhof",,0.000025,68,1,1,2,2895,2895,5790,4,0.352941,0.444444,77,0,0
8579941,"Eglisau, Tössriederen",,0.000032,68,1,1,2,2895,2895,5790,3,0.454545,0.533333,10,0,0
8579944,"Eglisau, Wiler",,0.000025,68,1,1,2,7634,7634,15268,3,0.454545,0.533333,360,0,0
8579942,"Eglisau, Altersheim",,0.000016,68,1,1,2,7634,7634,15268,4,0.352941,0.444444,426,0,0
8579945,"Eglisau, Schlafapfelbaum",,0.000059,68,2,2,4,10529,10526,21055,2,0.666667,0.75,304,0,0
8592486,"Port, Porthof",,0.000039,87,1,3,4,16660,16660,33320,6,0.301205,0.394,1949.157143,0,0
8592488,"Port, Spittel",,0.000034,87,2,2,4,15403,15499,30902,6,0.271739,0.346667,3883.314286,0,0
8593331,"Biel/Bienne, Leubringenbahn",,0.000109,87,5,4,9,84672,84366,169038,6,0.348485,0.45942,17007.695238,0,0
8593334,"Biel/Bienne, Grausteinweg",,0.000034,87,1,2,3,29548,29550,59098,6,0.319149,0.421111,0,0,0
8579947,"Näfels, Oberdorf",,0.00003,106,2,1,3,9445,9664,19109,9,0.198347,0.250959,198,0,0
8579952,"Mollis, Oberrütelistrasse",,0.000057,106,1,3,4,4095,4095,8190,3,0.5,0.642857,118,0,0
8579953,"Mollis, Baumgartenstrasse",,0.000027,106,1,1,2,2050,2050,4100,4,0.375,0.458333,0,0,0
8579951,"Mollis, Kanalstrasse",,0.000054,106,2,1,3,3904,4095,7999,4,0.363636,0.447917,146,0,0
8595640,"Ziegelbrücke, Bahnhof Süd",,0.000203,106,5,1,6,27092,3766,30858,1,1,1,34,0,0
8579954,"Vouvry, piscine",,0.000047,103,1,1,2,1147,1147,2294,2,0.666667,0.75,50,0,0
8579958,"Lauterbrunnen, Lochbrücke",,0.000057,43,2,1,3,2355,332,2687,3,0.5,0.583333,423.733333,0,0
8582257,"Wilderswil, Kirchgasse",,0.000088,43,3,1,4,8955,7779,16734,3,0.5,0.583333,352.266667,0,0
8579960,"Wilen (Sarnen), Bodenmattli",,0.00007,62,2,1,3,3422,3422,6844,2,0.666667,0.75,104,0,0
8580315,"Fislisbach, Dorfstrasse",,0.000033,22,1,1,2,5143,4839,9982,22,0.130493,0.148532,0,0.000097,0.004018
8580728,"Widen, Burkertsmatt",,0.000026,22,2,3,5,4104,3744,7848,22,0.159106,0.198054,72350.055777,0.003661,0.010939
8580729,"Berikon, Kesslernmatt",,0.000036,22,2,3,5,4425,3982,8407,22,0.159106,0.198054,5202.746397,0.00353,0.010939
8579967,"Kloten, Weinbergstrasse",,0.000037,107,2,1,3,26457,26463,52920,18,0.097561,0.1076,118,0.000008,0
8579968,Egetswil,,0.000042,107,1,1,2,26463,26456,52919,17,0.107873,0.121187,518,0,0
8580432,"Kloten, Bramen",,0.000025,107,2,2,4,14062,14082,28144,16,0.119344,0.136447,852.921645,0.000008,0.000226
8580434,"Kloten, Lindenstrasse",,0.00003,107,2,2,4,27733,27740,55473,16,0.119174,0.13601,219.691991,0.000007,0.000226
8580435,"Kloten, Mühle",,0.00004,107,3,1,4,3441,3464,6905,16,0.118738,0.133269,955.983333,0.000173,0.000219
8580437,"Kloten, Säntisstrasse",,0.000032,107,2,3,5,17054,17282,34336,16,0.119035,0.136684,291.425325,0.000007,0.00257
8580438,"Kloten, Wohnheim",,0.000028,107,2,2,4,11603,11374,22977,16,0.118801,0.134757,213.091991,0.000061,0.002587
8579972,"Monthey, piscine",,0.000062,103,2,1,3,2238,2238,4476,6,0.269231,0.378571,99,0,0
8579973,"Monthey, Troilletta",,0.000031,103,1,1,2,545,545,1090,2,0.6,0.666667,150,0,0
8579978,"Waldkirch, Werkhof",,0.000066,71,1,1,2,9046,9046,18092,2,0.666667,0.75,614,0,0
8579979,"Häggenschwil, Dorfplatz",,0.000049,71,1,1,2,5021,5021,10042,1,1,1,309,0,0
8579981,"Waldkirch, Bernhardsrüti",,0.000067,71,1,1,2,9046,9046,18092,1,1,1,308,0,0
8581346,"Oberwil-Lieli, Bündtenmättli",,0.000063,85,3,2,5,17424,16820,34244,18,0.166012,0.197958,5305.435308,0.018095,0.012271
8583560,"Oberrohrdorf, Im Feld",,0.000069,22,3,1,4,13040,642,13682,10,0.203173,0.220146,1136.788003,0.003406,0.06457
8583805,"Bonstetten, Dorfstrasse",,0.00014,85,7,1,8,6851,3340,10191,10,0.203173,0.220146,3440.870123,0.005397,0.06457
8579996,"Grabs, Säntisstrasse",,0.000076,73,3,1,4,3428,3428,6856,1,1,1,35,0,0
8579997,"Fideris, Madinis",,0.000037,112,1,1,2,3611,3626,7237,25,0.0959,0.128459,2956,0,0
8580012,"Sarnen, Kantonsschule",,0.000071,62,1,1,2,3422,3421,6843,1,1,1,53,0,0
8580014,"Grossteil, Rüti",,0.000069,92,2,2,4,2339,2329,4668,4,0.454545,0.616667,95,0,0
8582460,"Kaiserstuhl OW, Bahnhof",,0.00004,92,1,1,2,244,244,488,4,0.4,0.520833,0,0,0
8580018,"Altbüron, Ludligen",,0.000106,94,3,1,4,6562,6562,13124,3,0.5,0.583333,92,0,0
8580081,"Vacallo, Ponte Picio",,0.000119,99,6,3,9,25261,25263,50524,11,0.213389,0.297464,1325.823909,0,0
8580484,"Coldrerio, Paese",,0.000062,99,1,3,4,46573,46573,93146,10,0.22488,0.313847,329,0,0
8580711,"Novazzano, Paese",,0.000049,99,2,3,5,18426,18426,36852,11,0.208178,0.2867,509.033333,0,0
8581471,"Seseglio, Paese",,0.000079,99,1,2,3,8601,8601,17202,11,0.20524,0.278454,94,0,0
8580028,"Agarone, Paese",,0.000061,101,1,1,2,11569,11569,23138,16,0.120616,0.138557,987,0,0
8580981,"Gordola, Via Crespo",,0.000037,101,1,1,2,18085,18085,36170,16,0.120616,0.138557,14049.4,0,0
8580032,"Ennenda, Seilbahn",,0.000016,106,1,1,2,4795,4795,9590,2,0.6,0.666667,33,0,0
8580594,"Riffenmatt, Kreuzung",,0.000052,126,2,2,4,1796,2451,4247,3,0.571429,0.708333,1080,0,0
8582069,"Schwarzenburg, Büblern",,0.000109,126,3,2,5,2605,2485,5090,1,1,1,1089,0,0
8580045,"Ulrichen, Kittbrücke",,0.000041,108,2,2,4,508,508,1016,2,0.75,0.833333,573,0,0
8580212,"Ulrichen, Abzw. Nufenen",,0.000028,108,1,1,2,448,448,896,2,0.666667,0.75,0,0,0
8580046,"Wohlen b. Bern, Schaufelacker",,0.000047,44,1,1,2,5950,5950,11900,16,0.118881,0.176368,927,0,0
8580057,"Gstaad, Bissenegg",,0.00006,42,3,1,4,2215,2215,4430,11,0.190909,0.274359,128,0,0
8580344,"Turbach, Schwenterli",,0.000056,42,3,2,5,2538,899,3437,10,0.211765,0.327138,142,0,0
8580539,"Turbach, Heimweid",,0.000051,42,1,1,2,742,742,1484,10,0.195122,0.274281,16,0,0
8589500,"Morbio Inferiore, Fontanella",,0.000072,99,1,1,2,6632,6632,13264,10,0.184783,0.257096,84.2,0,0
8580070,"Balerna, Bellavista (FFS)",,0.000064,99,3,2,5,51289,53349,104638,12,0.179558,0.236038,1569.311905,0,0
8580071,"Balerna, Croce Bianca",,0.000038,99,1,1,2,46573,46573,93146,17,0.095406,0.127075,994,0,0
8580072,"Balerna, Mezzana",,0.000043,99,1,1,2,46573,46573,93146,16,0.103516,0.135186,905,0,0
8580073,"Coldrerio, Mercole",,0.000048,99,1,1,2,46573,46573,93146,15,0.11329,0.145251,814,0,0
8580074,"Coldrerio, Ideal",,0.000052,99,1,1,2,46573,46573,93146,14,0.125307,0.158146,721,0,0
8580076,"Coldrerio, Colle degli Ulivi",,0.000055,99,1,1,2,46573,46573,93146,13,0.140449,0.175391,626,0,0
8580078,"Balerna, Mercole",,0.000057,99,1,1,2,46573,46573,93146,12,0.160131,0.19992,529,0,0
8580079,"Moutier, Banque cantonale",,0.000092,1,5,3,8,9448,9448,18896,5,0.409091,0.568519,117.666667,0,0
8580097,"Moutier, Aux Laives",,0.000037,1,1,2,3,6880,6866,13746,5,0.380952,0.514583,0,0,0
8581144,"Moutier, Suisse Ouest",,0.000053,1,2,2,4,4993,2535,7528,5,0.388889,0.540476,11.833333,0,0
8583832,"Tremona, Teia",,0.000069,99,4,2,6,5714,9069,14783,8,0.205479,0.316905,624.666667,0,0
8580085,"Sta. Maria in Calanca, Pozzo B",,0.000034,17,2,1,3,2971,2963,5934,12,0.13913,0.187589,22,0,0
8580086,"Castaneda, Al Ronc",,0.00004,17,1,1,2,2963,2963,5926,11,0.156566,0.210651,42,0,0
8580929,"Grono, Paese",,0.000051,17,2,2,4,6175,4267,10442,1,1,1,393,0,0
8580090,"Augio, Tarco",,0.000045,17,2,1,3,2169,2138,4307,14,0.114094,0.15928,44,0,0
8580093,"Cauco, ponte",,0.000049,17,1,1,2,2138,2138,4276,13,0.125,0.170432,66,0,0
8580096,"Arvigo, Al Canton",,0.000053,17,1,1,2,2138,2138,4276,12,0.138528,0.184985,86,0,0
8580098,"Arvigo, Filovia",,0.000056,17,1,1,2,2138,2138,4276,11,0.155779,0.205275,104,0,0
8580104,"Vico Morcote, Pradon",,0.000034,102,1,1,2,5967,5967,11934,16,0.126186,0.144044,734,0,0
8582966,"Stabio, Scuola Media",,0.000022,99,1,1,2,1346,1336,2682,12,0.181518,0.225195,0,0,0
8583790,"Stabio, Stazione",,0.000078,99,3,2,5,23103,22836,45939,12,0.199187,0.267485,1090.583333,0,0
8587125,"Chiasso, Via Soldini",,0.000048,99,2,2,4,24906,23929,48835,12,0.19469,0.264927,838.483333,0,0
8580113,"Sorengo, Moncucchetto",,0.00003,102,1,2,3,8628,8628,17256,9,0.191083,0.243757,151.866667,0,0
8591609,"Lugano, Palazzo Congressi",,0.000061,102,2,3,5,113331,113331,226662,8,0.221854,0.27946,2312.889899,0,0
8591613,"Lugano, S. Nicolao",,0.000052,102,3,4,7,65672,65672,131344,8,0.228682,0.301352,3821.331313,0,0
8580114,"Mendrisio, Centro Studi 1",,0.00006,99,1,1,2,46573,46573,93146,11,0.18677,0.238509,430,0,0
8580115,"Vico Morcote, Via Piana",,0.000039,102,1,1,2,5967,5967,11934,15,0.143322,0.165179,828,0,0
8580116,"Carì, Ticc di Dentro",,0.000055,108,2,1,3,4060,4060,8120,20,0.097403,0.127819,908,0,0
8580117,"Molare, Campì",,0.000058,108,1,1,2,4060,4060,8120,19,0.106475,0.140057,855,0,0
8580118,"Molare, Stella Alpina",,0.00006,108,1,1,2,4060,4060,8120,18,0.117552,0.156801,800,0,0
8580122,"Faido, Centrale Telefoni",,0.000021,108,1,1,2,3627,3709,7336,20,0.095908,0.124766,118,0,0
8580128,"Mairengo, Selva",,0.000045,108,2,1,3,4007,4007,8014,18,0.115324,0.150555,524,0,0
8580129,"Mairengo, Campasc",,0.000049,108,1,1,2,4007,4007,8014,17,0.128571,0.171448,476,0,0
8580141,"Rodi, Casa Gendotti",,0.000076,108,1,2,3,6719,4801,11520,15,0.148248,0.222597,330,0,0
8580590,"Bodio, Stazione",,0.000045,108,1,2,3,12752,12752,25504,14,0.156156,0.224131,503.866667,0,0
8580133,"Rossura, Bivio per Rossura",,0.000074,108,3,2,5,7091,6822,13913,3,0.545455,0.638889,768.766667,0,0
8580457,"Carì, Condomini",,0.000047,108,1,3,4,4060,2901,6961,2,0.8,0.875,155,0,0
8580771,"Faido, Balcengo",,0.000024,108,1,1,2,177,177,354,2,0.6,0.666667,0,0,0
8580134,"Faido, Chia Meiza",,0.000042,108,1,1,2,3791,4060,7851,3,0.5,0.566667,302,0,0
8580136,"Dalpe, Villaggio",,0.00008,108,4,1,5,6719,6740,13459,20,0.090772,0.123827,805,0,0
8580137,"Dalpe, Campiano",,0.000079,108,1,1,2,6740,6749,13489,19,0.09817,0.132639,714,0,0
8580138,"Dalpe, Valle",,0.000078,108,1,1,2,6749,6749,13498,18,0.107011,0.14398,621,0,0
8580139,"Prato (Leventina), Paese",,0.000077,108,1,1,2,6749,6749,13498,17,0.117769,0.15936,526,0,0
8580140,"Prato (Leventina),Biv.Mascengo",,0.000077,108,1,1,2,6749,6719,13468,16,0.131148,0.182089,429,0,0
8580163,"Planken, Abzw. Egerta",,0.000039,73,1,1,2,767,767,1534,3,0.5,0.611111,1455,0,0
8580165,"Etzgen, Schulhaus",,0.000093,57,4,1,5,5730,5730,11460,1,1,1,96,0,0
8580447,"Sils i. D., Prolung",,0.000036,109,1,1,2,86,86,172,25,0.122558,0.153958,0,0,0
8580923,"Splügen, Bergbahnen",,0.000087,109,3,1,4,5617,1825,7442,2,0.666667,0.75,60.216667,0,0
8580750,"Rothenbrunnen, Abzw. Bahnhof",,0.000036,109,1,1,2,2993,3390,6383,6,0.264151,0.332143,0,0,0
8580180,"Feldis/Veulden, Dorfplatz",,0.000068,111,1,1,2,748,748,1496,4,0.4,0.520833,44,0,0
8580183,"S. Bernardino, Campeggio",,0.000023,109,1,1,2,530,530,1060,1,1,1,22,0,0
8580193,"Küblis, Dalvazza",,0.000099,112,3,1,4,3457,3649,7106,1,1,1,1448,0,0
8580197,"Meien, Gorezmettlen",,0.000049,93,1,1,2,254,254,508,13,0.129496,0.210849,1675,0,0
8580488,"Bendern, Under Atzig",,0.000079,73,3,2,5,4376,4376,8752,7,0.267123,0.323748,512.404762,0,0
8581007,"Gamprin, Mühlegass",,0.000094,73,4,3,7,3594,3485,7079,5,0.4,0.530556,3448.557143,0,0
8580208,"Oberwald VS, Rhonequelle",,0.000098,108,2,1,3,257,257,514,1,1,1,192,0,0
8580231,"La Place (Ayent), centre",,0.000046,39,2,1,3,1036,1016,2052,22,0.092956,0.113461,522,0,0
8580228,"Triesenberg, Rizlina",,0.000057,73,1,1,2,1691,1691,3382,3,0.5,0.611111,1497,0,0
8580229,"Malbun, Bergbahnen",,0.000059,73,1,1,2,1691,1691,3382,2,0.666667,0.75,1000,0,0
8580232,"Schaan, Planknerstr./Kresta",,0.000044,73,1,1,2,767,767,1534,2,0.666667,0.75,972,0,0
8580234,"Wald ZH, Hittenberg",,0.000026,67,1,1,2,841,840,1681,2,0.666667,0.75,58,0,0
8580661,"Lens, Le Bouille",,0.000049,39,2,1,3,1411,1336,2747,13,0.148148,0.206101,225,0,0
8588514,"Granges VS, Av. de la Gare",,0.000105,39,2,1,3,8664,8664,17328,13,0.148148,0.206101,6914.833333,0,0
8583046,"Bern, Forsthaus",,0.00008,44,2,2,4,32235,32235,64470,2,0.625,0.7,1224,0,0
8583222,"Bern, Lindenhofspital",,0.000111,44,4,2,6,32750,32757,65507,2,0.666667,0.75,1530.578571,0,0
8587328,"Säriswil, Dorf",,0.000058,44,1,1,2,8369,8369,16738,2,0.6,0.666667,0,0,0
8580696,"Melide, Stazione",,0.00011,102,5,4,9,23107,23108,46215,13,0.197269,0.245769,1901.919231,0,0
8580240,"Frauenfeld, Rorerbrücke",,0.000048,65,1,3,4,14895,14895,29790,2,0.8,0.875,650.5,0,0
8580249,"Lommis, Krattenbach",,0.000065,65,1,1,2,6112,6112,12224,5,0.333333,0.456667,885,0,0
8580250,"Weinfelden, Felsenstrasse",,0.000044,65,1,1,2,4607,4823,9430,19,0.099526,0.178031,254,0,0
8580251,"Raperswilen, Schulhaus",,0.000054,65,1,1,2,2921,2921,5842,5,0.3125,0.386667,110,0,0
8581810,"Engwilen, Hauptstrasse",,0.000061,65,1,1,2,4614,4614,9228,5,0.3125,0.386667,360,0,0
8581970,"Ermatingen, Rathaus",,0.000058,65,1,1,2,4801,4580,9381,5,0.3125,0.386667,370,0,0
8580252,"Ennenda, Gemeindehaus",,0.000025,106,1,2,3,4795,4795,9590,1,1,1,24,0,0
8580486,"Ennenda, Villastrasse",,0.000021,106,1,1,2,2399,2399,4798,1,1,1,0,0,0
8580256,"Elsau, Pestalozzistrasse",,0.000045,68,4,1,5,12154,12198,24352,13,0.130769,0.21174,59,0,0
8580257,"Elsau, Ebnet",,0.000049,68,1,1,2,12198,12168,24366,12,0.141593,0.223318,62,0,0
8580260,"Elsau, Bännebrett",,0.000062,68,2,1,3,13210,13221,26431,9,0.191176,0.274664,138,0,0
8580263,"Winterthur, Schlossacker",,0.000063,68,1,1,2,13221,13224,26445,8,0.218182,0.303671,133,0,0
8580264,"Winterthur, Grubenstrasse",,0.000065,68,1,1,2,13224,13224,26448,7,0.255814,0.349351,126,0,0
8580265,"Winterthur, Hegifeld",,0.000066,68,1,2,3,13224,13207,26431,6,0.3125,0.448333,117,0,0
8582789,"Elsau, Bettli",,0.000056,68,2,2,4,9239,9238,18477,1,1,1,27,0,0
8583361,"Elgg, Schloss",,0.000063,68,2,1,3,5194,5048,10242,1,1,1,8,0,0
8580266,"Glarus, Stampf",,0.000041,106,1,2,3,9664,9444,19108,6,0.3,0.415278,420,0,0
8580273,"Glarus, Landstrasse",,0.000035,106,1,1,2,4611,4611,9222,6,0.27027,0.348333,10,0,0
8580271,"Glarus, Lurigenstrasse",,0.000028,106,1,1,2,4610,4611,9221,7,0.229167,0.309957,36,0,0
8580288,"Glarus, Rathaus",,0.000016,106,1,1,2,4794,4794,9588,3,0.5,0.611111,33,0,0
8582673,"Elgg, Sennhof",,0.000067,68,1,2,3,5204,5200,10404,2,0.75,0.833333,47,0,0
8580297,"Uerzlikon, Dorf",,0.000049,115,1,1,2,1908,1870,3778,6,0.258065,0.35625,44.666667,0,0
8580298,"Mettmenstetten, Rossau",,0.000052,115,1,1,2,1870,1869,3739,5,0.304348,0.397619,45.666667,0,0
8580299,"Mettmenstetten, Wissenbach",,0.000055,115,1,1,2,1869,1983,3852,4,0.375,0.458333,44.666667,0,0
8583774,"Winkel, Seebüel",,0.000053,107,1,1,2,26886,25934,52820,16,0.117006,0.12811,419,0,0.002346
8580303,"Wohlen AG, Postplatz",,0.000106,115,5,4,9,12766,12934,25700,21,0.088642,0.106595,4503.95,0.008943,0
8580360,"Wohlen AG, Riedmatt",,0.000034,115,1,1,2,1597,1597,3194,6,0.25,0.352083,0,0,0
8580305,"Wohlen AG, Büttikerstrasse",,0.000034,115,1,1,2,4128,4128,8256,4,0.4,0.520833,1372,0,0
8580306,"Wohlen AG, untere Farnbühlstr.",,0.000039,115,1,1,2,4128,4128,8256,3,0.5,0.611111,1032,0,0
8580307,"Wohlen AG, Rainmattstrasse",,0.00005,115,2,2,4,3785,3785,7570,3,0.571429,0.708333,440,0.000193,0
8580376,"Wohlen AG, Gemeindehaus",,0.000032,115,1,1,2,1832,1832,3664,3,0.5,0.611111,0,0,0
8580308,"Wohlen AG, Brünismatt",,0.000044,115,1,1,2,4128,4128,8256,2,0.666667,0.75,690,0,0
8580365,"Wohlen AG, Dammweg",,0.000066,115,1,2,3,3202,3202,6404,2,0.666667,0.75,702,0,0
8580369,"Wohlen AG, Altersheim Bifang",,0.000044,115,1,1,2,1605,1605,3210,2,0.666667,0.75,2,0,0
8580314,"Wohlen AG, Industriestrasse",,0.000024,115,2,1,3,4279,4279,8558,6,0.285714,0.408333,486,0.000324,0
8580847,"Bremgarten AG, Bibenlos",,0.00007,85,2,2,4,10668,10669,21337,19,0.142857,0.164355,4026.547603,0.000306,0.002815
8580328,"Windisch, Breiti",,0.000059,22,2,1,3,8293,7849,16142,2,0.666667,0.75,34.5,0,0
8580330,"Murgenthal, Fahracker",,0.00007,94,2,2,4,5219,5173,10392,2,0.75,0.833333,486,0,0
8580819,"Murgenthal, Bahnhof",,0.000041,94,1,1,2,2640,2640,5280,2,0.666667,0.75,0,0,0
8580334,"Wohlen AG, Ringstrasse",,0.000032,115,1,1,2,4279,4279,8558,5,0.333333,0.456667,410,0,0
8580342,"Wohlen AG, Cellpack Werk 1",,0.000038,115,1,1,2,4279,4279,8558,4,0.4,0.520833,332,0,0
8580354,"Wohlen AG, Allmend",,0.000015,115,1,1,2,1008,1906,2914,3,0.5,0.611111,69,0.000136,0
8580355,"Wohlen AG, Kantonsschule",,0.000023,115,1,1,2,1906,1906,3812,2,0.666667,0.75,48,0,0
8580356,"Wohlen AG, Sportanlagen",,0.000031,115,1,1,2,1906,1906,3812,1,1,1,25,0,0
8580361,"Mühledorf SO, Kirche",,0.00009,87,3,1,4,2589,2485,5074,23,0.112698,0.140832,3824.5,0,0
8580362,"Wohlen AG, Schulen Junkholz",,0.000062,115,2,1,3,3202,3202,6404,5,0.291667,0.390476,1722,0,0
8580363,"Wohlen AG, Junkholzweg",,0.000064,115,1,1,2,3202,3202,6404,4,0.352941,0.444444,1384,0,0
8580364,"Wohlen AG, Gewerbering",,0.000065,115,1,1,2,3202,3202,6404,3,0.454545,0.533333,1044,0,0
8580367,"Wohlen AG, Stegmatt",,0.000039,115,1,1,2,1605,1605,3210,3,0.5,0.611111,348,0,0
8580370,"Lauterbrunnen, Dorf",,0.000049,43,1,1,2,7075,7076,14151,1,1,1,24,0,0
8580371,"Brünig-Hasliberg, Waldegg",,0.000065,114,2,1,3,3958,3972,7930,10,0.204082,0.271925,130,0,0
8580372,"Wohlen AG, Wehrlistrasse",,0.000114,115,3,1,4,7330,2064,9394,1,1,1,353,0,0
8588485,Kinderspital UKBB,,0.000053,2,4,2,6,44992,44992,89984,12,0.164153,0.191455,914.770876,0,0
8580377,"Wohlen AG, Litzibuech",,0.000059,115,2,1,3,3785,3785,7570,2,0.666667,0.75,224,0,0
8580382,"Wohlen AG, Hubäckerweg",,0.000043,115,1,1,2,4279,4279,8558,3,0.5,0.611111,252,0,0
8580385,"Boveresse, piscine",,0.000071,49,2,1,3,9393,9391,18784,6,0.3125,0.374444,1546.5,0,0
8580390,"Ulrichen, Bahnhof",,0.000052,108,2,1,3,508,508,1016,1,1,1,193,0,0
8580394,"Vissoie, les Rotzecs",,0.000052,39,1,1,2,2468,2336,4804,2,0.666667,0.75,22,0,0
8580397,"Homberg, Gappen",,0.000021,43,1,2,3,690,690,1380,2,0.75,0.833333,747,0,0
8582190,"Steffisburg, Ziegeleistrasse",,0.00002,43,1,1,2,450,445,895,2,0.666667,0.75,0,0,0
8580399,"Uettligen, Schule",,0.000036,44,1,1,2,5950,5950,11900,4,0.333333,0.416667,966.333333,0,0
8580400,Riedhaus,,0.000041,44,1,1,2,5950,5950,11900,3,0.428571,0.5,39.333333,0,0
8582210,"Bern, Untermattweg",,0.00004,44,1,1,2,26278,26285,52563,3,0.428571,0.5,2384.666667,0,0
8580732,"Roggliswil, Netzelen",,0.000076,94,2,1,3,10514,2464,12978,2,0.666667,0.75,65,0,0
8580402,"Wiler bei Seedorf, Neuwiler",,0.000034,44,1,1,2,3471,3471,6942,24,0.10138,0.122737,988,0,0
8580403,"Nax, piscine",,0.000035,39,2,1,3,2222,2222,4444,21,0.100228,0.134021,280,0,0
8580404,"Hinterkappelen, Schlossmatt",,0.000042,44,2,1,3,13274,13275,26549,15,0.121951,0.178215,933,0,0
8580425,"Aarberg, Nidaustrasse",,0.000034,87,2,1,3,4942,4942,9884,3,0.5,0.611111,919,0,0
8580430,"Winterthur, Technikum",,0.000072,68,7,4,11,26210,30689,56899,15,0.16849,0.245017,1055.066667,0,0
8580454,"Winterthur, Bettenplatz",,0.000026,68,1,1,2,5901,5906,11807,15,0.146138,0.197297,0,0,0
8580455,"Winterthur, Depot",,0.000026,68,1,2,3,14096,14089,28185,15,0.147917,0.208602,28,0,0
8580456,"Winterthur, Endliker",,0.000022,68,1,1,2,12442,12445,24887,15,0.146138,0.197297,0,0,0
8580433,"Kloten, Graswinkel",,0.000029,107,1,3,4,22061,22517,44578,17,0.106847,0.121674,518.875974,0.002292,0.000075
8588553,"Zürich Flughafen, Fracht",,0.000204,107,8,8,16,259119,201606,460725,14,0.151968,0.181247,45367.423667,0.087421,0.003363
8580442,"Arolla, Mt-Collon",,0.000059,39,1,1,2,1349,1349,2698,1,1,1,14,0,0
8580445,"Noville, Chotron",,0.000123,103,3,1,4,4874,4609,9483,4,0.384615,0.483333,247,0,0
8590620,"Glattbrugg, Bahnhof",,0.000081,107,4,3,7,119331,119428,238759,13,0.170732,0.191803,34978.478401,0.000231,0.021049
8590626,"Glattpark, Lindberghplatz",,0.000044,107,2,2,4,117006,117004,234010,12,0.170136,0.186813,2314.413095,0.000498,0.025688
8590628,"Glattbrugg, Oberhusen",,0.000021,85,1,1,2,25254,25252,50506,11,0.146091,0.15543,1,0.000012,0.020637
8590890,"Wallisellen, Ifang",,0.000048,107,1,1,2,32997,32997,65994,10,0.18315,0.200139,5164.922332,0,0.026462
8591046,"Zürich, Aspholz",,0.000014,107,1,1,2,29831,29804,59635,10,0.18315,0.200139,0,0.019567,0.004021
8591065,"Zürich, Bahnhof Stettbach",,0.00027,85,11,7,18,230460,133392,363852,10,0.213598,0.249275,40326.267422,0.056878,0.072291
8591140,"Zürich, Friedackerstrasse",,0.000041,85,4,5,9,53879,54215,108094,8,0.237991,0.303976,2786.970486,0.005875,0.085185
8591294,"Zürich, Oerlikerhus",,0.000063,85,3,5,8,116830,116945,233775,8,0.282979,0.337871,2590.457093,0.012267,0.032514
8591332,"Zürich, Salersteig",,0.000061,85,3,3,6,120885,120875,241760,7,0.3,0.35425,1251.942056,0.016416,0.02339
8591347,"Zürich, Schürgistrasse",,0.000048,85,2,1,3,65238,32247,97485,6,0.284848,0.325177,77.732129,0.00012,0.009968
8591349,"Zürich, Schwamendingerplatz",,0.000241,85,10,8,18,241680,215908,457588,7,0.314394,0.397533,5833.451795,0.004937,0.032451
8591350,"Zürich, Schwandenholz",,0.000045,85,2,2,4,30584,30612,61196,6,0.288344,0.339362,300.310388,0.007581,0.010831
8591354,"Zürich, Seebach",,0.00019,85,10,3,13,212390,211865,424255,7,0.273063,0.328539,9976.089748,0.020918,0.011453
8591355,"Zürich, Seebacherplatz",,0.000106,85,3,4,7,195127,143505,338632,6,0.303571,0.361765,2682.653018,0.00744,0.017659
8591362,"Zürich, Seilbahn Rigiblick",,0.000237,85,13,11,24,177081,177056,354137,4,0.417808,0.505464,13881.902222,0.063731,0.053556
8591373,"Zürich, Sonneggstrasse",,0.000049,85,2,2,4,70994,47450,118444,5,0.324138,0.375887,62.292852,0.010225,0.016475
8591379,"Zürich, Stampfenbachplatz",,0.000184,85,9,6,15,153077,151576,304653,4,0.386861,0.454403,3501.050886,0.029354,0.029875
8591381,"Zürich, Stauffacher",,0.000235,85,10,13,23,260585,258046,518631,4,0.455357,0.558824,12298.788494,0.04926,0.051846
8580459,"Winterthur, Hinterdorf Seen",,0.000028,68,1,1,2,12450,12447,24897,8,0.225806,0.301956,0,0,0
8590930,"Winterthur, Brunngasse",,0.000039,68,1,1,2,11888,11847,23735,7,0.241935,0.31619,1986,0,0
8580460,"Suen, Sud",,0.00005,39,3,1,4,1975,1975,3950,23,0.085741,0.112662,393.833333,0,0
8596057,Les Granges-de-Dompierre,,0.000066,13,1,1,2,3998,52,4050,2,0.666667,0.75,274.5,0,0
8596058,"Hennens, village",,0.000035,13,2,2,4,833,833,1666,1,1,1,305.166667,0,0
8583445,"Möhlin, Unter der Halde",,0.000074,2,4,1,5,3926,1969,5895,1,1,1,4.833333,0,0
8582231,"Möhlin, Schwimmbad",,0.000033,2,1,2,3,5054,4497,9551,2,0.625,0.7,35.208333,0,0
8580489,"Bütschwil, Hofwiesen",,0.000072,70,3,3,6,12908,12907,25815,5,0.357143,0.484444,2901.5,0,0
8589498,"Chiasso, Viale Stoppa",,0.000141,99,6,5,11,68854,45166,114020,11,0.234848,0.387328,1658.687229,0,0
8580500,"Nendeln, Kohlmahd",,0.000049,73,1,1,2,2447,2805,5252,8,0.242991,0.299771,148.683333,0,0
8585402,"Bazenheid, altes Zeughaus",,0.000025,20,1,1,2,58,58,116,6,0.25641,0.34,3.5,0,0
8580492,"Frümsen, Schäfli",,0.000074,73,2,1,3,8030,8030,16060,15,0.135484,0.178656,4828.421429,0,0
8580493,"Glarus, Buchholz",,0.000058,106,2,1,3,9445,9444,18889,5,0.333333,0.411111,342,0,0
8580494,"Glarus, Kantonsschule/Spital",,0.00006,106,1,2,3,9444,9445,18889,4,0.444444,0.552083,312,0,0
8580502,"Netstal, Gemeinde",,0.000042,106,1,1,2,4390,4609,8999,4,0.4,0.486111,6,0,0
8580501,"Netstal, Altersheim",,0.000036,106,1,1,2,4611,4390,9001,5,0.318182,0.409524,40,0,0
8580503,"Netstal, Wiggis Park",,0.000072,106,2,2,4,9443,9664,19107,3,0.555556,0.666667,210,0,0
8580907,"Netstal, Post",,0.000046,106,1,1,2,4611,4609,9220,3,0.5,0.611111,3,0,0
8580518,"Chiasso, Via Favre",,0.000082,99,3,1,4,8532,8601,17133,13,0.150307,0.188801,284,0,0
8580520,"Turbach, Relli",,0.000047,42,2,1,3,620,742,1362,11,0.171717,0.245777,24,0,0
8580798,"Winterthur, Schiltwiesen",,0.000055,68,2,1,3,13126,13126,26252,12,0.143713,0.188147,384,0,0
8591056,"Zürich, Bahnhof Altstetten",,0.000072,85,8,11,19,199346,229525,428871,9,0.256776,0.302491,17630.574342,0.071637,0.11649
8591068,"Zürich, Bändliweg",,0.000066,85,5,7,12,87999,87922,175921,9,0.234657,0.269071,10967.28704,0.13722,0.102379
8591123,"Zürich, ETH/Universitätsspital",,0.000082,85,8,4,12,165703,168043,333746,8,0.228086,0.256998,8823.509351,0.20317,0.271974
8591131,"Zürich, Fischerweg",,0.00007,85,6,1,7,109218,108743,217961,9,0.195837,0.212286,22.513425,0.101437,0.135565
8583202,"Euthal, Ängi",,0.000098,69,4,1,5,4087,3840,7927,1,1,1,24.166667,0,0
8580526,"Gamprin, Haldenstrasse",,0.00008,73,3,2,5,5057,5069,10126,4,0.407407,0.492424,2916.5,0,0
8581008,"Ruggell, Limsenegg",,0.000033,73,1,1,2,2135,2135,4270,3,0.411765,0.47619,18,0,0
8580534,"Massongex, Le Bras",,0.000065,37,1,1,2,1066,1024,2090,3,0.5,0.611111,42,0,0
8580535,"Oey, Chirlegand",,0.000075,46,2,1,3,1435,1435,2870,6,0.266667,0.3625,136,0,0
8580541,"Wald ZH, Wabe",,0.000033,67,1,1,2,840,857,1697,1,1,1,30,0,0
8580997,"Rehetobel, Schützenhaus",,0.000074,71,3,2,5,8689,8689,17378,2,0.75,0.833333,1040.911905,0,0
8580642,"Trient, camping",,0.000057,39,2,2,4,396,396,792,8,0.247059,0.346145,88.333333,0,0
8580646,"Chemin, sommet village",,0.000037,39,1,1,2,1246,1242,2488,6,0.264706,0.368519,0,0,0
8580553,"Flawil, Herrensberg",,0.000024,20,1,1,2,11633,11633,23266,7,0.25,0.370408,1393,0,0
8580554,"Flawil, Rütistrasse",,0.000031,20,1,1,2,11633,11633,23266,6,0.285714,0.408333,1200,0,0
8580555,"Flawil, Unterstrasse",,0.000037,20,1,1,2,11633,11633,23266,5,0.333333,0.456667,1005,0,0
8580556,"Flawil, Oberstrasse",,0.000043,20,1,1,2,11633,11633,23266,4,0.4,0.520833,808,0,0
8580557,"Flawil, Alterssiedlung",,0.000047,20,1,1,2,11633,11467,23100,3,0.5,0.611111,609,0,0
8580563,Lupsingen Pfarrhaus,,0.000027,2,1,1,2,17972,17972,35944,3,0.5,0.611111,297,0,0
8580564,Lupsingen Schützenhaus,,0.000034,2,1,1,2,17972,17972,35944,2,0.666667,0.75,200,0,0
8589702,Kriens Dattenmatt,,0.000036,90,1,2,3,11339,11336,22675,12,0.155951,0.187566,114,0,0
8589705,Kriens Friedhofstrasse,,0.000023,90,1,2,3,7316,7316,14632,12,0.155007,0.184802,300.333333,0,0
8589710,Kriens Grabenhof,,0.000043,90,2,3,5,38284,38114,76398,11,0.178019,0.217212,2199.020238,0,0
8580574,"Davos Monstein, Bahnhof",,0.000025,131,1,1,2,3623,3623,7246,16,0.135458,0.201711,1689.516667,0,0
8580575,"Sulz AG, Milchhüsli",,0.000063,57,1,1,2,3536,3465,7001,1,1,1,80,0,0
8580576,"Gressy, Moulin",,0.000059,35,2,1,3,5641,5809,11450,1,1,1,473,0,0
8580582,"Ganterschwil, Oetschwilerstr.",,0.000031,70,1,1,2,12820,12821,25641,1,1,1,374,0,0
8580588,"Cresciano, Stazione",,0.00006,108,2,1,3,19778,16265,36043,12,0.195122,0.229346,401,0,0
8580589,"Pollegio, Piazza",,0.00004,108,2,1,3,12752,12752,25504,15,0.137306,0.184711,608.866667,0,0
8580604,"Unterbach BE, Schulhaus",,0.000068,114,2,1,3,2851,2851,5702,16,0.104762,0.178053,1222,0,0
8581600,"Waltensburg/Vuorz, Mt. S.Gieri",,0.000081,110,1,1,2,2884,2606,5490,1,1,1,7.666667,0,0
8580614,"Bülach, Stadthalle",,0.000039,107,2,1,3,19280,19310,38590,13,0.159091,0.245879,653.166667,0.000178,0
8580615,"Bülach, Tiefengasse",,0.000044,107,1,2,3,19310,19337,38647,12,0.18018,0.303039,600.166667,0,0.000001
8582005,"Bülach, Einkaufszentrum Süd",,0.000114,107,3,1,4,18319,9892,28211,2,0.666667,0.75,67.666667,0,0.000005
8580623,"Bülach, Soliboden",,0.000072,107,5,1,6,10944,11012,21956,11,0.156627,0.250461,806,0.000208,0
8580624,"Bülach, Soligänter",,0.000072,107,1,1,2,11012,10980,21992,10,0.171429,0.266402,738,0,0
8580625,"Bülach, Schuemacher",,0.000072,107,1,1,2,10980,11016,21996,9,0.189655,0.285317,668,0,0
8580626,"Bülach, Hohfuri",,0.000072,107,1,1,2,11016,11017,22033,8,0.212766,0.308452,596,0,0
8580628,"Bülach, Obere Frohalde",,0.000072,107,1,1,2,11017,11019,22036,7,0.243243,0.338095,522,0,0
8580629,"Bülach, Untere Frohalde",,0.000072,107,1,1,2,11019,11020,22039,6,0.285714,0.379167,446,0,0
8580630,"Bülach, Stubenchlaus",,0.000072,107,1,1,2,11020,11006,22026,5,0.35,0.445238,368,0,0
8580631,"Bülach, Witenwisen",,0.000073,107,1,2,3,11006,10994,22000,4,0.461538,0.597222,288,0,0
8580632,"Bülach, Moritz-Meyer-Weg",,0.000042,107,1,1,2,10678,10642,21320,4,0.416667,0.516667,0,0,0
8580633,"Savièse, Chandolin sommet",,0.000047,39,1,1,2,30,30,60,1,1,1,23,0,0
8580634,"Mägenwil, Eckwil",,0.000039,22,2,1,3,7519,7391,14910,22,0.123729,0.142749,1099.439456,0.000193,0
8580635,"Bülach, Berglistrasse",,0.000077,107,2,2,4,10958,10226,21184,3,0.571429,0.708333,122,0,0
8580636,"Bülach, Güterbahnhof",,0.000044,107,1,1,2,5954,4155,10109,3,0.5,0.611111,0,0,0
8581780,"Bülach, Grampenweg",,0.000039,107,2,1,3,10856,9892,20748,3,0.5,0.611111,117.666667,0.000004,0
8590291,"Turgi, Gehling",,0.00003,22,1,1,2,12124,12124,24248,13,0.196203,0.276779,0,0.000024,0.000358
8590292,"Wettingen, Albisstrasse",,0.00008,22,5,3,8,18467,18467,36934,13,0.22,0.353943,6973.892803,0.000129,0.000376
8580639,"Ehrendingen, Breitwies",,0.000057,22,4,1,5,15295,96,15391,1,1,1,261.5,0.000425,0
8582526,"Rietheim, Badstrasse",,0.000032,98,1,1,2,397,397,794,1,1,1,16.5,0,0
8580640,Au,,0.000028,100,1,1,2,3728,3728,7456,1,1,1,18,0,0
8580641,"St-Luc, Tsampetros",,0.000055,39,1,1,2,2336,2336,4672,1,1,1,12,0,0
8580643,"Martigny-Combe, Le Chanton",,0.000061,39,2,3,5,847,847,1694,7,0.30303,0.432619,401.833333,0,0
8580649,"Trient, Le Plan",,0.000055,39,1,2,3,396,180,576,8,0.230769,0.329762,20.5,0,0
8580756,"Le Fays, village",,0.000052,39,2,2,4,660,660,1320,7,0.278689,0.391317,54.5,0,0
8581463,"Branson, Pont du Rhône",,0.000105,39,5,3,8,7667,7224,14891,7,0.306452,0.442231,3006.533333,0,0
8582551,"Martigny-Combe, Chalet Forêt",,0.000056,39,2,1,3,236,236,472,7,0.266667,0.353274,16,0,0
8580644,"Ravoire, colonie",,0.000037,39,1,1,2,1147,1147,2294,6,0.25,0.352083,16.333333,0,0
8582639,"Martigny, Place de Rome",,0.000141,39,5,4,9,4591,4387,8978,6,0.340909,0.51,2646.35,0,0
8583414,"Le Cergneux, hameau",,0.000041,39,1,1,2,660,660,1320,6,0.25,0.352083,0,0,0
8583563,"Chemin, Les Frênes",,0.000068,39,2,2,4,1278,1282,2560,5,0.32,0.466667,271.083333,0,0
8580648,"Trient, bif. rte Finhaut",,0.000052,39,2,1,3,396,396,792,9,0.195876,0.26746,43.5,0,0
8580652,"Torgon, La Cheurgne",,0.000056,103,2,1,3,1469,1469,2938,5,0.315789,0.422222,117,0,0
8580653,"Torgon, douane",,0.000058,103,1,1,2,1469,1469,2938,4,0.384615,0.483333,85,0,0
8580654,"Torgon, Sur Mayen",,0.000061,103,1,1,2,1469,1469,2938,3,0.5,0.583333,51,0,0
8581050,"Aigle, La Mêlée",,0.000061,103,2,1,3,1475,865,2340,2,0.666667,0.75,68,0,0
8580656,"Le Flon, village",,0.000051,103,1,1,2,1147,1147,2294,1,1,1,26,0,0
8580659,"Argnou (Ayent), d'en Haut",,0.000064,39,2,1,3,1092,1092,2184,21,0.101681,0.124685,1223,0,0
8580660,"Blignou (Ayent), Corbarare",,0.000065,39,1,1,2,1092,1016,2108,20,0.112299,0.139549,1272,0,0
8580664,"Daillon, Ferme Coppex",,0.00004,38,1,1,2,2241,2159,4400,1,1,1,4,0,0
8580666,"La Place (Ayent), bif. Villa",,0.000066,39,1,1,2,1016,1016,2032,19,0.125502,0.160502,1319,0,0
8580669,"Bex, En Bellin",,0.000059,103,1,1,2,519,519,1038,1,1,1,33,0,0
8580670,"Mase, église",,0.000054,39,1,1,2,1975,1975,3950,22,0.092762,0.122714,355.833333,0,0
8580672,"La Vernaz VS, d'en-Haut",,0.000035,39,1,2,3,2998,2998,5996,3,0.478261,0.545455,485,0,0
8581067,"Les Agettes, Tsamorés",,0.000026,39,1,2,3,2639,2639,5278,3,0.47619,0.55,103,0,0
8582387,"Les Agettes, d'en haut",,0.000022,39,1,1,2,2521,2507,5028,3,0.45,0.5,0,0,0
8582580,"Veysonnaz, Pranu",,0.000048,39,2,1,3,1207,1087,2294,3,0.45,0.5,377,0,0
8580673,"Euseigne, la Combaz",,0.000036,39,1,1,2,2469,2469,4938,18,0.134069,0.176961,2077,0,0
8580678,"Zimmerwald, Eichacher",,0.000042,44,2,1,3,6062,6062,12124,4,0.4,0.520833,4884,0,0
8580681,"Gams, Schulhaus Höfli",,0.000074,73,1,2,3,8030,7794,15824,14,0.154229,0.217479,4441.421429,0,0
8587491,"Rüthi (Rheintal), Industrie",,0.000054,73,1,2,3,16225,16225,32450,14,0.156479,0.219797,2058,0,0
8587496,Büchel bei Rüthi (Rheintal),,0.00004,73,1,2,3,7891,7891,15782,14,0.154229,0.217479,84,0,0
8588954,"Haag (Rheintal), Haag-Center",,0.000039,73,1,1,2,16142,16156,32298,4,0.4,0.46875,14729.104762,0,0
8580684,"Goldach, Kronenplatz",,0.000038,72,1,1,2,15337,15337,30674,16,0.146597,0.21955,558,0,0
8580687,"St. Gallen, Obere Waid",,0.000068,71,2,1,3,9113,9113,18226,19,0.142678,0.165928,784,0,0
8589551,"St. Gallen, Ahorn",,0.000081,71,5,3,8,49993,50002,99995,12,0.19,0.235464,3897.168343,0,0
8589558,"St. Gallen Winkeln, Bahnhof",,0.000042,71,2,3,5,47928,35687,83615,11,0.181682,0.226382,1526.417823,0,0
8583788,"Steinach, Hafen",,0.000066,71,1,2,3,8213,8153,16366,12,0.192751,0.235786,1271,0,0
8589563,"St. Gallen, Naturmuseum",,0.000047,71,3,2,5,28541,40302,68843,12,0.184049,0.227398,654.112687,0,0
8589578,"St. Gallen, Gröblistrasse",,0.000039,71,2,4,6,66470,66470,132940,12,0.205575,0.270605,778.836916,0,0
8580692,"Goldach, Appenzeller Strasse",,0.000048,72,2,1,3,14300,14300,28600,16,0.146597,0.21955,1060.166667,0,0
8581647,"Cappella-Agnuzzo, Stazione",,0.000053,102,4,2,6,23462,6284,29746,10,0.214437,0.248637,1501.364258,0,0
8580746,"Bioggio, Centro Commerciale",,0.00003,102,1,1,2,7981,8233,16214,5,0.36,0.438889,22.9,0,0
8580971,"Manno, Scuole",,0.000087,102,1,2,3,23107,17840,40947,4,0.45,0.546296,328.206818,0,0
8584709,"Comano, Municipio",,0.000055,102,2,1,3,15934,8477,24411,5,0.36,0.438889,20.002489,0,0
8591626,"Massagno, Santa Lucia",,0.000086,102,2,3,5,54198,48680,102878,8,0.285714,0.389328,676.6,0,0
8591653,"Viganello, Centro",,0.000171,102,6,5,11,116700,105280,221980,7,0.333333,0.464469,3599.545346,0,0
8580701,"Bioggio, Via Industria",,0.00008,102,1,1,2,22904,22904,45808,14,0.12333,0.140058,2546.833333,0,0
8580702,"Bioggio, Cavezzolo",,0.000078,102,1,1,2,22904,22904,45808,13,0.139508,0.158493,2388.833333,0,0
8580712,"Manno, Michelino",,0.000089,102,2,1,3,23127,23107,46234,5,0.333333,0.403333,596.206818,0,0
8582579,"Schluein, Casanova",,0.000136,110,4,1,5,8406,2967,11373,1,1,1,31.333333,0,0
8580720,"Oberegg AI, Rutlenstrasse",,0.000104,73,4,2,6,5835,5835,11670,15,0.107143,0.162222,6432.466667,0,0
8581403,"Oberegg AI, Bäumen",,0.000055,73,1,1,2,1071,1014,2085,15,0.105012,0.143181,0,0,0
8580721,"Robasacco, Curva Steiner",,0.000022,108,2,1,3,1549,1549,3098,14,0.128492,0.154155,138,0,0
8580723,"Robasacco, Bivio Sasselli",,0.000017,108,1,1,2,300,1746,2046,14,0.128492,0.154155,46,0,0
8582461,"Niederrohrdorf, Egro",,0.000095,22,6,2,8,17960,17025,34985,21,0.149767,0.1771,7172.143074,0.004018,0.003514
8582053,"Laufenburg, Werkstrasse",,0.000098,57,4,1,5,13119,2642,15761,1,1,1,78,0,0
8580758,"Salavaux, école",,0.000102,126,5,2,7,5151,5151,10302,6,0.30303,0.44,783,0,0
8583520,"Avenches, route du Lac",,0.000093,126,1,3,4,6139,5410,11549,3,0.6,0.722222,654.333333,0,0
8580759,"Avenches, L'Eau-Noire",,0.000054,126,1,2,3,3562,3562,7124,5,0.346154,0.466667,423,0,0
8581750,"Cudrefin, La Sauge",,0.000034,126,1,1,2,1720,1720,3440,5,0.32,0.4,0,0,0
8583515,"Avenches, plage",,0.000023,126,2,3,5,2577,2577,5154,5,0.37931,0.518182,1442.166667,0,0
8583517,"Avenches, Joli-Val",,0.000038,126,2,2,4,2931,2931,5862,4,0.409091,0.509259,468.666667,0,0
8583518,"Avenches, Montmezard",,0.000027,126,1,2,3,2814,2814,5628,3,0.470588,0.5625,314.666667,0,0
8580761,"Ellikon a. d. Thur, Dorf",,0.000047,64,2,1,3,7632,2678,10310,1,1,1,5,0,0
8580765,"St-Maurice VS, Grotte aux Fées",,0.000066,37,1,1,2,1024,1024,2048,2,0.666667,0.75,30,0,0
8580768,"Grimentz, les Aires",,0.00003,39,1,1,2,2468,2306,4774,5,0.333333,0.456667,30,0,0
8580769,"Waltensburg/Vuorz, Crap Martin",,0.000083,110,5,1,6,2884,2884,5768,2,0.666667,0.75,65.666667,0,0
8580772,"Corcelles NE, rue à Jean",,0.000025,134,2,1,3,6918,6918,13836,3,0.5,0.611111,602,0,0
8580774,"La Côte-aux-Fées, Bellevue",,0.000069,35,3,2,5,4620,4620,9240,2,0.75,0.833333,222,0,0
8583729,"La Côte-aux-Fées, garage",,0.00004,35,1,1,2,3407,3407,6814,2,0.666667,0.75,0,0,0
8580788,"Cadenazzo, Stazione",,0.000161,108,5,4,9,25258,18153,43411,12,0.168856,0.224555,44706.404762,0,0
8580783,"Schiers, Büel",,0.000068,112,2,1,3,2397,2356,4753,3,0.444444,0.541667,5916,0,0
8580784,"Schiers, Schibabüel",,0.000068,112,1,1,2,2356,2370,4726,2,0.6,0.666667,4440,0,0
8581551,"Bellinzona, Via Pellandini",,0.000235,108,10,9,19,144103,145374,289477,10,0.287823,0.39216,43550.057143,0,0
8581586,"S. Antonino, Via Tellina",,0.000071,108,2,2,4,14823,14722,29545,11,0.176471,0.241462,1242.792857,0,0
8581300,"Cadenazzo, Scuola Media",,0.000045,108,1,1,2,2026,2026,4052,2,0.666667,0.75,0,0,0
8581587,"S. Antonino, Lati",,0.000109,108,4,3,7,17293,15928,33221,11,0.175497,0.249163,17494.086905,0,0
8581588,"S. Antonino, Via Serrai",,0.000053,108,2,2,4,19665,21406,41071,11,0.172757,0.234724,15,0,0
8580795,"Wila, Espistrasse",,0.000061,84,1,1,2,1090,1090,2180,1,1,1,46,0,0
8580796,"Wiesendangen, Oberdorf",,0.000033,68,1,1,2,390,390,780,2,0.666667,0.75,15,0,0
8581317,"Piotta, Nord",,0.000112,108,2,4,6,19494,19408,38902,13,0.177778,0.283416,1676.25,0,0
8581715,"Biasca, al Ponte",,0.000051,108,1,2,3,12752,12752,25504,9,0.233083,0.309844,2126.016667,0,0
8581039,"Landquart, Forum im Ried",,0.000066,109,1,2,3,16700,16700,33400,24,0.138327,0.185581,5547,0,0
8580812,Lupsingen Höfli,,0.00004,2,1,1,2,17972,17972,35944,1,1,1,101,0,0
8582944,"Sion, Dames blanches",,0.000042,39,2,2,4,1094,1094,2188,16,0.135714,0.194717,937.5,0,0
8580817,"Iseltwald, Unterschwand",,0.000036,43,2,1,3,3348,3348,6696,5,0.352941,0.463889,140,0,0
8582505,"Sion, Chapelle",,0.000042,39,2,3,5,5078,3204,8282,3,0.583333,0.690476,503.17619,0,0
8580821,"Reinach AG, Hochhaus",,0.000034,59,2,1,3,8406,8070,16476,13,0.147208,0.206335,738,0,0
8580822,"Beinwil am See, Bahnhof",,0.00004,59,1,2,3,8070,8408,16478,12,0.166667,0.245197,645,0,0
8580823,"Schwarzenbach LU, Löwen",,0.000028,59,1,1,2,4565,4297,8862,12,0.161677,0.217241,0,0,0
8580824,"Menziken, Bahnhof",,0.000051,59,2,1,3,8140,8070,16210,11,0.185714,0.250261,453,0,0
8580825,"Reinach AG, Bahnhof",,0.000055,59,1,2,3,8070,8070,16140,10,0.219298,0.314206,354,0,0
8580832,"Beromünster, Winon",,0.000034,59,1,1,2,4297,4297,8594,10,0.212389,0.285632,0,0,0
8580827,"Zeneggen, Gstei",,0.000042,40,2,1,3,2176,2177,4353,4,0.4,0.520833,177,0,0
8580829,"Zeneggen, Sonnenberg",,0.000059,40,2,1,3,2248,2176,4424,2,0.666667,0.75,69,0,0
8580865,"Tübach, Waldegg",,0.000026,71,1,1,2,8277,8217,16494,14,0.143469,0.169126,2597.5,0,0
8580867,"Tübach, Sonne",,0.00002,71,1,1,2,64,64,128,21,0.0739,0.089331,1128,0,0
8580868,"Steinach, Obersteinach Käserei",,0.000028,71,1,1,2,64,64,128,20,0.079164,0.094515,689,0,0
8580869,"Steinach, Schule",,0.000035,71,1,1,2,64,64,128,19,0.085282,0.100628,248,0,0
8580919,"Arbon, Bündnerhof",,0.000034,71,1,2,3,15200,15198,30398,19,0.090776,0.121118,6908,0,0
8580870,"Arbon, Landquartstrasse",,0.000027,71,2,1,3,15200,15200,30400,20,0.083836,0.106797,7348,0,0
8580872,"Uster, Ackerstrasse",,0.000028,84,1,1,2,18489,18487,36976,5,0.333333,0.436111,468,0,0
8580874,"Uster, Krämeracker",,0.000035,84,1,1,2,18487,18488,36975,4,0.416667,0.516667,395,0,0
8580877,"Uster, Sonnenberg",,0.000041,84,1,2,3,18488,18489,36977,3,0.571429,0.708333,320,0,0
8581538,"Uster, Seeweg",,0.000028,84,1,1,2,18365,18364,36729,3,0.5,0.611111,0,0,0
8580879,"Uster, Stadthaus",,0.000092,84,4,2,6,18931,18906,37837,2,0.75,0.833333,128.733333,0,0
8581543,"Uster, Krone",,0.000053,84,1,1,2,17787,17786,35573,2,0.6,0.666667,180.266667,0,0
8581546,"Uster, Nossikon",,0.000095,84,2,2,4,18406,14580,32986,1,1,1,141.333333,0,0
8588883,"Wald ZH, Katholische Kirche",,0.000094,67,1,4,5,4701,3728,8429,12,0.183544,0.308868,851,0,0
8589512,"Rapperswil SG, Attenhoferstr.",,0.000061,67,2,5,7,17090,16244,33334,10,0.245283,0.406288,4317.666667,0,0
8582116,"Mathon, Muntsulej",,0.000056,109,1,1,2,2536,402,2938,1,1,1,0,0,0
8580890,"Vétroz, le Home",,0.000084,39,5,1,6,9416,9901,19317,9,0.227723,0.308627,3431.009524,0,0
8580894,"Auenstein, Eggen",,0.000048,58,1,1,2,2801,3033,5834,4,0.4,0.520833,28,0,0
8580895,"Auenstein, Hausacher",,0.000052,58,1,1,2,3033,3033,6066,3,0.5,0.611111,17,0,0
8580897,"Auenstein, Rütigasse",,0.000095,58,2,1,3,3991,2070,6061,1,1,1,17,0,0
8580903,"Glarus, Friedhof",,0.000025,106,1,1,2,4794,4794,9588,2,0.666667,0.75,24,0,0
8580904,"Glarus, Schützenhaus",,0.000032,106,1,1,2,4794,4794,9588,1,1,1,13,0,0
8580906,"Riedern GL, Lerchen",,0.000041,106,1,1,2,4830,4611,9441,4,0.4,0.520833,43,0,0
8580918,"Rorschacherberg, Seehalde",,0.000078,72,2,1,3,15384,15384,30768,15,0.153846,0.236176,569,0,0
8594347,"St. Gallen, Kantonsschule",,0.000049,71,1,1,2,18816,21725,40541,7,0.266667,0.386607,96,0,0
8580922,"Mutten, Unterdorf",,0.000064,109,2,1,3,1491,1350,2841,3,0.5,0.611111,1209,0,0
8580925,"Niederscherli, Bahnhof",,0.000047,44,1,1,2,3422,3422,6844,3,0.5,0.611111,2535,0,0
8580928,"Pianezzo, Ronchetti",,0.000092,108,2,1,3,8578,8578,17156,10,0.189427,0.249972,860,0,0
8581595,"S. Antonino, Paese",,0.000094,108,3,2,5,23628,23628,47256,10,0.197581,0.269363,16981,0,0
8582978,"Camorino, Ufficio Circolazione",,0.000061,108,1,2,3,17728,17728,35456,10,0.192982,0.267018,180,0,0
8582981,"Arbedo, Rotondello",,0.000044,108,1,2,3,18644,18779,37423,10,0.192982,0.267018,1014,0,0
8582982,"Castione, Via Cantonale",,0.00003,108,1,1,2,18537,18537,37074,10,0.189427,0.249972,0,0,0
8582988,"Giubiasco, Borghetto",,0.000059,108,2,1,3,11486,11486,22972,10,0.189427,0.249972,0,0,0
8580930,"Degersheim, Wolfhag",,0.000047,20,1,1,2,3379,3379,6758,1,1,1,228,0,0
8580933,"Büren SO, Moosmatt",,0.000064,2,1,1,2,4394,441,4835,1,1,1,35,0,0
8580938,"Gossau SG, Lerchenstrasse",,0.000036,71,2,2,4,5931,5931,11862,3,0.571429,0.708333,788,0,0
8588724,"Gossau SG, Zeughausstrasse",,0.000026,71,1,1,2,5683,5683,11366,3,0.5,0.611111,0,0,0
8581119,"Bethlehem b. Bern, Riedernrain",,0.000077,44,4,1,5,7906,7906,15812,11,0.17382,0.212371,1377,0,0
8580947,"Wiggen, Wittenmoos",,0.00011,61,4,1,5,6200,6201,12401,5,0.333333,0.436111,126,0,0
8580948,"Wiggen, Schächli",,0.000104,61,1,1,2,6201,6201,12402,4,0.416667,0.516667,110,0,0
8580949,"Marbach LU, Geissenmoos",,0.0001,61,1,2,3,6201,6201,12402,3,0.571429,0.708333,92,0,0
8580950,"Marbach LU, Laui",,0.000053,61,1,1,2,4749,4749,9498,3,0.5,0.611111,0,0,0
8580951,"Mastrils, Tardisbrücke",,0.000023,109,1,1,2,3484,3484,6968,32,0.067802,0.080452,5845,0,0
8580952,"Mastrils, Rösliplatz",,0.00003,109,1,1,2,3484,2872,6356,31,0.072395,0.085782,5224,0,0
8580953,"Mastrils, Birke",,0.000037,109,1,1,2,2872,3373,6245,30,0.077681,0.09216,4601,0,0
8580954,"Mastrils, Piz Alun",,0.000042,109,1,1,2,3373,3373,6746,29,0.083828,0.099991,3976,0,0
8580955,"Mastrils, Feld",,0.000047,109,1,1,2,3373,3373,6746,28,0.091066,0.110026,3349,0,0
8580956,"Mastrils, Tretsch",,0.000051,109,1,2,3,3373,3373,6746,27,0.099715,0.124383,2720,0,0
8580957,"Mastrils, Isla",,0.000032,109,1,1,2,1615,1615,3230,27,0.099287,0.120194,0,0,0
8580961,"Eyholz, Abzw. Lalden",,0.00005,40,2,1,3,4033,2508,6541,2,0.666667,0.75,48.333333,0,0
8580966,"Gondo, Ramserna",,0.00008,40,2,2,4,1665,1556,3221,2,0.75,0.833333,677.5,0,0
8581060,"Eyholz, Brücke",,0.000056,40,3,1,4,1134,890,2024,2,0.666667,0.75,51.833333,0,0
8581518,"Ried-Brig, Bleiken",,0.000045,40,1,1,2,124,124,248,2,0.666667,0.75,0,0,0
8580969,Mettschlatt,,0.000045,66,1,1,2,4954,4963,9917,2,0.666667,0.75,64,0,0
8580970,"Oberschlatt TG, Dorf",,0.000049,66,1,1,2,4963,3241,8204,1,1,1,33,0,0
8591656,"Viganello, Villa Costanza",,0.00004,102,1,2,3,48905,48905,97810,4,0.461538,0.597222,128.742965,0,0
8594225,"Lugano, Via Balestra",,0.000096,102,2,2,4,34623,34623,69246,4,0.454545,0.616667,225.772186,0,0
8580973,"Mastrils, Tobel",,0.00006,109,2,2,4,3373,1615,4988,26,0.109705,0.137332,1456,0,0
8581037,"Landquart, Primarschule",,0.000109,109,1,1,2,16700,16700,33400,26,0.109647,0.134928,8003,0,0
8581038,"Landquart, Schulhaus Ried",,0.000129,109,2,2,4,16797,16807,33604,25,0.122558,0.157817,8356,0,0
8580974,"Manno, la Monda",,0.000078,102,1,1,2,22904,22904,45808,12,0.160763,0.184713,2228.833333,0,0
8580977,"Lyss, Industriezone Bernstr.",,0.00009,44,3,2,5,4577,4577,9154,22,0.125895,0.164653,208056.4,0,0
8581024,"Ammerzwil BE, Sandhubel",,0.000049,44,1,1,2,1024,1024,2048,22,0.125373,0.160675,0,0,0
8580978,"Medeglia, Sorgai",,0.000052,102,1,1,2,6671,6671,13342,2,0.666667,0.75,208,0,0
8580980,"Riazzino, Bivio Stradonino",,0.000031,101,1,1,2,18085,18085,36170,17,0.108314,0.124145,14280.4,0,0
8580982,"Gordola, Gnesa",,0.000094,101,2,1,3,29654,29654,59308,15,0.136187,0.158388,14936.4,0,0
8580986,"Minusio, Scuole Medie",,0.000048,101,1,1,2,18085,18085,36170,15,0.128277,0.145219,770,0,0
8580987,"Minusio, Via Verbano",,0.000052,101,1,1,2,18085,18085,36170,14,0.146079,0.166579,521,0,0
8587502,"Locarno, Panorama",,0.000017,101,1,1,2,8752,8785,17537,6,0.282051,0.362121,0,0,0
8591544,"Locarno, Belvedere",,0.000159,101,4,2,6,17425,17493,34918,6,0.323529,0.442424,926,0,0
8587766,"Arcegno, Cruglio",,0.000076,101,3,2,5,9753,9753,19506,6,0.285714,0.408333,311.313095,0,0
8591530,"Ascona, Via Pascolo",,0.000077,101,1,1,2,40786,40786,81572,6,0.27907,0.366667,224,0,0
8583674,"Monte Carasso, Camp di Nav",,0.000067,108,2,2,4,42469,42302,84771,1,1,1,1722,0,0
8591562,"Muralto, Simposio",,0.000148,101,1,2,3,23649,12046,35695,1,1,1,449,0,0
8591563,"Muralto, Via Sociale",,0.000058,101,1,1,2,42054,42054,84108,1,1,1,4,0,0
8591564,"Orselina, Albergo Orselina",,0.000085,101,1,1,2,17316,8783,26099,1,1,1,14,0,0
8591569,"Solduno, Selva",,0.000055,101,1,1,2,39548,39548,79096,1,1,1,22,0,0
8580992,"Locarno, Bivio Via Nessi",,0.00002,101,1,2,3,55801,55801,111602,13,0.159772,0.194757,2931.633333,0,0
8580993,"Locarno, Case Popolari",,0.00002,101,1,1,2,13747,13747,27494,13,0.158571,0.187502,0,0,0
8580996,"Altstätten SG, Kapf",,0.000031,73,1,1,2,1464,1464,2928,1,1,1,468,0,0
8581841,"Triesen, Sonnenkreisel",,0.000116,73,5,3,8,9794,8689,18483,2,0.8,0.875,1554.926754,0,0
8582113,"Trübbach, Fährhütte",,0.000044,73,1,1,2,3477,3477,6954,2,0.666667,0.75,0,0,0
8582436,"Schaan, Malarsch",,0.000046,73,2,1,3,5755,580,6335,2,0.666667,0.75,6,0,0
8581001,"Triesenberg, Tristel",,0.000051,73,1,1,2,1114,1114,2228,2,0.666667,0.75,48,0,0
8581002,"Triesenberg, Egga",,0.000054,73,1,1,2,1114,1114,2228,1,1,1,25,0,0
8581004,"Gamprin, Simmasguet",,0.000045,73,1,1,2,2531,2531,5062,6,0.243902,0.331667,1689,0,0
8581005,"Gamprin, Unterbühl",,0.000049,73,1,1,2,2531,2531,5062,5,0.290323,0.381481,1135,0,0
8581006,"Gamprin, Abzw. Badäl-Schlatt",,0.000053,73,1,2,3,2531,2333,4864,4,0.363636,0.489583,579,0,0
8581842,"Schellenberg, Sägaplatz",,0.000123,73,3,3,6,6941,4620,11561,1,1,1,1710,0,0
8581824,"Eschen, KiGa Schönabüel",,0.00006,73,1,1,2,2420,2153,4573,6,0.290323,0.387037,18,0,0
8582415,"Ruggell, Noflerstrasse",,0.000088,73,2,2,4,3133,3206,6339,5,0.363636,0.504167,592,0,0
8582567,"Ruggell, Zollamt",,0.000048,73,1,1,2,787,722,1509,5,0.333333,0.433333,0,0,0
8581009,"Malbun, Zentrum",,0.000061,73,1,1,2,1691,1691,3382,1,1,1,501,0,0
8581010,"Schellenberg, Klenn",,0.000073,73,2,2,4,4673,4673,9346,2,0.6,0.666667,133.5,0,0
8581011,"Schellenberg, Stotz",,0.000057,73,2,2,4,2268,2268,4536,2,0.6,0.666667,3265.5,0,0
8581013,"Schellenberg, Obergut",,0.000067,73,1,1,2,3928,3928,7856,2,0.571429,0.625,4,0,0
8581012,"Schellenberg, Hinterschloss",,0.000066,73,2,1,3,3928,3928,7856,3,0.416667,0.5,569,0,0
8581015,"Affoltern a.A., Friedhof",,0.000033,115,1,1,2,2944,2944,5888,13,0.105263,0.123326,204,0,0
8581017,"Schwenden i.D., Fildrichbrücke",,0.000075,46,1,1,2,1435,1435,2870,5,0.318182,0.409524,126,0,0
8581018,"Schwenden i. D., Geissboden",,0.000075,46,1,1,2,1435,1302,2737,4,0.4,0.486111,114,0,0
8581020,"Beatenberg, Altersheim",,0.00007,43,2,2,4,4824,4639,9463,1,1,1,376,0,0
8581361,"Unterseen, Birmse",,0.00004,43,1,1,2,4483,4661,9144,1,1,1,0,0,0
8581032,"Landquart, Fabriken",,0.000123,109,6,1,7,16700,16700,33400,28,0.090674,0.107772,10587,0,0
8581036,"Landquart, Post",,0.000115,109,1,1,2,16700,16700,33400,27,0.09924,0.119396,9296,0,0
8581077,"Igis, Rebhaldenweg",,0.000047,109,2,1,3,7546,7546,15092,24,0.088946,0.118055,3,0,0
8581202,"Saas i.P., Dorfplatz",,0.000071,112,2,2,4,7335,7350,14685,24,0.09542,0.133589,12325.5,0,0
8581042,"Igis, Kreuzwiese",,0.000051,109,2,1,3,9908,9908,19816,24,0.136579,0.177776,1528,0,0
8581652,"Cazis, Abzw. Klinik Beverin",,0.000046,109,1,4,5,5509,5509,11018,3,0.555556,0.666667,7833,0,0
8581350,"Zizers, Bild",,0.000097,109,1,3,4,11605,11976,23581,21,0.117371,0.183955,938,0,0
8581656,"Jenaz,Rosengarten/Schulanlagen",,0.000077,112,2,2,4,4750,4750,9500,22,0.113272,0.173034,9779.3,0,0
8581989,"Sevelen, Veltur",,0.000063,73,3,3,6,17349,17349,34698,22,0.143928,0.226427,89958.975698,0,0
8594405,"Chur, Benerpark",,0.00005,109,3,6,9,57843,55966,113809,5,0.385321,0.467063,18359.857563,0,0
8594406,"Chur, Berggasse",,0.000031,109,2,2,4,12851,12823,25674,7,0.254658,0.319744,8,0,0
8594413,"Chur, Eulengut",,0.000041,109,2,3,5,10371,10901,21272,6,0.291339,0.364414,77.166667,0,0
8594414,"Chur, Seniorenzentrum Cadonau",,0.000032,109,2,2,4,47858,44740,92598,7,0.251701,0.315122,38.833333,0,0
8594416,"Chur, Fontanaspital",,0.000069,109,5,5,10,17328,17482,34810,6,0.310345,0.411574,23491.004762,0,0
8594422,"Chur, Heckenweg",,0.000045,109,3,4,7,10385,10901,21286,7,0.29703,0.40254,5516.166667,0,0
8594415,"Chur, Fontanaplatz",,0.000031,109,1,1,2,5382,5382,10764,12,0.161616,0.246629,16,0,0
8594980,"Chur, City West",,0.000038,109,2,2,4,26742,26743,53485,3,0.555556,0.666667,71.666667,0,0
8582066,"Felsberg, Abzweigung",,0.000056,109,3,1,4,14923,12423,27346,2,0.666667,0.75,4.083333,0,0
8582141,"Bonaduz, Isla",,0.000054,109,4,2,6,8162,7444,15606,2,0.625,0.7,4772.3,0,0
8594444,"Chur, Sassal",,0.00007,109,2,2,4,10861,10863,21724,7,0.290323,0.454762,3918,0,0
8595592,"Chur, Postplatz",,0.000145,109,6,1,7,48151,21209,69360,1,1,1,16.5,0,0
8581051,"Sagogn, Fanaus",,0.000079,110,4,1,5,4501,4501,9002,3,0.5,0.611111,59,0,0
8581054,"Romanel-sur-Morges, Pra-Vuatte",,0.000036,5,2,2,4,9221,9221,18442,7,0.254335,0.304762,1137,0,0
8581918,"Bussigny, Grand-Record",,0.000052,5,2,2,4,15082,15106,30188,7,0.245989,0.299482,1297.166667,0,0
8581055,"Attelwil, Schule",,0.000079,59,4,1,5,7254,6484,13738,6,0.282051,0.362121,721,0,0
8581056,"Pfäffikon SZ, Tertianum",,0.000089,113,2,1,3,9723,9723,19446,2,0.666667,0.75,100,0,0
8581057,"Pfäffikon SZ, Gräfli",,0.000087,113,1,1,2,9723,9723,19446,1,1,1,51,0,0
8582752,"Birmensdorf ZH, Weissenbrunnen",,0.000028,85,1,2,3,1381,1380,2761,8,0.204494,0.23196,220.419048,0.000001,0.000103
8583047,"Aeugst am Albis, Grossacher",,0.000077,85,4,1,5,5140,1712,6852,8,0.204036,0.226465,450.978571,0.000014,0.000017
8581066,"St-Aubin NE, village",,0.000096,35,2,1,3,1199,1132,2331,3,0.5,0.611111,1350,0,0
8581068,"Vaumarcus, haut du village",,0.000092,35,1,1,2,1132,1132,2264,2,0.666667,0.75,902,0,0
8582802,"Kaiseraugst, Sagerweg",,0.000036,2,2,2,4,11577,11357,22934,7,0.259259,0.366156,1105,0,0
8582548,"Burg AG, Hinterdorf",,0.000031,59,1,1,2,3843,3843,7686,6,0.3,0.392593,620,0,0
8581085,"Sursee, Mariazell",,0.000088,59,5,1,6,21259,21329,42588,8,0.226804,0.286093,1616.966667,0,0
8581097,"Saanenmöser, Mösching",,0.000044,42,3,1,4,439,425,864,10,0.205128,0.296156,35,0,0
8581100,"Mase, Les Terresses",,0.000056,39,1,1,2,1975,1975,3950,21,0.101124,0.136995,315.833333,0,0
8582949,"Nax, Via Ferrata",,0.000086,39,2,2,4,1797,602,2399,1,1,1,580,0,0
8582950,"Eison, Felliny",,0.000071,39,2,1,3,1800,1338,3138,1,1,1,13.166667,0,0
8581103,"Wald ZH, Pflegezentrum",,0.000055,67,1,1,2,551,551,1102,17,0.107595,0.158775,238,0,0
8587950,"Steg im Tösstal, Bahnhof",,0.000045,67,2,2,4,980,919,1899,14,0.151111,0.23729,1419,0,0
8581243,"Bellinzona, Saleggi",,0.000053,108,2,1,3,28283,30462,58745,15,0.128205,0.154034,1774,0,0
8581106,"Bözberg, Mittlerer Hafen",,0.000069,57,1,1,2,5465,5465,10930,3,0.5,0.611111,297,0,0
8581107,"Bözberg, Oberer Hafen",,0.00007,57,1,1,2,5465,5465,10930,2,0.666667,0.75,200,0,0
8581111,"Le Fuet, carrefour",,0.000093,1,4,2,6,2763,2834,5597,3,0.555556,0.666667,127.666667,0,0
8581116,"Orbe, gare",,0.000238,35,12,3,15,39822,39978,79800,5,0.40625,0.528205,3457,0,0
8595068,"Yverdon-les-Bains, rue d'Orbe",,0.000229,35,8,4,12,49473,31627,81100,2,0.833333,0.9,3783,0,0
8581146,"Moutier, Suisse Est",,0.000075,1,3,2,5,6520,4719,11239,4,0.461538,0.597222,79.833333,0,0
8581151,"Moutier, Etoile",,0.000054,1,1,1,2,4105,771,4876,2,0.666667,0.75,6,0,0
8581147,"Moutier, Neusté",,0.000043,1,1,1,2,4433,4441,8874,5,0.333333,0.456667,54,0,0
8581148,"Moutier, Petite-Fin",,0.000047,1,1,1,2,4441,4441,8882,4,0.4,0.520833,40,0,0
8581149,"Moutier, Chantemerle",,0.000051,1,1,1,2,4441,4105,8546,3,0.5,0.611111,24,0,0
8581155,"Scheid, Curgiola",,0.000069,111,1,1,2,748,748,1496,3,0.5,0.611111,36,0,0
8581156,"Feldis/Veulden, Nurlagn",,0.000069,111,1,1,2,748,747,1495,2,0.666667,0.75,26,0,0
8581158,"Schwarzenberg LU, Fabrikli",,0.000064,90,2,1,3,4388,4388,8776,2,0.666667,0.75,146,0,0
8581159,"Schwarzenberg LU, Lifelen",,0.000065,90,1,1,2,4388,3194,7582,1,1,1,74,0,0
8581160,"Alpnach Dorf, Schoried",,0.000029,62,1,1,2,3667,3593,7260,4,0.4,0.520833,102,0,0
8581164,"Alpnach Dorf, Hofmättelikreuz",,0.000036,62,1,1,2,3593,2455,6048,3,0.5,0.611111,54,0,0
8581167,"Breil/Brigels, S. Giacun",,0.000061,110,2,1,3,2301,1209,3510,1,1,1,35,0,0
8581169,"Valendas, Dorf",,0.000038,110,2,1,3,2491,2491,4982,4,0.384615,0.483333,114,0,0
8581170,"Valendas, Abzw. Brün",,0.000043,110,1,1,2,2491,2491,4982,3,0.5,0.583333,62,0,0
8581598,"Castrisch, Schleps",,0.000053,110,1,1,2,2281,2281,4562,1,1,1,55,0,0
8581172,"Castrisch, vitg",,0.00005,110,2,1,3,2566,2281,4847,2,0.666667,0.75,113,0,0
8581175,"Jenaz, Marktplatz",,0.000092,112,4,2,6,4514,4750,9264,23,0.115837,0.171301,60199.383333,0,0
8581196,"Serneus, Dorf",,0.000048,112,2,2,4,6900,7360,14260,26,0.088599,0.133523,2268.583333,0,0
8581197,"Serneus, Walki",,0.000031,112,1,1,2,7277,13842,21119,26,0.087973,0.126754,0,0,0
8581176,"Schiers, Kirchgemeindehaus",,0.000069,112,1,2,3,2370,1150,3520,1,1,1,2962,0,0
8582203,"Schiers, Schulhaus Feld",,0.00004,112,1,1,2,239,77,316,1,1,1,0,0,0
8581199,"Serneus, Mezzaselva",,0.000097,112,3,3,6,13987,13895,27882,25,0.095705,0.151436,47815.666667,0,0
8581201,"Saas i.P., Ufm Ried",,0.000038,112,1,1,2,4203,7273,11476,25,0.087744,0.116727,0,0,0
8581441,"Saas i.P., Mülitobel",,0.000032,112,1,2,3,3276,3725,7001,29,0.086826,0.164959,1173.5,0,0
8581443,"Küblis, Prada",,0.000052,112,2,1,3,7165,7165,14330,29,0.085457,0.150309,57,0,0
8581203,"Saas i.P., Old-Inn",,0.000041,112,1,1,2,7288,7288,14576,32,0.072855,0.122261,9704,0,0
8581204,"Saas i.P., Waldhof",,0.000046,112,1,1,2,7288,7288,14576,31,0.077313,0.134262,7831,0,0
8581206,"Flawil, Reithalle",,0.000058,20,3,2,5,7561,6826,14387,2,0.75,0.833333,488,0,0
8583510,"Bichwil, Riggenschwil",,0.000076,20,2,1,3,11272,5908,17180,1,1,1,205,0,0
8581228,"Feldis/Veulden, Schulhaus",,0.00007,111,1,1,2,747,748,1495,1,1,1,14,0,0
8581240,"Artore, Paese",,0.000029,108,1,1,2,7292,7292,14584,6,0.294118,0.378333,2565.25,0,0
8582990,"Giubiasco, Stazione",,0.000286,108,8,5,13,93320,83722,177042,9,0.228261,0.343868,17599.397619,0,0
8581245,"Camorino, Villaggio",,0.000088,108,2,2,4,36362,36276,72638,14,0.145329,0.180173,4393,0,0
8581252,"Arbedo, Casa Comunale",,0.000052,108,1,1,2,31232,31232,62464,14,0.142609,0.166274,82,0,0
8581844,"Varenzo, Paese",,0.000035,108,1,1,2,3759,3917,7676,6,0.3,0.392593,81,0,0
8587460,"Varenzo, Bivio",,0.000084,108,2,2,4,12733,12733,25466,6,0.322581,0.453333,691.983333,0,0
8587461,"Giornico, Fraggio",,0.000077,108,2,2,4,12752,12397,25149,5,0.36,0.485185,298.833333,0,0
8581251,"Arbedo, Chiesa",,0.000048,108,1,1,2,30376,31232,61608,15,0.12614,0.147706,848,0,0
8581256,"Camorino, Bivio Comelina",,0.000092,108,2,1,3,37132,36141,73273,13,0.1643,0.192945,2095,0,0
8581257,"Giubiasco, alla Morobbia",,0.000089,108,1,2,3,36141,36141,72282,12,0.194175,0.236826,1325,0,0
8581281,"Wollerau, Untere Sihlegg",,0.000116,113,1,1,2,25988,16889,42877,3,0.5,0.583333,56,0,0
8581265,"Pfäffikon SZ, Löwen",,0.000047,113,2,1,3,28046,28520,56566,15,0.123894,0.189993,1452,0,0
8581266,"Pfäffikon SZ, Rain",,0.000051,113,1,1,2,28520,28520,57040,14,0.136364,0.21352,1413,0,0
8581267,"Freienbach, Grütze",,0.000054,113,1,2,3,28520,28032,56552,13,0.152047,0.260898,1372,0,0
8581269,"Freienbach, alte Post",,0.00004,113,1,1,2,13039,13217,26256,13,0.142857,0.220139,24,0,0
8581268,"Freienbach, Kirche",,0.000034,113,1,1,2,12729,13039,25768,14,0.129534,0.197268,69,0,0
8581270,"Freienbach, Oechsli",,0.000068,113,2,2,4,28520,28520,57040,12,0.159722,0.266221,1237,0,0
8581271,"Freienbach, Leutschen",,0.00004,113,1,1,2,13217,13217,26434,11,0.157895,0.25999,468,0,0
8581272,"Freienbach, Chrummen",,0.000045,113,1,1,2,13217,13217,26434,10,0.171875,0.276371,407,0,0
8581273,"Freienbach, Bahnhof SOB",,0.00004,113,1,1,2,15303,15303,30606,9,0.2,0.31433,648,0,0
8581274,"Freienbach, Gehren",,0.000045,113,1,1,2,15303,15303,30606,8,0.222222,0.339732,584,0,0
8581275,"Wilen bei Wollerau, Eulen",,0.000049,113,1,1,2,13217,13217,26434,9,0.188679,0.295397,344,0,0
8581276,"Wilen bei Wollerau, Obereulen",,0.000052,113,1,1,2,13217,12399,25616,8,0.209302,0.317857,279,0,0
8581277,"Wilen bei Wollerau, Bahnhof",,0.000055,113,1,1,2,12399,11911,24310,7,0.235294,0.34494,212,0,0
8581278,"Wilen bei Wollerau, Schlyffi",,0.000058,113,1,1,2,11911,13217,25128,6,0.269231,0.378571,143,0,0
8581280,"Wollerau, Sonnenberg",,0.000124,113,3,1,4,26462,25988,52450,4,0.384615,0.483333,131,0,0
8581286,"Egerkingen, Zentrum",,0.000043,94,1,1,2,14412,14412,28824,20,0.103896,0.182942,633,0,0
8581287,"Egerkingen, Widenfeld",,0.000048,94,1,1,2,14412,14412,28824,19,0.111111,0.197728,543,0,0
8581293,"Escholzmatt, Bahnhof",,0.000099,61,2,1,3,6201,6201,12402,2,0.666667,0.75,50,0,0
8581295,"Homburg, Eugerswil",,0.00004,65,1,1,2,233,223,456,1,1,1,21,0,0
8581306,"Wabern, Kleinwabern",,0.000046,44,1,1,2,6062,6062,12124,3,0.5,0.611111,3666,0,0
8581307,"Ueberstorf, Dorfstrasse",,0.000053,126,3,1,4,2764,5110,7874,11,0.150273,0.170635,331,0,0
8581318,"Giornico, Parondino",,0.000059,108,2,1,3,12752,12397,25149,12,0.160448,0.203729,2142,0,0
8581327,"Toffen, Bahnhof",,0.000082,44,1,1,2,4686,2343,7029,2,0.666667,0.75,134,0,0
8581334,"Saas-Grund, Niwi",,0.000084,41,2,1,3,5287,1739,7026,1,1,1,14,0,0
8581344,"Boussens, village",,0.000059,5,2,1,3,8632,3669,12301,1,1,1,204,0,0
8581348,"Zizers, Stutz",,0.000106,109,4,1,5,11977,11977,23954,23,0.096682,0.130907,4608,0,0
8581349,"Zizers, Rathaus",,0.000101,109,1,1,2,11977,11605,23582,22,0.105981,0.149796,2774,0,0
8582197,"Chur, Quaderwiese",,0.000102,109,4,4,8,39804,40340,80144,21,0.12192,0.194631,58531.322826,0,0
8582864,"Klosters, Rufinis",,0.000085,112,2,2,4,7042,6624,13666,21,0.119403,0.234896,16281.5,0,0
8583205,"Bern, Melchiorstrasse",,0.000045,44,1,1,2,26285,26285,52570,1,1,1,4,0,0
8581356,"Schönried, Schulhaus",,0.000133,42,5,1,6,2575,2561,5136,10,0.1875,0.297652,207,0,0
8581357,"Saanen, Halten",,0.000124,42,1,2,3,2561,2561,5122,9,0.211538,0.36324,149,0,0
8581358,"Saanen, Crestalta",,0.000064,42,1,1,2,1266,1266,2532,9,0.196078,0.299563,0,0,0
8581360,"Gstaad, Unter-Gstaad",,0.00027,42,6,1,7,11882,2423,14305,7,0.25,0.355357,592,0,0
8581362,"Diemtigen, Friedhof",,0.000074,46,1,2,3,1302,1302,2604,3,0.555556,0.666667,100,0,0
8581865,"Zwischenflüh, Allmiried",,0.000042,46,1,1,2,872,872,1744,3,0.5,0.583333,0,0,0
8581363,"Balm b. Meiringen, Schulhaus",,0.000069,114,1,1,2,2851,2851,5702,15,0.111702,0.186559,1178,0,0
8581364,"Balm b. Meiringen, Wirtschaft",,0.000069,114,1,1,2,2851,2851,5702,14,0.11976,0.196803,1132,0,0
8581366,"Hausen b. Meiringen, Platz",,0.00007,114,1,1,2,2851,2851,5702,13,0.129252,0.209986,1084,0,0
8581368,"Hausen b. Meiringen,Dorfbrunn.",,0.00007,114,1,1,2,2851,2851,5702,12,0.140625,0.229457,1034,0,0
8581369,"Meiringen, Gilli",,0.000071,114,1,2,3,2851,2851,5702,11,0.154545,0.271174,982,0,0
8581373,"Meiringen, Hallenbad",,0.000041,114,1,1,2,519,519,1038,11,0.146789,0.225622,0,0,0
8581370,"Meiringen, Alpbach Parkplatz",,0.000153,114,6,1,7,3430,3430,6860,11,0.153846,0.247944,2212,0,0
8581372,"Willigen, Klinik Reichenbach",,0.000071,114,1,1,2,1970,1970,3940,9,0.178082,0.262027,1833,0,0
8581374,"Meiringen, Kirchgemeindehaus",,0.000071,114,1,1,2,1970,1970,3940,8,0.2,0.282837,1704,0,0
8581375,"Meiringen, Luftseilbahn",,0.000071,114,1,1,2,1970,1970,3940,7,0.229167,0.309957,1573,0,0
8581376,"Meiringen, Molki",,0.000072,114,1,1,2,1970,1970,3940,6,0.27027,0.348333,1440,0,0
8583837,"Saxon, Rue de Gottefrey",,0.000067,39,1,1,2,564,564,1128,3,0.5,0.583333,4,0,0
8581381,"Grimentz, Carovilla",,0.000036,39,1,1,2,2306,2468,4774,4,0.4,0.520833,19,0,0
8581385,"Oberscherli, Haltlirain",,0.000051,44,1,1,2,3422,3422,6844,2,0.666667,0.75,1692,0,0
8581386,"Niederscherli, Burisholzweg",,0.000054,44,1,1,2,3422,3422,6844,1,1,1,847,0,0
8581393,"Mörschwil, Fahrn",,0.000055,71,2,1,3,8152,8153,16305,18,0.092481,0.107952,3983,0,0
8581394,"Mörschwil, Kirche",,0.000058,71,1,1,2,8153,8153,16306,17,0.101077,0.116896,3536,0,0
8581395,"Mörschwil, Altes Gemeindehaus",,0.00006,71,1,1,2,8153,8213,16366,16,0.111521,0.128085,3087,0,0
8581396,"Mörschwil, Bitzi",,0.000062,71,1,1,2,8213,8213,16426,15,0.124481,0.142527,2636,0,0
8581397,"Mörschwil, Lantschen",,0.000063,71,1,1,2,8213,8213,16426,14,0.140995,0.161992,2183,0,0
8581398,"Mörschwil, Alberenberg",,0.000065,71,1,1,2,8213,8213,16426,13,0.162759,0.190013,1728,0,0
8581401,"Herisau, Heinrichsbad",,0.000058,71,3,1,4,33652,32711,66363,13,0.154163,0.180749,5357.101401,0,0
8581409,Trüttlikon,,0.000048,65,1,1,2,4537,4537,9074,4,0.4,0.520833,680,0,0
8581410,"Oberwil TG, Dorf",,0.000066,65,1,1,2,6780,6780,13560,4,0.4,0.520833,712,0,0
8581424,"Oberbüren, Staubhusen",,0.000047,71,2,1,3,3269,3269,6538,19,0.088889,0.104461,3765.135134,0,0
8592144,"Montpreveyres, Riau-Graubon",,0.000143,13,1,2,3,3223,3027,6250,8,0.25641,0.421786,1568.633333,0,0
8592194,"Pully, Ravessoud",,0.000106,10,2,2,4,6077,5624,11701,7,0.290323,0.454762,1861.533333,0,0
8592225,"Ropraz, Home du Jorat",,0.000148,13,1,1,2,3223,2266,5489,7,0.25,0.370408,1135.866667,0,0
8581437,"Neyruz-sur-Moudon, collège",,0.000045,13,1,1,2,1835,1835,3670,17,0.118557,0.16023,1926.72619,0,0
8581440,"Serneus, Pagrüeg",,0.00005,112,1,2,3,7288,6839,14127,30,0.082418,0.15582,5956,0,0
8581442,"Saas i.P., Haus Fluor",,0.000032,112,1,1,2,3563,3563,7126,30,0.08,0.135331,968.5,0,0
8583379,"Sursee, Rathaus",,0.000037,59,1,2,3,6978,6615,13593,5,0.375,0.547222,16,0,0
8581447,"Leytron, Union",,0.000065,39,1,1,2,2553,2553,5106,5,0.28,0.383333,407,0,0
8581448,"Leytron, Haut de Dugny",,0.000066,39,1,1,2,2553,2553,5106,4,0.333333,0.430556,336,0,0
8581449,"Ettingen, Oberdorf",,0.000042,54,1,1,2,7355,7214,14569,9,0.2,0.31433,281,0,0
8581450,"Hofstetten SO, Ettingerstrasse",,0.000046,54,1,1,2,7214,7113,14327,8,0.222222,0.339732,254,0,0
8581452,"Serneus, Gruoba",,0.000096,112,3,1,4,16918,13430,30348,28,0.091803,0.173856,30314.166667,0,0
8581465,"Seseglio, Centro Sportivo",,0.000081,99,1,1,2,8601,8601,17202,12,0.173285,0.220743,190,0,0
8581466,"Sarnen, Kernserstrasse",,0.000108,62,4,1,5,13986,3663,17649,2,0.666667,0.75,230,0,0
8581467,"Sarnen, Schatzli",,0.000094,62,4,1,5,4231,4189,8420,1,1,1,54,0,0
8589509,"Vacallo, Sovernigo",,0.000044,99,1,2,3,7393,7393,14786,4,0.421053,0.53125,216.5,0,0
8589510,"Vacallo, Via Spinee",,0.00003,99,1,2,3,3987,3987,7974,3,0.5,0.595238,8,0,0
8581472,"Unterbach BE, Garage Egger",,0.000076,114,2,1,3,2851,2851,5702,10,0.16129,0.239974,872,0,0
8581473,"Unterbach BE, Unterheid",,0.000075,114,1,1,2,2851,2851,5702,9,0.179487,0.257596,814,0,0
8581474,"Unterbach BE, Stägmad",,0.000075,114,1,1,2,2851,2851,5702,8,0.203125,0.280311,754,0,0
8581475,"Unterbach BE, Flugplatz",,0.000074,114,1,1,2,2851,2851,5702,7,0.235294,0.311905,692,0,0
8581476,"Unterbach BE, Rössli",,0.000074,114,1,1,2,2851,2851,5702,6,0.282051,0.362121,628,0,0
8581479,"Balm b. Meiringen, Zaunstrasse",,0.000074,114,1,2,3,2851,2851,5702,5,0.357143,0.47,562,0,0
8581555,"Unterbach BE, Rollfeld",,0.000042,114,1,1,2,436,436,872,5,0.333333,0.411111,0,0,0
8581481,"Rorschach Stadt, Bahnhof",,0.000153,72,4,4,8,61153,60354,121507,13,0.201835,0.394552,12562,0,0
8591810,"Rorschach, Hauptbahnhof Süd",,0.000087,72,2,1,3,31696,20767,52463,3,0.5,0.611111,45,0,0
8591816,"Rorschach, Trischlistrasse",,0.000043,72,1,1,2,6735,6735,13470,3,0.5,0.611111,0,0,0
8581484,"Rorschacherberg, Seebleiche",,0.000043,72,1,2,3,31566,31696,63262,12,0.189474,0.32703,8580,0,0
8581531,"Staad SG, Bahnhof",,0.000065,72,1,1,2,10929,10929,21858,5,0.352941,0.463889,66,0,0
8581486,"Rorschacherberg, Hörnlibuck",,0.000029,72,1,1,2,10929,10929,21858,16,0.114094,0.203391,6303,0,0
8581487,"Staad SG, Hafen",,0.000036,72,1,1,2,10929,10929,21858,15,0.121212,0.212598,5746,0,0
8581488,"Staad SG, Speck",,0.000041,72,1,1,2,10929,10929,21858,14,0.12931,0.222831,5187,0,0
8581489,"Altenrhein, Flugplatz",,0.000046,72,1,1,2,10929,10929,21858,13,0.138614,0.234295,4626,0,0
8581490,"Altenrhein, Dorf",,0.00005,72,1,1,2,10929,10929,21858,12,0.149425,0.247256,4063,0,0
8581491,"Altenrhein, Am Rhein",,0.000053,72,1,1,2,10929,10929,21858,11,0.162162,0.262073,3498,0,0
8581492,"Altenrhein, Hegi",,0.000056,72,1,1,2,10929,10929,21858,10,0.177419,0.279257,2931,0,0
8581493,"Thal, Buriet",,0.000059,72,1,1,2,10929,10929,21858,9,0.196078,0.299563,2362,0,0
8581494,"Rheineck, Schwimmbad",,0.000061,72,1,1,2,10929,10929,21858,8,0.219512,0.324206,1791,0,0
8581504,"Oberdorf NW, Schulhaus",,0.000022,62,1,1,2,5445,5771,11216,4,0.4,0.486111,150,0,0
8581505,"Büren NW, Kirchenplatz",,0.000029,62,1,2,3,5771,5771,11542,3,0.555556,0.666667,130,0,0
8581521,"Oberdorf NW, Kaserne",,0.000037,62,1,1,2,5445,5445,10890,2,0.666667,0.75,4,0,0
8581508,"Altenrhein, Markthalle",,0.000063,72,1,1,2,10929,10929,21858,7,0.25,0.355357,1218,0,0
8581509,"Altenrhein, Schulhaus",,0.000064,72,1,1,2,10929,10929,21858,6,0.291667,0.397619,643,0,0
8581511,"Romairon, collège",,0.000061,35,3,1,4,581,581,1162,2,0.666667,0.75,1449,0,0
8581513,"Moudon, Chalet-Blanc",,0.000049,13,1,1,2,1835,1835,3670,16,0.131579,0.178849,1517.72619,0,0
8581519,"Stans, Engelbergstrasse",,0.000023,62,1,1,2,5445,5445,10890,4,0.4,0.520833,54,0,0
8581520,"Oberdorf NW, Wilrank",,0.000031,62,1,1,2,5445,5445,10890,3,0.5,0.611111,30,0,0
8581522,"Büren NW, Mühleplatz",,0.000055,62,2,1,3,5771,5445,11216,1,1,1,30,0,0
8581523,"Gerlikon, Dorf",,0.000067,65,1,1,2,6780,6780,13560,3,0.5,0.611111,537,0,0
8581526,"Habkern, Lombachbrücke",,0.000043,43,1,1,2,3220,3221,6441,2,0.666667,0.75,376,0,0
8581529,"Oeschgen, Brückenwaage",,0.000052,57,3,2,5,3730,3896,7626,5,0.347826,0.483333,632,0,0
8581530,"Münchwilen AG, Dell",,0.000033,57,1,1,2,3419,3273,6692,5,0.318182,0.409524,0,0,0
8582123,"Neftenbach, Wolfgässli",,0.000032,68,2,2,4,3437,3439,6876,3,0.571429,0.708333,74.85,0,0
8582180,"Seuzach, Forrenbergstrasse",,0.000033,68,2,2,4,3606,3610,7216,2,0.75,0.833333,201.483333,0,0
8588552,"Winterthur, Museumstrasse/HB",,0.000156,68,7,3,10,17260,16681,33941,6,0.342857,0.498611,1844.116667,0,0
8581536,"Dägerlen, Oberwil",,0.000045,68,2,1,3,6018,6017,12035,8,0.225806,0.301956,1339.790476,0,0
8581540,"Uster, Wildsbergstrasse",,0.000052,84,2,1,3,18488,18489,36977,2,0.666667,0.75,164,0,0
8581541,"Uster, Jungholz",,0.000055,84,1,1,2,18489,18489,36978,1,1,1,83,0,0
8581542,"Uster, Burgstrasse",,0.00005,84,2,1,3,17804,17787,35591,3,0.444444,0.541667,257.266667,0,0
8581544,"Uster, Bildungszentrum",,0.000032,84,1,1,2,20182,20182,40364,2,0.666667,0.75,156,0,0
8581545,"Uster, Jugendhaus",,0.000038,84,1,1,2,20182,19307,39489,1,1,1,79,0,0
8581549,"Oeschgen, Gemeindehaus",,0.000061,57,2,1,3,3750,3896,7646,4,0.4,0.486111,486,0,0
8581550,"Oeschgen, Hinterdorf",,0.000063,57,1,2,3,3896,3627,7523,3,0.555556,0.666667,410,0,0
8581951,"Eiken, Ost",,0.000047,57,1,1,2,3190,3190,6380,2,0.666667,0.75,4,0,0
8583009,"Bellinzona, Scuola Media 1",,0.00008,108,2,2,4,25968,25968,51936,5,0.4,0.535417,3104.916667,0,0
8581556,"Habkern, Steinacker",,0.000047,43,1,1,2,3221,3221,6442,1,1,1,189,0,0
8581559,"Brienz BE, Glyssibach",,0.000183,114,6,4,10,6652,6967,13619,8,0.305085,0.472288,1278,0,0
8581560,"Brienzwiler, Schlüssel",,0.00005,114,1,2,3,1522,1522,3044,8,0.27907,0.434821,0,0,0
8582661,"Schwanden b. Brienz, Weid",,0.000071,114,1,3,4,4505,3651,8156,8,0.263158,0.471786,10,0,0
8587024,"Axalp, Bellevue",,0.000061,114,1,1,2,975,975,1950,8,0.25,0.371786,40,0,0
8581649,"Summaprada, Dorf",,0.000067,109,2,2,4,5345,5532,10877,5,0.333333,0.428205,3599.7,0,0
8581562,"Meiringen, Altersheim",,0.000072,114,1,1,2,1970,1970,3940,5,0.333333,0.411111,1305,0,0
8581669,"Muri AG, Kreisel",,0.000098,115,7,2,9,13651,13066,26717,19,0.10509,0.123335,5235.363965,0.024824,0.000615
8581578,"Zernez, Center Parc Naziunal",,0.000062,30,2,1,3,3469,3162,6631,1,1,1,5,0,0
8581585,"Pfäffikon ZH, Frohwies",,0.000021,84,1,1,2,9060,9058,18118,8,0.217391,0.282302,154,0,0
8583357,"Lüterkofen, Schulhaus",,0.000063,87,3,1,4,949,431,1380,1,1,1,457.5,0,0
8581592,"Hausen b. Meiringen,Summerauli",,0.000078,114,2,2,4,2851,2851,5702,4,0.444444,0.552083,424,0,0
8581908,"Willigen, Unterdorf",,0.000072,114,1,2,3,1970,1185,3155,4,0.444444,0.552083,1168,0,0
8581992,"Meiringen, Spitalstrasse",,0.000075,114,2,2,4,3349,3827,7176,4,0.466667,0.583333,348,0,0
8581593,"Uzwil, Coop",,0.000046,20,3,1,4,11233,11574,22807,7,0.25,0.370408,1352,0,0
8581594,"St. Urban, Sonnhaldenhof",,0.000118,94,2,1,3,6562,2464,9026,1,1,1,51,0,0
8588899,"Lugano, Cornaredo",,0.000081,102,3,4,7,51903,51903,103806,10,0.226121,0.279379,3052.183333,0,0
8581606,"Oberschan, Bettlerstein",,0.000044,73,2,1,3,5746,5580,11326,11,0.178571,0.251946,2296.248366,0,0
8581608,"Mels, Fabrik",,0.000055,73,1,1,2,6893,6893,13786,1,1,1,546,0,0
8581609,"Jenins, Sonne",,0.000072,109,2,1,3,6371,4668,11039,1,1,1,1498,0,0
8581611,"Elgg, Städtli",,0.000053,68,3,1,4,10413,10419,20832,6,0.275862,0.372917,177,0,0
8581612,"Elgg, Obergasse",,0.000056,68,1,1,2,10419,10418,20837,5,0.333333,0.433333,155,0,0
8581613,"Elgg, Bahnhof",,0.000058,68,1,2,3,10418,10424,20842,4,0.428571,0.569444,131,0,0
8582612,"Hofstetten ZH, Dorf",,0.000036,68,1,1,2,5206,5194,10400,4,0.384615,0.483333,0,0,0
8581614,"Thundorf, Brückenwaage",,0.000066,65,1,1,2,6112,6112,12224,4,0.4,0.520833,712,0,0
8581615,"Stettfurt, Freudenberg",,0.000067,65,1,1,2,6112,6112,12224,3,0.5,0.611111,537,0,0
8581616,"Stettfurt, Köll",,0.000068,65,1,1,2,6112,6112,12224,2,0.666667,0.75,360,0,0
8581617,"Stettfurt, Vorstadt",,0.000069,65,1,1,2,6112,6112,12224,1,1,1,181,0,0
8581622,"Rorschacherberg, Bachwies",,0.000085,72,2,2,4,31696,31696,63392,4,0.454545,0.616667,1209,0,0
8591809,"Rorschach, Wachsbleichestrasse",,0.000047,72,1,1,2,10929,10929,21858,4,0.4,0.520833,0,0,0
8581623,"Hägglingen, Altersheim",,0.000061,115,1,1,2,3785,1953,5738,1,1,1,113,0,0
8581631,"Montagny-les-Monts, croisée",,0.00002,116,1,1,2,1078,2151,3229,4,0.388889,0.464286,7,0,0
8581632,"Mannens, école",,0.000028,116,1,2,3,2151,2151,4302,3,0.545455,0.638889,12,0,0
8581633,"Grandsivaz, village",,0.000023,116,1,1,2,1078,1078,2156,3,0.5,0.566667,0,0,0
8581635,"Cousset, gare",,0.000042,116,2,3,5,2151,1479,3630,2,0.8,0.875,16,0,0
8581638,"Montagny-les-Monts, école",,0.000023,116,1,1,2,605,467,1072,1,1,1,0,0,0
8581804,"Montagny, Les Arbognes",,0.00003,116,1,1,2,730,122,852,1,1,1,1,0,0
8581636,"Montagny-la-Ville, école",,0.000023,116,1,1,2,730,730,1460,2,0.666667,0.75,5,0,0
8581650,"Cazis, Bündner Arena",,0.00005,109,2,1,3,4176,4176,8352,5,0.315789,0.380556,9428,0,0
8581651,"Cazis, Dorf",,0.000082,109,2,2,4,5618,5618,11236,4,0.423077,0.515152,10774.7,0,0
8581768,"Rhäzüns, Mineralquelle",,0.000021,109,1,1,2,3390,3390,6780,2,0.6,0.666667,0,0,0
8581887,"Rodels-Realta, Abzw. Bahnhof",,0.000035,109,1,1,2,1544,1544,3088,2,0.6,0.666667,6,0,0
8581659,"Féchy, Auberge",,0.000056,32,1,2,3,4562,4561,9123,3,0.555556,0.666667,184,0,0
8582696,"Rolle, Les Vernes",,0.00004,32,1,1,2,4067,4067,8134,3,0.5,0.611111,3,0,0
8581662,"Zumholz, Abzweigung",,0.000055,126,1,1,2,501,501,1002,3,0.444444,0.541667,732,0,0
8581668,"Valens, Sandgrueb",,0.000073,109,2,1,3,6169,4480,10649,2,0.666667,0.75,1698,0,0
8581670,"Muri AG, im Roos",,0.000038,115,2,2,4,4562,4562,9124,2,0.75,0.833333,297,0.004382,0
8581831,"Geltwil, Schulhaus",,0.000034,115,1,1,2,3841,3841,7682,1,1,1,1,0,0
8582688,"Rolle, Quatre-Communes",,0.000051,32,3,3,6,5186,5186,10372,5,0.310345,0.412963,218.666667,0,0
8582691,"Rolle, Uttins-Maupas",,0.000085,32,3,2,5,6405,6405,12810,4,0.347826,0.421875,285,0,0
8593251,"Wädenswil, Friedhof",,0.000046,63,1,1,2,4019,4020,8039,1,1,1,3.25,0,0
8581690,"Kreuzlingen, Fliegaufstrasse",,0.000094,65,3,2,5,9991,9991,19982,22,0.078292,0.101957,3184,0,0
8581680,"Kreuzlingen, Remisbergstrasse",,0.000073,65,2,1,3,5437,5221,10658,17,0.111765,0.193456,4104,0,0
8581681,"Kreuzlingen, Gaissbergstrasse",,0.000073,65,1,1,2,5221,5235,10456,16,0.119205,0.202699,3906,0,0
8581682,"Kreuzlingen, Möösliweg",,0.000073,65,1,1,2,5235,5221,10456,15,0.12782,0.213397,3706,0,0
8581683,"Lengwil, Bahnhof",,0.000073,65,1,1,2,5221,4991,10212,14,0.137931,0.226139,3504,0,0
8581684,"Lengwil, Dorf",,0.000073,65,1,1,2,4991,4991,9982,13,0.15,0.242009,3300,0,0
8581686,"Piotta, Bivio Funicolare Ritom",,0.000035,108,1,1,2,2916,2916,5832,2,0.666667,0.75,340,0,0
8581687,"Sternenberg, Sunnenbad",,0.000049,84,1,1,2,3057,3058,6115,1,1,1,15,0,0
8581698,"Kreuzlingen, Sonnenweg",,0.00004,65,1,1,2,638,638,1276,22,0.077289,0.094124,6,0,0
8581692,"Tägerwilen, Glaserstrasse",,0.000059,65,2,1,3,4614,4614,9228,6,0.255814,0.330303,528,0,0
8581696,"Kreuzlingen, Hauptzoll",,0.000067,65,2,1,3,1276,1276,2552,21,0.084188,0.105561,1844,0,0
8581697,"Kreuzlingen, Helvetiaplatz",,0.000068,65,1,2,3,1276,1275,2551,20,0.091461,0.120346,1806,0,0
8581700,"Landschlacht, Blindenzentrum",,0.000083,65,1,2,3,9991,9991,19982,20,0.09044,0.116603,1614,0,0
8581706,"Altnau, Bahnhof",,0.000046,65,1,1,2,4675,4675,9350,20,0.090014,0.112002,0,0,0
8581699,"Scherzingen, Rohrenzelg",,0.000084,65,2,1,3,9991,9991,19982,21,0.083333,0.103156,1658,0,0
8581702,"Oberhofen TG, Dorf",,0.000073,65,1,1,2,4991,4991,9982,12,0.164706,0.263325,3094,0,0
8581703,"Dettighofen (Lengwil), Dorf",,0.000073,65,1,1,2,4991,4977,9968,11,0.183099,0.296401,2886,0,0
8581704,"Lengwil, Ekkharthof",,0.000073,65,1,2,3,4977,5235,10212,10,0.206897,0.369081,2676,0,0
8582226,"Weinfelden, Güttingersreuti",,0.000066,65,1,1,2,4823,4607,9430,2,0.666667,0.75,18,0,0
8581710,"Lachen SZ, Eschenweg",,0.000046,67,1,1,2,7628,7612,15240,5,0.315789,0.422222,112,0,0
8581711,"Lachen SZ, Kapelle",,0.00005,67,1,1,2,7612,7612,15224,4,0.384615,0.483333,61,0,0
8581719,"Baden, Rütihof Bohnacker",,0.000051,22,3,1,4,20437,20613,41050,22,0.072408,0.092156,747.67152,0.000464,0
8583568,"Osco, Piottino",,0.000102,108,4,2,6,13950,12733,26683,7,0.27907,0.406349,1143.4,0,0
8583006,"Bellinzona, al Ramone",,0.000183,108,3,5,8,70965,71116,142081,6,0.362069,0.499206,6679.3,0,0
8587462,"Airolo, Bivio per Madrano",,0.000152,108,4,2,6,16397,12510,28907,5,0.380952,0.514583,856.866667,0,0
8582009,"Baltschieder, Kreuzmatte",,0.00008,40,1,1,2,6054,2227,8281,1,1,1,2,0,0
8590166,"Baden, Baregg",,0.000046,22,3,2,5,23487,23487,46974,22,0.07223,0.092954,868.381799,0.000349,0.000003
8590173,"Baden, Gartenstrasse",,0.00004,22,2,2,4,12301,12301,24602,21,0.077467,0.102531,139.516673,0.000014,0.000017
8581736,"Unterohringen, Dorf",,0.000032,68,1,1,2,2780,2780,5560,2,0.666667,0.75,141.133333,0,0
8587551,"Dinhard, Gemeindehaus",,0.000061,68,1,2,3,3848,3855,7703,2,0.666667,0.75,236,0,0
8587718,Niederwil ZH,,0.000042,68,1,1,2,3229,3244,6473,2,0.666667,0.75,2,0,0
8590954,"Winterthur, Haltenreben",,0.000114,68,5,1,6,7821,3347,11168,2,0.666667,0.75,119.233333,0,0
8581740,"Heiden, Asylstrasse",,0.000102,73,2,1,3,5778,1071,6849,14,0.114667,0.153674,5814.466667,0,0
8581742,"Quinto, Scruengo TCS",,0.00004,108,1,1,2,2916,2916,5832,1,1,1,171,0,0
8581973,"Pfyn, Biberpfad",,0.000169,65,5,2,7,19672,11071,30743,3,0.538462,0.619048,1578.5,0,0
8581996,"Kreuzlingen, Weiherstrasse",,0.000122,65,2,2,4,10134,8820,18954,3,0.545455,0.638889,424,0,0
8581760,Erlenauweg,,0.000026,100,1,1,2,4501,4501,9002,1,1,1,20,0,0
8581765,"Rubigen, Beitenwil",,0.000015,100,1,1,2,3196,3196,6392,3,0.5,0.611111,28,0,0
8581769,"Englisberg, Neuhaus",,0.00005,44,1,1,2,6062,6062,12124,2,0.666667,0.75,2446,0,0
8581772,"Mels, Hallenbad",,0.000044,73,1,2,3,14754,14754,29508,2,0.666667,0.75,1628,0,0
8582000,"Plons (Mels), Rekrutierungsztr.",,0.00003,73,1,1,2,7912,7912,15824,2,0.6,0.666667,0,0,0
8591819,"Trübbach, Oberstufenzentrum",,0.000051,73,1,1,2,17320,5704,23024,2,0.6,0.666667,5228.546965,0,0
8581776,"Abtwil SG, Zentrumpark",,0.00005,71,3,2,5,30459,30459,60918,13,0.161804,0.187198,1292.688095,0,0
8588961,"Abtwil SG, Ausserdorf",,0.000048,71,1,2,3,51662,51662,103324,13,0.161224,0.189203,1566,0,0
8581778,"Tenero, Centro Commerciale",,0.000165,101,2,4,6,73264,61788,135052,12,0.159763,0.310114,5432.366667,0,0
8587845,"Muralto, al Parco",,0.000046,101,1,1,2,20775,20789,41564,12,0.140244,0.211873,0,0,0
8581779,"Pfäffikon ZH, Steinwiesstrasse",,0.000042,84,2,1,3,5811,5562,11373,2,0.666667,0.75,76,0,0
8581783,"Lyss, Abzw. Hardern",,0.000043,87,2,1,3,957,957,1914,8,0.222222,0.339732,50,0,0
8583038,"Lyss, Seelandweg",,0.000067,87,1,1,2,929,929,1858,4,0.4,0.520833,16,0,0
8581784,"Uetendorf, Schürhus",,0.000011,43,0,1,1,0,1347,1347,7,0.222222,0.314087,0,0,0
8581785,"Uetendorf, Gibliz",,0.00002,43,1,2,3,1347,1347,2694,6,0.261905,0.387879,11,0,0
8581799,"Gurzelen, Kreuz",,0.000019,43,1,1,2,1017,1101,2118,6,0.243902,0.326667,0,0,0
8581787,"Uetendorf, Hofmättli",,0.000024,43,1,1,2,988,988,1976,10,0.153846,0.241156,3276,0,0
8581788,"Uetendorf, Fliederweg",,0.000031,43,1,1,2,988,988,1976,9,0.168831,0.25638,3055,0,0
8581789,"Uetendorf, Mehrzweckhalle Bach",,0.000037,43,1,1,2,988,988,1976,8,0.1875,0.274603,2832,0,0
8581790,"Uetendorf, Allmendstrasse",,0.000043,43,1,1,2,988,988,1976,7,0.211538,0.297186,2607,0,0
8581792,"Vielbringen, Chäsi",,0.000015,100,1,1,2,2706,2706,5412,6,0.285714,0.408333,64,0,0
8581793,"Uetendorf, Walalpweg",,0.000047,43,1,1,2,988,988,1976,6,0.243902,0.326667,2380,0,0
8581794,"Uetendorf, Jungfraustrasse",,0.000051,43,1,1,2,988,988,1976,5,0.290323,0.368519,2151,0,0
8581795,"Uetendorf, TUS",,0.000054,43,1,1,2,988,988,1976,4,0.363636,0.4375,1920,0,0
8581801,"Gurzelen, Obergurzelen",,0.000041,43,1,1,2,2202,2202,4404,4,0.363636,0.4375,32,0,0
8581796,"Eglisau, Steinboden",,0.000036,68,1,2,3,2892,2895,5787,1,1,1,115.5,0,0
8583817,"Eglisau, Breitistrasse",,0.000036,68,1,1,2,7634,7634,15268,1,1,1,38.5,0,0
8581798,"Vielbringen, Schulhaus",,0.000024,100,1,1,2,2706,2706,5412,5,0.333333,0.456667,53,0,0
8581800,"Gurzelen, Schulhaus",,0.000036,43,2,1,3,1431,2202,3633,5,0.290323,0.368519,27,0,0
8581802,"Uetendorf, Bahnhof",,0.000092,43,2,2,4,3190,2862,6052,3,0.5,0.595238,1722,0,0
8581803,"Uetendorf, Stiftung U.-Berg",,0.00005,43,1,2,3,2202,2202,4404,2,0.666667,0.75,988,0,0
8582187,"Uetendorf, Bergschulhaus",,0.000038,43,1,1,2,1347,1347,2694,2,0.666667,0.75,2,0,0
8589697,Kriens  Pulvermühle,,0.00009,90,4,2,6,71274,72127,143401,11,0.17305,0.204395,6800.979365,0,0
8589715,Kriens Hofmatt - Bellpark,,0.000078,90,3,5,8,124125,124233,248358,10,0.215415,0.270384,3520.231349,0,0
8589720,Kriens Krauerhalle,,0.000085,90,3,3,6,17786,17786,35572,10,0.211155,0.254451,747.688095,0,0
8589723,Kriens Kupferhammer,,0.000024,90,1,1,2,107084,106868,213952,10,0.197674,0.229019,0,0,0
8589724,Kriens Lauerzweg,,0.000082,90,3,1,4,20652,20657,41309,10,0.197674,0.229019,116,0,0
8581813,"Wiggen, Unterbach",,0.000095,61,1,1,2,6201,6201,12402,1,1,1,26,0,0
8581819,"Vaduz, Lettstrasse",,0.000027,73,1,1,2,1568,1568,3136,13,0.13164,0.163592,2542.419048,0,0
8581820,"Vaduz, Rheinparkstadion",,0.000034,73,1,1,2,1568,1568,3136,12,0.148936,0.185453,2058.419048,0,0
8581821,"Vaduz, Alte Rheinbrücke",,0.00004,73,1,1,2,1568,1568,3136,11,0.171875,0.219698,1572.419048,0,0
8582470,"Bad Ragaz, St. Leonhard",,0.000044,73,1,1,2,29,29,58,11,0.171875,0.219698,960,0,0
8587407,"Räfis, Schulhaus",,0.000029,73,1,1,2,17239,17239,34478,11,0.171875,0.219698,0,0,0
8581822,"Eschen, Primarschule",,0.000055,73,2,1,3,2420,2420,4840,8,0.211538,0.300974,1136,0,0
8581823,"Eschen, Rofenberg Kapelle",,0.000058,73,1,1,2,2420,2420,4840,7,0.243902,0.334286,578,0,0
8581830,"Geltwil, Isenbergschwil",,0.000027,115,1,1,2,3841,3841,7682,2,0.666667,0.75,100,0,0
8581833,"Courgenay, Petite Gilberte",,0.000064,50,1,2,3,5549,5549,11098,9,0.203704,0.359452,209,0,0
8582086,"Porrentruy, Voyeboeuf",,0.000038,50,1,1,2,2586,2586,5172,9,0.188679,0.295397,0,0,0
8581839,"Rüfenacht, Schlössli",,0.000031,100,1,1,2,2706,2706,5412,4,0.4,0.520833,40,0,0
8583677,"Mauren FL, Binza",,0.000046,73,1,1,2,387,387,774,1,1,1,0,0,0
8581843,"Eiken, Poststrasse",,0.000037,57,1,1,2,3237,3190,6427,4,0.4,0.520833,166,0,0
8581851,"Weinfelden, Humana",,0.000042,65,1,1,2,4607,4823,9430,11,0.166667,0.274534,2016,0,0
8581852,"Visp, Bahnhof Nord",,0.000083,40,3,1,4,6026,6054,12080,3,0.5,0.611111,160,0,0
8581859,"Rüfenacht, Längimoos",,0.000037,100,1,1,2,2706,2706,5412,3,0.5,0.611111,25,0,0
8581862,"St. Niklausen OW, Haueti",,0.000103,62,1,1,2,3663,1552,5215,1,1,1,116,0,0
8581863,"Pratval, Gemeindehaus",,0.000021,109,1,1,2,1544,1544,3088,4,0.357143,0.466667,3858,0,0
8581864,"Cazis, Siedlung Realta",,0.000028,109,1,1,2,1544,1544,3088,3,0.444444,0.541667,1933,0,0
8581882,"Wohlen AG, Durisolstrasse",,0.000047,115,1,1,2,4279,4279,8558,2,0.666667,0.75,170,0,0
8581883,"Wohlen AG, Allmendstrasse",,0.000051,115,1,1,2,4279,4279,8558,1,1,1,86,0,0
8582618,"Galgenen, Hornbach",,0.000106,67,1,1,2,6089,4247,10336,1,1,1,1,0,0
8581895,"Ins, West",,0.000134,117,4,1,5,9074,1229,10303,2,0.666667,0.75,1170,0,0
8581904,"Worb Dorf, Bahnhofstrasse",,0.00017,100,5,1,6,12252,2706,14958,1,1,1,48,0,0
8581993,"Meiringen, Isenbolgen",,0.000076,114,2,3,5,2851,2766,5617,3,0.6,0.722222,419.5,0,0
8581914,"Bussigny, gare",,0.00006,5,4,3,7,19632,20188,39820,8,0.212245,0.272459,1811.166667,0,0
8581916,"Bussigny, Condémine",,0.000028,5,1,1,2,6195,6169,12364,8,0.200855,0.235841,0,0,0
8581917,"Bussigny, Dallaz",,0.000028,5,1,1,2,5080,5080,10160,7,0.242424,0.349107,306,0,0
8581920,"Bussigny, Sauge",,0.000033,5,1,2,3,12866,12869,25735,4,0.454545,0.616667,350,0,0
8581921,"Bussigny, Vieux-Four",,0.000025,5,1,1,2,12785,12399,25184,4,0.4,0.520833,0,0,0
8581922,"Bussigny, Riettaz",,0.000046,5,2,1,3,12483,6169,18652,3,0.5,0.611111,148,0,0
8581924,"Bussigny, Sullens",,0.00005,5,1,1,2,6169,6169,12338,2,0.666667,0.75,44,0,0
8593815,"Crissier, Jura",,0.000091,5,3,2,5,70026,70026,140052,4,0.444444,0.552083,4202,0,0
8581927,"Gland, Borgeaud",,0.000029,32,2,1,3,6855,6856,13711,8,0.173913,0.223165,48,0,0
8581928,"Gland, Riant-Coteau",,0.000035,32,1,1,2,6856,6856,13712,7,0.201754,0.25207,69,0,0
8581935,"Gland, gare sud",,0.000073,32,3,3,6,15107,15383,30490,5,0.304348,0.400794,314.416667,0,0
8582690,"Rolle, Baccara",,0.000046,32,2,1,3,4448,4448,8896,5,0.269841,0.323529,0,0,0
8581936,"Gland, Montoly",,0.000032,32,1,1,2,11730,11730,23460,6,0.25641,0.316667,75.666667,0,0
8583111,"Rolle, La Pièce-Etraz",,0.000085,32,1,2,3,5431,5431,10862,4,0.392857,0.484848,165.333333,0,0
8581943,"Thierrens, gare routière",,0.000267,13,8,5,13,15816,14815,30631,14,0.16996,0.276374,10137.420757,0,0
8581945,"Salenstein, Dorf",,0.000049,65,1,1,2,4580,4801,9381,8,0.191176,0.270238,508,0,0
8581947,"Arenenberg, Schloss",,0.000053,65,1,1,2,4801,4801,9602,7,0.218182,0.295238,464,0,0
8581948,"Schöftland, Holzikerstrasse",,0.000046,94,1,1,2,6251,6256,12507,2,0.666667,0.75,486,0,0
8581950,"Eiken, West",,0.000043,57,1,1,2,3190,3190,6380,3,0.5,0.611111,86,0,0
8581952,"Gstaad, Rütti Schulhaus",,0.000241,42,1,1,2,2423,1970,4393,6,0.291667,0.397619,525,0,0
8581953,"Orbe, Suchet",,0.000078,35,1,1,2,6155,1322,7477,1,1,1,302,0,0
8581969,"Ermatingen, Friedhof",,0.000056,65,1,1,2,4801,4801,9602,6,0.255814,0.330303,418,0,0
8582011,"Müllheim, Bahnhofstrasse",,0.000056,65,1,1,2,2530,2530,5060,3,0.5,0.566667,37.5,0,0
8581974,"Islikon, Bahnhof",,0.000068,65,1,1,2,6780,6780,13560,2,0.666667,0.75,360,0,0
8583232,"Willisau, Mohrenplatz",,0.000046,59,2,1,3,250,250,500,3,0.5,0.611111,22.5,0,0
8581979,"Hofstetten b. Brienz, Schried",,0.000071,114,2,1,3,4505,4505,9010,9,0.22449,0.348088,73,0,0
8581983,"Isone, Piazzale",,0.000055,102,1,1,2,6671,6671,13342,1,1,1,105,0,0
8581994,"Meiringen, Casinoplatz",,0.000095,114,3,2,5,3088,1279,4367,3,0.571429,0.708333,645.5,0,0
8582002,"Glis, Glismatten",,0.000189,40,5,1,6,5060,796,5856,1,1,1,287,0,0
8582006,"Weinfelden, Sonnenplatz",,0.000046,65,1,1,2,4823,4823,9646,10,0.181818,0.292897,1802,0,0
8582008,"Baltschieder, Cavallo",,0.000082,40,1,1,2,6054,6054,12108,2,0.666667,0.75,82,0,0
8582010,"Gachnang, Kath. Kirche",,0.000069,65,1,1,2,6780,6780,13560,1,1,1,181,0,0
8582012,"Tscherlach, Steibünt",,0.000042,124,2,1,3,6432,6590,13022,7,0.230769,0.328836,122,0,0
8582019,"Arnegg, Geretschwilerstrasse",,0.000047,71,2,1,3,16412,16412,32824,5,0.333333,0.456667,2240,0,0
8582020,"Gossau SG, Lindenhof",,0.000051,71,1,1,2,16412,16412,32824,4,0.4,0.520833,1684,0,0
8582022,"Gossau SG, Watt",,0.000054,71,1,1,2,16412,16412,32824,3,0.5,0.611111,1126,0,0
8582023,"Gossau SG, Bischofszellerstr.",,0.000057,71,1,1,2,16412,16412,32824,2,0.666667,0.75,566,0,0
8582030,"Porrentruy, JURASSICA Museum",,0.000026,50,1,1,2,5731,5731,11462,3,0.5,0.611111,22,0,0
8582036,"Porrentruy, Château",,0.000029,50,1,1,2,3351,3351,6702,4,0.416667,0.516667,2.5,0,0
8582124,"Porrentruy, Minoux",,0.00006,50,2,1,3,3340,3342,6682,4,0.416667,0.516667,79.5,0,0
8582397,"Porrentruy, les Tilleuls",,0.000057,50,1,2,3,5237,5237,10474,3,0.555556,0.666667,38,0,0
8582037,"Porrentruy, Bacavoine",,0.000033,50,1,1,2,5731,5731,11462,2,0.666667,0.75,13,0,0
8582044,"Ballwil, Hochdorfstrasse",,0.000021,90,1,1,2,4324,4324,8648,17,0.096774,0.11221,831,0,0
8582045,"Eschenbach LU, Luzernstrasse",,0.000029,90,1,1,2,4324,4324,8648,16,0.106414,0.12347,796,0,0
8582046,"Honau, Hirschen",,0.000036,90,1,1,2,4324,4324,8648,15,0.118271,0.138401,759,0,0
8583423,"Villarzel, Les Râpes",,0.000064,13,2,1,3,3427,1840,5267,1,1,1,515,0,0
8582050,"Vaumarcus, milieu du village",,0.000089,35,1,1,2,1132,1132,2264,1,1,1,452,0,0
8594019,"Yverdon, Curtil Maillet",,0.000035,35,2,2,4,15664,15663,31327,6,0.28169,0.355,2451.985714,0,0
8594051,"Yverdon-les-Bains, L'Orient",,0.000037,35,1,1,2,9167,9166,18333,5,0.291667,0.35,256.397619,0,0
8582061,Seedorf Im Grund,,0.000118,93,5,1,6,18571,18570,37141,8,0.256637,0.308087,648.538095,0,0
8582071,"Jens, Birkenweg",,0.000092,87,3,1,4,3565,1729,5294,1,1,1,921,0,0
8582085,"St-Ursanne, porte St-Pierre",,0.000102,52,2,1,3,7717,7724,15441,1,1,1,23,0,0
8582095,"Gretschins, Dorf",,0.000048,73,1,2,3,5580,5580,11160,10,0.206522,0.306788,1792.248366,0,0
8582096,"Trübbach, Seidenbaum",,0.000031,73,1,1,2,921,889,1810,10,0.197802,0.268276,0,0,0
8582101,"Fontnas, Dorf",,0.000058,73,2,1,3,5548,5580,11128,9,0.232877,0.31739,778.248366,0,0
8589892,"Weite, alte Gasse",,0.000082,73,2,1,3,17349,17349,34698,9,0.232877,0.31739,23282.546965,0,0
8582103,"Rafz, Bleiki",,0.000051,68,3,1,4,11743,11762,23505,3,0.5,0.611111,222,0,0
8582115,"Ennetmoos, Mueterschwandenberg",,0.000023,62,1,1,2,2142,2142,4284,3,0.5,0.611111,12,0,0
8582117,"Mezzovico, Fontana",,0.000059,102,2,1,3,12495,12850,25345,3,0.5,0.611111,447,0,0
8582120,"Ennetmoos, Abzw. Rütli",,0.00003,62,1,1,2,2142,2142,4284,2,0.666667,0.75,10,0,0
8582121,"Ennetmoos, Ebnet",,0.000037,62,1,1,2,2142,2141,4283,1,1,1,6,0,0
8582125,"Porrentruy, route Bressaucourt",,0.000054,50,2,1,3,5237,5237,10474,4,0.4,0.486111,46,0,0
8582127,"Porrentruy, Vauches/Perche",,0.00007,50,2,1,3,5549,5549,11098,8,0.209302,0.317857,189,0,0
8582128,"Porrentruy, Patinoire",,0.000071,50,1,1,2,5549,5549,11098,7,0.235294,0.34494,176,0,0
8582131,"Porrentruy, Haute-Fin",,0.000068,50,2,3,5,5264,5264,10528,1,1,1,48,0,0
8583351,"Porrentruy, Roche-de-Mars",,0.00003,50,1,2,3,4040,4237,8277,1,1,1,0,0,0
8583564,"Beurnevésin, Le Péqui",,0.000043,50,2,1,3,5370,5173,10543,1,1,1,0,0,0
8582132,"Vaz/Obervaz, Solis",,0.000066,109,1,1,2,1350,1350,2700,2,0.666667,0.75,808,0,0
8582133,"Alvaschein, Solisbrücke",,0.000067,109,1,1,2,1350,1350,2700,1,1,1,405,0,0
8582137,"Bassins, Piscine",,0.000081,125,2,1,3,10788,3668,14456,3,0.5,0.611111,80,0,0
8582159,"Bussnang, Stadler",,0.000043,20,2,2,4,3223,2572,5795,17,0.098246,0.199261,731.166667,0,0
8588624,"Wuppenau, Im Rank",,0.000075,20,2,2,4,10230,9481,19711,1,1,1,116.833333,0,0
8582160,"Müllheim, Felsenau",,0.000183,65,3,3,6,13600,13601,27201,2,0.8,0.875,1096,0,0
8582498,"Tägerwilen Dorf, Bahnhof",,0.000063,65,1,1,2,4614,4614,9228,2,0.666667,0.75,0,0,0
8582161,"Dozwil, Oberdorfstrasse",,0.00002,121,1,1,2,4893,4893,9786,18,0.102293,0.123985,174,0,0
8582456,"Engishofen, Oberdorf",,0.000053,121,1,1,2,4705,4488,9193,18,0.10276,0.126134,875,0,0
8582165,"Engishofen, Dorfplatz",,0.000028,121,1,1,2,4921,4704,9625,23,0.069418,0.082768,1240,0,0
8582166,"Kümmertshausen, Hauptstrasse",,0.000035,121,1,1,2,4704,4921,9625,22,0.074182,0.088107,1171,0,0
8582170,"Langrickenbach, Rutishausen",,0.00004,121,1,1,2,4921,4704,9625,21,0.079678,0.094515,1100,0,0
8582171,"Langrickenbach, Waldhof",,0.000045,121,1,1,2,4704,4705,9409,20,0.086089,0.102404,1027,0,0
8582173,"Illighausen, Wilen",,0.00005,65,1,1,2,4823,4607,9430,9,0.2,0.31433,1586,0,0
8582174,"Klarsreuti, Linde",,0.000054,65,1,1,2,4607,4607,9214,8,0.222222,0.339732,1368,0,0
8582175,"Birwinken, Käserei",,0.000057,65,1,1,2,4607,4607,9214,7,0.25,0.370408,1148,0,0
8582176,"Andwil TG, Eckartshausen",,0.000059,65,1,1,2,4607,4823,9430,6,0.285714,0.408333,926,0,0
8582177,"Andwil TG, Volg",,0.000061,65,1,1,2,4823,4823,9646,5,0.333333,0.456667,702,0,0
8582178,"Heimenhofen, Kreuzung",,0.000063,65,1,1,2,4823,4823,9646,4,0.4,0.520833,476,0,0
8582179,"Donzhausen, Dorfplatz",,0.000064,65,1,1,2,4823,4823,9646,3,0.5,0.611111,248,0,0
8582184,"Flawil, Wohn- und Pflegeheim",,0.000051,20,1,1,2,11467,11192,22659,2,0.666667,0.75,408,0,0
8582186,"Uetendorf, Buchshalte",,0.000032,43,1,1,2,1066,1347,2413,3,0.5,0.611111,248,0,0
8582188,"Uetendorf, Uttigenstrasse",,0.00005,43,1,1,2,660,988,1648,1,1,1,247,0,0
8582191,"Langrickenbach, Neuhof",,0.000049,121,1,1,2,4705,4705,9410,19,0.093667,0.112474,952,0,0
8582192,"Oensingen, Kreisschule",,0.000062,94,3,1,4,18524,18520,37044,18,0.118919,0.217202,396.666667,0,0
8582863,"Klosters, Rüefa",,0.000062,112,1,1,2,6548,6980,13528,22,0.109043,0.190412,657,0,0
8594450,"Chur, Sägenstrasse",,0.000068,109,4,4,8,30272,27871,58143,3,0.6,0.703704,1568.927591,0,0
8594452,"Chur, Waldhaus",,0.000044,109,2,2,4,45053,44712,89765,5,0.375,0.547222,1931.5,0,0
8594462,"Chur, Kleinwaldegg",,0.000112,109,4,3,7,21045,21375,42420,5,0.421053,0.597917,3964.309524,0,0
8594464,"Chur, Böschenstrasse",,0.000047,109,1,1,2,10360,10972,21332,5,0.333333,0.456667,5,0,0
8594551,"Klosters Platz, Bahnhof",,0.000288,112,6,1,7,16885,62,16947,5,0.333333,0.456667,400,0,0
8594777,"Bad Ragaz, Kreisel Ausserfeld",,0.000054,73,1,1,2,29,29,58,5,0.333333,0.456667,911.248366,0,0
8595002,"Chur, Neubruchstrasse",,0.000061,109,2,1,3,22485,19308,41793,5,0.333333,0.456667,0,0,0
8595391,"Chur, Sandstrasse",,0.000046,109,1,1,2,5158,5154,10312,5,0.333333,0.456667,50,0,0
8582200,"Les Tavernes, collège",,0.000106,13,4,2,6,2121,1816,3937,11,0.179487,0.319872,7083.866667,0,0
8582216,"Grimentz, Morette",,0.000117,39,3,1,4,747,302,1049,2,0.666667,0.75,42,0,0
8588516,"Grône, écoles",,0.00015,39,4,2,6,9584,7184,16768,11,0.202128,0.334881,2635.583333,0,0
8588524,"Sion, Hôpital Sud",,0.000056,39,1,1,2,6769,6769,13538,2,0.6,0.666667,48,0,0
8594634,"Sierre, Résidence Plantzette",,0.000038,39,1,1,2,1992,2021,4013,1,1,1,1,0,0
8582218,"Niouc, Les Saints Innocents",,0.000028,39,1,1,2,2337,2173,4510,1,1,1,20.75,0,0
8588525,"Chalais, Les Zittes",,0.000139,39,3,2,5,9741,9741,19482,1,1,1,694.5,0,0
8589217,"Salgesch, Bahnhof",,0.000028,39,1,1,2,6437,6437,12874,1,1,1,20.75,0,0
8582228,"Zimmerwald, Weiermatt",,0.000054,44,1,1,2,6062,6062,12124,1,1,1,1224,0,0
8582232,"Möhlin, Helvetierstrasse",,0.000025,2,1,1,2,4007,4253,8260,2,0.571429,0.625,16,0,0
8582239,"Trogen, Lindenbüel",,0.000097,73,1,1,2,1071,1071,2142,13,0.126506,0.167547,5502.466667,0,0
8582244,"Lussy FR, Le Quartz",,0.000081,13,4,1,5,6784,6623,13407,12,0.130508,0.156846,1622.616667,0,0
8588603,"Posieux, Agroscope",,0.000119,13,5,3,8,21888,22104,43992,10,0.171233,0.215423,4335.699675,0,0
8582256,"Muri AG, Industriestrasse",,0.000061,115,2,1,3,3047,3095,6142,1,1,1,451,0.000601,0
8582388,"Daviaz, Charrière",,0.000067,37,1,1,2,1024,1066,2090,1,1,1,16,0,0
8582389,"Torgon, Planchamp",,0.000089,103,2,1,3,1469,1469,2938,1,1,1,42,0,0
8582391,"Altendorf, Talstrasse",,0.000112,67,2,1,3,6089,6089,12178,2,0.666667,0.75,167,0,0
8583437,"Courtedoux, Place St-Martin",,0.00006,50,1,1,2,68,68,136,1,1,1,14,0,0
8582398,"Winterthur, Loorstrasse",,0.00002,68,1,1,2,11903,11885,23788,12,0.162921,0.222456,1637,0,0
8590922,"Winterthur, Bäumliweg",,0.000044,68,1,1,2,7435,7435,14870,12,0.162921,0.222456,1838,0,0
8582405,"Grüsch, Ingerloch",,0.000059,75,1,1,2,1386,1386,2772,1,1,1,9,0,0
8582406,"Schiers, Rossgasse",,0.000042,112,1,1,2,1963,1848,3811,1,1,1,1479,0,0
8582408,"Sessa, La Costa",,0.00007,81,1,1,2,7772,7772,15544,4,0.4,0.520833,352,0,0
8582409,"Sessa, Beredino",,0.00007,81,1,1,2,7772,7772,15544,3,0.5,0.611111,244,0,0
8582416,"Sessa, Cimitero",,0.000098,81,2,1,3,9381,9108,18489,1,1,1,114,0,0
8582422,"Fiez, collège",,0.000074,35,2,1,3,950,950,1900,1,1,1,727,0,0
8582434,"Collombey, Les Neyres Raccot",,0.000141,103,4,1,5,1136,500,1636,2,0.666667,0.75,84,0,0
8582431,"Bramois, église",,0.000083,39,4,1,5,2006,2005,4011,19,0.119444,0.153595,1388,0,0
8582435,"Schaan, Im Rossfeld",,0.000049,73,1,1,2,767,767,1534,1,1,1,487,0,0
8583368,"Sion, Grand Champsec",,0.000047,39,1,2,3,8919,8919,17838,8,0.259259,0.3572,1243.5,0,0
8583369,"Sion, SUVA",,0.000078,39,1,2,3,13027,12945,25972,8,0.270833,0.407784,268.833333,0,0
8583370,"Sion, Treille",,0.000068,39,2,2,4,9714,9714,19428,8,0.26087,0.400099,417.333333,0,0
8583373,"Sion, Cité du Soleil",,0.00004,39,1,1,2,4684,4613,9297,8,0.244444,0.345563,0,0,0
8588522,"Bramois, Glarey",,0.000056,39,1,1,2,4158,4158,8316,8,0.244444,0.345563,544.5,0,0
8582454,"Iselisberg, Abzweigung",,0.000052,65,1,1,2,4537,4537,9074,3,0.5,0.611111,513,0,0
8582457,"Uesslingen, Zollhausweg",,0.000055,65,1,1,2,4537,4537,9074,2,0.666667,0.75,344,0,0
8582464,"Bazenheid, Ifang",,0.000049,20,2,3,5,7411,7411,14822,5,0.342857,0.484722,1401.5,0,0
8587338,"Krummenau, Restaurant Adler",,0.000101,73,5,2,7,6627,1100,7727,4,0.411765,0.547619,8931,0,0
8587772,Dietschwil b. Kirchberg SG,,0.000025,20,1,1,2,2758,2758,5516,5,0.291667,0.390476,0,0,0
8582467,"Bad Ragaz, Bahnhofstrasse",,0.000073,109,1,1,2,4480,995,5475,1,1,1,850,0,0
8582468,"Bad Ragaz, Im Ochsenbrunnen",,0.000033,73,1,1,2,29,29,58,13,0.13164,0.163592,4746,0,0
8582469,"Bad Ragaz, Zentrum",,0.000039,73,1,1,2,29,29,58,12,0.148936,0.185453,2854,0,0
8582486,"Düdingen, Warpel",,0.000121,126,4,2,6,35133,4227,39360,14,0.153846,0.291753,2769,0,0
8587003,"Meyriez, Hôpital",,0.000085,126,2,2,4,5584,5584,11168,11,0.2,0.34577,9558,0,0
8593542,Prieuré,,0.000052,48,1,2,3,52562,52563,105125,16,0.13894,0.186192,6274.7,0,0
8582670,"Cressier NE, Malpierres",,0.000142,48,2,2,4,2662,2634,5296,14,0.120718,0.169292,3585.5,0,0
8593591,Rochettes,,0.00015,48,4,2,6,124065,67063,191128,18,0.115523,0.222775,6724.333333,0,0
8582488,"Wavre, Les Motteresses",,0.000021,48,1,1,2,2605,2605,5210,20,0.075298,0.101637,737,0,0
8582490,"Thielle, Le Verger",,0.000054,48,3,1,4,2663,2659,5322,18,0.086393,0.115867,4544,0,0
8582491,"Cornaux, gare",,0.000056,48,1,1,2,2659,2663,5322,17,0.093381,0.126884,3884,0,0
8582503,"Morthey, Préplan",,0.000067,39,1,1,2,2553,2553,5106,3,0.416667,0.5,263,0,0
8582504,"Ovronnaz, chapelle",,0.000068,39,1,1,2,2553,2553,5106,2,0.571429,0.625,188,0,0
8582506,"Aarburg, Alter Friedhof",,0.000055,94,1,1,2,33744,33763,67507,4,0.4,0.520833,441,0,0
8582507,"Aarburg, Kloosmatte",,0.000057,94,1,1,2,33763,33762,67525,3,0.5,0.611111,297,0,0
8582508,"Bad Zurzach, Friedhof",,0.000019,98,1,1,2,104,104,208,8,0.197183,0.271599,124,0,0
8582510,"Bad Zurzach, Feldblumenweg",,0.00002,98,1,1,2,397,397,794,9,0.174419,0.249418,246,0,0
8582511,"Bad Zurzach, Fliederweg",,0.000028,98,1,1,2,397,397,794,8,0.197183,0.271599,137,0,0
8582513,"Bad Zurzach, Baslerstrasse",,0.000081,98,4,1,5,2786,1503,4289,6,0.272727,0.352778,1427.5,0,0
8582515,"Bad Zurzach, Parkhotel",,0.00008,98,1,2,3,1503,1694,3197,5,0.34375,0.460606,1309.5,0,0
8582516,"Bad Zurzach, Rathaus",,0.000045,98,1,1,2,1297,1297,2594,5,0.322581,0.406667,0,0,0
8582517,"Bad Zurzach, RehaClinic",,0.000083,98,2,3,5,1694,1694,3388,4,0.428571,0.574074,1067.5,0,0
8582518,"Bad Zurzach, Salzstrasse",,0.000034,98,1,1,2,872,872,1744,4,0.368421,0.452381,0,0,0
8582519,"Bad Zurzach, Triumph",,0.000034,98,1,1,2,104,104,208,4,0.368421,0.452381,0,0,0
8582520,"Bad Zurzach, Turmhotel",,0.000093,98,3,2,5,1694,1590,3284,3,0.5,0.611111,689.5,0,0
8582521,"Bad Zurzach, Zurzacher Hof",,0.00005,98,1,2,3,1269,1269,2538,2,0.666667,0.75,423.5,0,0
8582524,"Olten, Passerelle",,0.00006,94,1,1,2,33762,33763,67525,2,0.666667,0.75,151,0,0
8582532,"Les Brenets, gare",,0.000011,118,0,1,1,0,2606,2606,6,0.285714,0.408333,0,0,0
8582533,"Les Brenets, Les Pâquerettes",,0.00002,118,1,1,2,2606,2606,5212,5,0.333333,0.456667,5,0,0
8582534,"Les Brenets, centre village",,0.000028,118,1,1,2,2606,2606,5212,4,0.4,0.520833,8,0,0
8582535,"Les Brenets, Grande Rue 27",,0.000035,118,1,1,2,2606,2606,5212,3,0.5,0.611111,9,0,0
8582536,"Les Brenets, centre sportif",,0.00004,118,1,1,2,2606,2606,5212,2,0.666667,0.75,8,0,0
8582537,"Les Brenets, camping",,0.000045,118,1,1,2,2606,2606,5212,1,1,1,5,0,0
8582549,"Reinach AG, Beinwiler Höhe",,0.000055,59,2,2,4,8140,8408,16548,5,0.380952,0.514583,503,0,0
8582550,"Burg AG, Rössligasse",,0.000034,59,1,1,2,3843,3843,7686,5,0.35,0.445238,0,0,0
8582560,"Sursee, Sappeurstrasse",,0.000058,59,3,1,4,8819,9030,17849,7,0.25,0.347354,339,0,0
8582564,"Sursee, Münchrüti",,0.00006,59,1,1,2,9030,8905,17935,6,0.296296,0.4,234,0,0
8582566,"Wilderswil, Oberland Shopping",,0.000135,43,2,2,4,8111,3941,12052,2,0.75,0.833333,588,0,0
8582578,"Cerniat FR, église",,0.000065,13,2,1,3,1527,1449,2976,1,1,1,630,0,0
8582592,Epagnier,,0.000036,48,1,1,2,2605,2605,5210,16,0.100522,0.134562,742,0,0
8582596,"Faulensee, Angernstrasse",,0.00009,43,3,1,4,6198,6246,12444,10,0.180328,0.281421,721,0,0
8582601,"Schönholzerswilen, Hagenbuch",,0.000043,20,2,1,3,3318,3373,6691,15,0.103586,0.164114,1028,0,0
8582603,"Niederhof, Feuerwehrdepot",,0.000048,20,1,1,2,3373,3373,6746,14,0.111111,0.17171,888,0,0
8582604,"Oberbussnang, Feuerwehrdepot",,0.000051,20,1,1,2,3373,3276,6649,13,0.12,0.180605,746,0,0
8582606,"Schönholzerswilen, Toos",,0.000055,20,1,1,2,3276,3373,6649,12,0.130682,0.191292,602,0,0
8582608,"Lanterswil, Schulhaus",,0.000057,20,1,1,2,3373,3373,6746,11,0.143791,0.204585,456,0,0
8582613,"Elgg, Post",,0.000066,68,2,1,3,10412,5204,15616,3,0.5,0.583333,77,0,0
8582619,"Lyss, Bahnhof Ost",,0.000063,87,2,1,3,1886,929,2815,7,0.25,0.370408,3625,0,0
8582620,"Lyss, Beundengasse",,0.000027,87,1,2,3,6506,1793,8299,2,0.75,0.833333,3618,0,0
8583033,"Lyss, Flurweg",,0.000022,87,1,1,2,896,896,1792,2,0.666667,0.75,0,0,0
8582623,"Einsiedeln, Allmeindstrasse",,0.000022,69,1,1,2,2134,2134,4268,3,0.5,0.611111,96,0,0
8582624,"Einsiedeln, Schlyffi",,0.000029,69,1,1,2,2134,2134,4268,2,0.666667,0.75,66,0,0
8582625,"Einsiedeln, Kornhausstrasse",,0.000036,69,1,1,2,2134,2134,4268,1,1,1,34,0,0
8582627,"Einsiedeln, Spital",,0.000084,69,2,2,4,5838,6405,12243,2,0.75,0.833333,204,0,0
8582629,"Einsiedeln, Scheidweg",,0.000047,69,1,1,2,2129,2129,4258,1,1,1,34.5,0,0
8582637,"Einsiedeln, Rietstrasse",,0.000047,69,1,1,2,4276,4276,8552,1,1,1,34.5,0,0
8582632,"Einsiedeln, Diorama",,0.000024,69,1,1,2,4419,4419,8838,3,0.5,0.611111,201,0,0
8582633,"Einsiedeln, Gerbe",,0.000032,69,1,1,2,4419,4419,8838,2,0.666667,0.75,136,0,0
8582634,"Einsiedeln, Wasenmattstrasse",,0.000038,69,1,1,2,4419,4419,8838,1,1,1,69,0,0
8582642,"Däniken, Bahnhof",,0.000011,119,0,1,1,0,980,980,3,0.5,0.611111,0,0,0
8582654,"Däniken, Industrie",,0.00002,119,1,1,2,980,1929,2909,2,0.666667,0.75,2,0,0
8582655,"Däniken, Aarefeld",,0.000028,119,1,1,2,1929,1929,3858,1,1,1,2,0,0
8582658,"Pfäffikon ZH, Witzberg",,0.000028,84,1,1,2,9058,9057,18115,7,0.259259,0.32449,91,0,0
8587231,"Brienz BE, Buscheli",,0.000143,114,4,3,7,3548,2620,6168,7,0.3,0.510317,716,0,0
8587521,"Brienzwiler, Dorf",,0.000071,114,2,1,3,3840,1152,4992,1,1,1,0,0,0
8582662,"Oberglatt ZH, Bälen",,0.00012,107,2,1,3,10338,10331,20669,1,1,1,93,0.000005,0
8582669,"Le Landeron, centre",,0.000134,48,5,1,6,2951,1365,4316,15,0.109012,0.144373,4114.5,0,0
8582671,"Marin-Epagnier, La Tène",,0.000071,48,1,1,2,2605,2605,5210,13,0.124361,0.149573,2697.5,0,0
8582674,"Yvonand, Les Vursys",,0.000052,13,3,1,4,2786,2786,5572,2,0.666667,0.75,366,0,0
8582676,"Mont-sur-Rolle, Bellefontaine",,0.000035,32,1,1,2,4066,4067,8133,4,0.4,0.520833,46,0,0
8582678,"Biasca, Centro Sportivo",,0.000066,108,2,1,3,4826,4826,9652,2,0.666667,0.75,2024,0,0
8582679,"Biasca, Municipio",,0.000067,108,1,1,2,4826,4826,9652,1,1,1,1013,0,0
8582692,"Rolle, route de Gilly",,0.000047,32,1,2,3,6284,6284,12568,3,0.473684,0.555556,216,0,0
8583459,"Bursinel, Château",,0.000037,32,1,2,3,3653,3046,6699,3,0.5,0.595238,34,0,0
8583460,"Luins, Le Vernay",,0.000038,32,1,2,3,833,833,1666,3,0.5,0.595238,26,0,0
8583464,"Rolle, La Prairie",,0.000048,32,2,1,3,2478,2164,4642,3,0.461538,0.527778,155,0,0
8582697,"Bursins, Bourdouzan",,0.000087,32,4,1,5,5707,5431,11138,5,0.3,0.366667,202.333333,0,0
8582699,"Wila, Geissackerstrasse",,0.000047,84,1,1,2,5562,5563,11125,1,1,1,39,0,0
8582701,"Mettmenstetten, Oberdorf",,0.000075,115,2,3,5,4995,5108,10103,2,0.8,0.875,468,0.002358,0
8583742,"Mettmenstetten, Schulhaus",,0.000032,115,1,1,2,2915,1583,4498,2,0.6,0.666667,0,0,0
8583743,"Mettmenstetten, Rennweg",,0.000059,115,2,2,4,3162,3160,6322,1,1,1,61,0,0
8582705,"Gsteig b. Gstaad, Schönenboden",,0.000215,42,1,1,2,1970,1970,3940,5,0.352941,0.463889,456,0,0
8582710,"Monthey-Ville, En Place",,0.00019,103,2,1,3,5109,4609,9718,1,1,1,105,0,0
8582945,"Vernamiège, Fond-Ville",,0.00006,39,3,1,4,4684,301,4985,2,0.6,0.666667,27,0,0
8582715,"Faulensee, Möve",,0.000088,43,1,1,2,6246,6246,12492,9,0.2,0.302897,584,0,0
8582718,"Uesslingen, Trüfelbach",,0.000058,65,1,1,2,4537,4537,9074,1,1,1,173,0,0
8582721,"Hedingen, Hausacker",,0.00003,85,1,1,2,2901,2895,5796,13,0.12708,0.133904,696,0.004479,0
8582722,"Hedingen, Güpf",,0.000036,85,1,1,2,2895,2899,5794,12,0.145147,0.153254,683,0,0
8582724,"Hittnau, Industrie",,0.000077,84,3,1,4,12195,12208,24403,4,0.375,0.430556,399.9,0,0
8583486,"Auslikon, Schulhausstrasse",,0.000029,84,1,1,2,1678,1677,3355,4,0.375,0.430556,1500,0,0
8586432,"Leytron, rue du Collège",,0.000146,39,5,1,6,1058,362,1420,1,1,1,299,0,0
8582727,"Aesch BL, Bahnhof",,0.00005,54,1,1,2,7113,7146,14259,7,0.25,0.370408,225,0,0
8582734,"Mülenen, Suldbrücke",,0.000046,43,3,2,5,1856,1856,3712,14,0.154229,0.24352,717.294398,0,0
8582735,"Emdthal, Bad Heustrich",,0.000031,43,1,1,2,246,246,492,14,0.15,0.218304,0,0,0
8582736,Aeusseres Emdthal,,0.000057,43,2,1,3,1856,1856,3712,13,0.170588,0.260987,537.294398,0,0
8582739,"Bülach, Cholplatz",,0.00005,107,3,1,4,26879,26886,53765,17,0.104974,0.113648,90,0.002618,0
8582743,"Boll, Aeschiweg/Feldackerweg",,0.000017,47,1,1,2,1713,3360,5073,5,0.333333,0.456667,3760,0,0
8582744,"Boll, Gumpisbühlweg",,0.000025,47,1,1,2,3360,3360,6720,4,0.4,0.520833,3012,0,0
8582746,"Boll, Oberfeldstrasse",,0.000032,47,1,1,2,3360,3360,6720,3,0.5,0.611111,2262,0,0
8582747,"Boll, Obermoosstrasse",,0.000038,47,1,1,2,3360,3360,6720,2,0.666667,0.75,1510,0,0
8582748,"Boll, Rüdenweg",,0.000044,47,1,1,2,3360,3360,6720,1,1,1,756,0,0
8583053,"Stallikon, Langfuren",,0.000105,85,3,2,5,5225,5225,10450,7,0.253521,0.290317,1298.453144,0.000017,0.028007
8582753,"St. Erhard, Wiberg",,0.000029,59,1,1,2,2575,2575,5150,2,0.666667,0.75,137,0,0
8583570,"Schiers, Palottis",,0.000055,112,2,1,3,2707,1980,4687,2,0.666667,0.75,182,0,0
8582765,"Näfels, Krumm",,0.000081,106,2,1,3,9443,4834,14277,2,0.666667,0.75,90,0,0
8582766,"Porrentruy, Petite Promenade",,0.00011,50,3,2,5,6761,6523,13284,3,0.571429,0.708333,93,0,0
8582768,"Grossteil, Zopf",,0.000074,92,2,1,3,2329,1444,3773,3,0.5,0.611111,63,0,0
8582772,"Forel (Lavaux), Grand Champ",,0.000056,13,1,1,2,1548,1555,3103,10,0.1875,0.297652,6181.2,0,0
8582773,"Forel (Lavaux), Le Plane",,0.000058,13,1,2,3,1555,1555,3110,9,0.211538,0.36324,5579.2,0,0
8582774,"Forel (Lavaux), La Chesaude",,0.000036,13,1,1,2,733,733,1466,8,0.219512,0.324206,2180.1,0,0
8582775,"Forel (Lavaux), La Chercotte",,0.000036,13,1,1,2,822,822,1644,8,0.219512,0.324206,2180.1,0,0
8582776,"Forel (Lavaux), La Tuilière",,0.000072,13,2,1,3,1555,1555,3110,7,0.25,0.355357,3761.2,0,0
8582777,"Grandvaux, Le Tronchet",,0.000072,13,1,1,2,1555,1555,3110,6,0.291667,0.397619,3151.2,0,0
8582778,"Grandvaux, Crêt-Mouton",,0.000072,13,1,1,2,1555,1555,3110,5,0.352941,0.463889,2539.2,0,0
8582781,"Grandvaux, Le Bougnon",,0.000053,10,3,1,4,2027,2033,4060,4,0.4,0.520833,808,0,0
8588453,"Aran, Pra Forny",,0.000053,10,1,1,2,16550,16551,33101,4,0.4,0.520833,352.8,0,0
8582790,"Ottenbach, Engelwiese",,0.000057,115,2,2,4,5932,5932,11864,11,0.130374,0.154362,502,0.000628,0
8582792,"Gampelen, West",,0.000125,117,1,1,2,1229,1229,2458,1,1,1,586,0,0
8582799,"Aesch BL, Schürhof",,0.000054,54,1,1,2,7146,7146,14292,6,0.285714,0.408333,194,0,0
8582800,"Aesch BL, Neumatt",,0.000056,54,1,1,2,7146,7146,14292,5,0.333333,0.456667,161,0,0
8582801,"Aesch BL, Sportanl Löhrenacker",,0.000059,54,1,1,2,7146,7146,14292,4,0.4,0.520833,126,0,0
8582804,"Ettingen, Lebernweg",,0.000061,54,1,1,2,7146,7425,14571,3,0.5,0.611111,89,0,0
8582807,"Weingarten, Brunnenwies",,0.00006,20,1,1,2,3373,3373,6746,10,0.160305,0.221939,308,0,0
8582810,"Himmelried, Kastel",,0.00004,53,2,1,3,1090,1740,2830,3,0.5,0.611111,12,0,0
8582812,"Himmelried, Steffenplatz",,0.000067,53,2,1,3,4052,1114,5166,1,1,1,12,0,0
8582842,"Klosters, Au",,0.000011,112,0,1,1,0,3141,3141,30,0.082079,0.147686,0,0,0
8582843,"Klosters, Bir Legi",,0.00002,112,1,2,3,3141,5899,9040,29,0.087928,0.176395,59,0,0
8582844,"Klosters, Brachweg",,0.000019,112,1,1,2,2950,3156,6106,29,0.086567,0.162195,0,0,0
8582845,"Klosters, Brügga",,0.000011,112,0,1,1,0,3495,3495,29,0.08589,0.16054,0,0,0
8582846,"Klosters, Bündelti",,0.000036,112,2,3,5,6105,5899,12004,28,0.093137,0.203583,171,0,0
8582848,"Klosters, Doggiboden",,0.000029,112,1,2,3,3156,3156,6312,28,0.091362,0.195228,55,0,0
8582849,"Serneus, Capeira",,0.000092,112,1,3,4,13430,4278,17708,27,0.099278,0.221372,28429.166667,0,0
8582850,"Klosters, Eggarain",,0.00002,112,1,2,3,3495,3496,6991,28,0.092282,0.195834,55,0,0
8582851,"Klosters, Gotschnastrasse",,0.000068,112,4,4,8,7108,8800,15908,27,0.097297,0.227683,16016.166667,0,0
8582847,"Klosters, Bündnerhof",,0.000021,112,1,1,2,2950,3156,6106,29,0.085106,0.159484,4,0,0
8582852,"Klosters, Höfji",,0.000036,112,2,1,3,3141,3141,6282,10,0.204819,0.286018,14,0,0
8582869,"Klosters, Malein",,0.000051,112,1,3,4,6562,6980,13542,6,0.375,0.523611,11763.5,0,0
8582870,"Klosters, Vereinapark",,0.00008,112,4,5,9,7973,7986,15959,6,0.407407,0.631818,7886.166667,0,0
8582853,"Klosters, Hotel Sport",,0.000052,112,2,1,3,5426,6562,11988,26,0.081818,0.131841,8297,0,0
8582854,"Klosters, Höhwald",,0.000068,112,3,2,5,6297,5899,12196,9,0.242424,0.359102,7863.666667,0,0
8582855,"Klosters, Kath. Kirche",,0.000055,112,1,1,2,6562,6562,13124,25,0.087129,0.14037,6390,0,0
8582856,"Klosters, Kirchplatz",,0.000057,112,1,1,2,6562,6548,13110,24,0.093275,0.151483,4481,0,0
8582857,"Klosters, Mälcheti",,0.000034,112,2,1,3,3496,3496,6992,8,0.254902,0.343681,2134.166667,0,0
8582859,"Krattigen, Tschuppen",,0.000076,43,2,1,3,1733,502,2235,1,1,1,134,0,0
8582860,"Klosters, Nutlihüschi",,0.00004,112,1,1,2,2949,3141,6090,8,0.26,0.350092,1993.666667,0,0
8582861,"Klosters, Kraftwerk",,0.00004,112,1,1,2,2950,3156,6106,8,0.254902,0.343681,1980,0,0
8582862,"Klosters, Risweg",,0.00006,112,1,1,2,6548,6548,13096,23,0.100478,0.166875,2570,0,0
8582865,"Klosters, Sportzentrum",,0.000045,112,1,2,3,3156,3156,6312,7,0.315789,0.452183,39,0,0
8582866,"Klosters, Stütz",,0.00004,112,1,2,3,3496,3496,6992,7,0.315789,0.452183,195.166667,0,0
8582867,"Klosters, Täschi",,0.000045,112,1,2,3,3141,3141,6282,7,0.324324,0.466071,52.666667,0,0
8582886,"Klosters, Aeuja Alte Post",,0.000044,112,2,1,3,3156,3156,6312,8,0.222222,0.339732,2,0,0
8582868,"Klosters, Überm Bach",,0.000047,112,1,1,2,6562,6562,13124,7,0.288889,0.372527,13722.5,0,0
8582888,"Klosters, Monbiel Parkplatz",,0.000079,112,1,1,2,6297,5899,12196,6,0.285714,0.408333,12,0,0
8582890,"Klosters, Oberselfranga",,0.000041,112,2,1,3,3496,3496,6992,6,0.285714,0.408333,30,0,0
8583544,"Saas i.P., Sagarank",,0.000065,112,3,1,4,6867,6950,13817,6,0.285714,0.408333,123.5,0,0
8593313,Davos Wolfgang (Bus),,0.000107,131,4,1,5,14430,62,14492,6,0.285714,0.408333,1210.333333,0,0
8582883,"Grossteil, Haltenrain",,0.000074,92,1,1,2,1444,244,1688,2,0.666667,0.75,44,0,0
8582887,"Klosters, Aeuja Brücke",,0.00008,112,3,1,4,6297,6297,12594,7,0.25,0.370408,1989,0,0
8582960,"Cazis, Cafluri",,0.000126,109,5,2,7,5618,3757,9375,1,1,1,3870,0,0
8582967,"Evolène, Village",,0.000035,39,1,1,2,2469,81,2550,1,1,1,313,0,0
8583258,"Bramois, Ecole",,0.000048,39,1,1,2,4158,4158,8316,16,0.138196,0.189265,0,0,0
8582970,"Diemtigen, Katzenlochbrücke",,0.000079,46,2,2,4,1302,1302,2604,2,0.75,0.833333,66,0,0
8582971,"Zwischenflüh, Bühl",,0.000044,46,1,1,2,872,872,1744,2,0.666667,0.75,0,0,0
8582972,"Bassecourt, Jura Centre",,0.000056,1,2,1,3,1871,1871,3742,3,0.5,0.611111,65,0,0
8582974,"S. Antonino, Nosetto",,0.000051,108,1,1,2,17728,17728,35456,14,0.115942,0.150951,3724,0,0
8582975,"Camorino, in Cumlina",,0.000054,108,1,1,2,17728,17728,35456,13,0.128415,0.164995,2841,0,0
8582976,"Camorino, Pro Quadri",,0.000057,108,1,1,2,17728,17728,35456,12,0.144201,0.184371,1956,0,0
8582977,"Camorino, Soabbia",,0.000059,108,1,1,2,17728,17728,35456,11,0.164835,0.213617,1069,0,0
8582979,"Arbedo, Polveriera Nord",,0.000033,108,1,1,2,18572,18467,37039,12,0.144201,0.184371,2778,0,0
8582980,"Arbedo, Ponte Pacciaredo",,0.000039,108,1,1,2,18467,18644,37111,11,0.164835,0.213617,1897,0,0
8582991,"Giubiasco, Via Bellinzona",,0.00006,108,1,1,2,30462,30462,60924,9,0.216418,0.269431,0,0,0
8582994,"Bellinzona, Bagno Pubblico",,0.00006,108,1,1,2,24303,24468,48771,8,0.22,0.306169,5620.75,0,0
8582995,"Bellinzona, dalla Bett",,0.000129,108,3,3,6,21613,23785,45398,9,0.226891,0.331364,5430.952381,0,0
8582999,"Bellinzona, Cimitero",,0.000047,108,1,1,2,22599,22183,44782,9,0.19403,0.241911,0,0,0
8583010,"Bellinzona, Scuola Media 2",,0.000042,108,1,2,3,23538,23538,47076,5,0.391304,0.512963,1226,0,0
8583014,"Bellinzona, Via Jauch",,0.000057,108,2,2,4,46561,46145,92706,4,0.444444,0.552083,4733.047619,0,0
8582996,"Bellinzona, Bramantino",,0.000061,108,1,1,2,24468,24468,48936,7,0.25641,0.342619,4667.75,0,0
8582997,"Bellinzona, Business Center",,0.000063,108,1,1,2,24468,24468,48936,6,0.310345,0.401852,3712.75,0,0
8582998,"Bellinzona, Cast. Montebello",,0.000035,108,1,2,3,7292,7292,14584,5,0.375,0.494444,2203.25,0,0
8583002,"Bellinzona, al Maglio",,0.000203,108,5,2,7,68000,71116,139116,7,0.289157,0.374702,9844.3,0,0
8583004,"Bellinzona, al Persico",,0.000097,108,1,2,3,47578,47578,95156,7,0.283951,0.369255,1077,0,0
8583005,"Bellinzona, Posta Semine",,0.000052,108,1,1,2,30462,30311,60773,7,0.275,0.340584,0,0,0
8583003,"Bellinzona, Nocca",,0.000033,108,1,1,2,23962,23962,47924,5,0.333333,0.411111,5031.047619,0,0
8587466,"Cresciano, Paese",,0.000072,108,1,1,2,15828,16687,32515,2,0.666667,0.75,153,0,0
8583015,"Bellinzona, Via Monte Gaggio",,0.000089,108,3,2,5,23369,23681,47050,2,0.75,0.833333,3249,0,0
8583018,"Bellinzona, Via Vallone",,0.000049,108,1,1,2,23434,23538,46972,2,0.666667,0.75,0,0,0
8583021,"Bellinzona, Viale G. Motta",,0.00009,108,2,1,3,23785,17320,41105,1,1,1,1085,0,0
8583022,"Daro, Pian Lorenzo",,0.00006,108,2,1,3,7292,7505,14797,4,0.4,0.520833,3876,0,0
8583023,"Daro, Pichitt",,0.000062,108,1,1,2,7505,7292,14797,3,0.5,0.611111,2910,0,0
8583024,"Daro, Scuole",,0.000063,108,1,1,2,7292,7292,14584,2,0.666667,0.75,1942,0,0
8583025,"Daro, Via Malmera",,0.000065,108,1,1,2,7292,7505,14797,1,1,1,972,0,0
8583026,"Ravecchia, Belsoggiorno",,0.000035,108,1,1,2,23962,23962,47924,3,0.5,0.611111,3249,0,0
8583027,"Ravecchia, Paese",,0.000041,108,1,1,2,23962,23962,47924,2,0.666667,0.75,2168,0,0
8583028,"Ravecchia, Piazza Fontana",,0.000045,108,1,1,2,23962,23962,47924,1,1,1,1085,0,0
8583034,"Lyss, Kornweg",,0.000041,87,2,1,3,1793,896,2689,1,1,1,1208,0,0
8583036,"Lyss, Grentschel",,0.000065,87,1,1,2,929,929,1858,6,0.285714,0.408333,2424,0,0
8583037,"Lyss, Oberfeldweg",,0.000066,87,1,1,2,929,929,1858,5,0.333333,0.456667,1221,0,0
8583039,"Lyss, Dreihubel",,0.000084,87,2,1,3,1858,929,2787,3,0.5,0.611111,3633,0,0
8583040,"Lyss, Eigerweg",,0.000082,87,1,1,2,929,929,1858,2,0.666667,0.75,2424,0,0
8583041,"Lyss, Jungfrauweg",,0.000081,87,1,1,2,929,929,1858,1,1,1,1213,0,0
8583613,"Waldegg, Leuen",,0.000048,85,2,2,4,13168,10856,24024,17,0.131169,0.162654,12183.150795,0.016188,0.028769
8583755,"Aesch ZH, Heligenmattstrasse",,0.00008,85,4,3,7,5992,4716,10708,17,0.131203,0.163644,21523.746233,0.019345,0.030709
8583890,"Affoltern a.A., Moosbach",,0.000143,115,4,1,5,13445,2770,16215,7,0.251412,0.282343,1144.966571,0.00194,0.027344
8591190,"Zürich, Heuried",,0.000066,85,5,4,9,109709,109608,219317,7,0.248792,0.281611,11525.257152,0.043251,0.120195
8591279,"Zürich, Morgental",,0.000212,85,12,8,20,231233,231468,462701,7,0.297826,0.360375,15044.986884,0.103235,0.121869
8591286,"Zürich, Neubühl",,0.000039,85,2,3,5,48980,47739,96719,7,0.264095,0.311182,35.219875,0.00643,0.042424
8591308,"Zürich, Räffelstrasse",,0.000034,85,1,1,2,40880,40880,81760,7,0.251412,0.282343,57.557523,0.004349,0.004155
8591323,"Zürich, Rosengartenstrasse",,0.000209,85,8,6,14,182260,182199,364459,7,0.30117,0.363061,7139.442122,0.025711,0.018083
8591333,"Zürich, Salzweg",,0.000074,85,3,2,5,94649,94632,189281,7,0.260234,0.29695,446.681201,0.000874,0.00498
8591335,"Zürich, Schaffhauserplatz",,0.00015,85,9,10,19,237785,237755,475540,6,0.342007,0.419928,8236.710243,0.0246,0.034843
8583058,"Niederuzwil, Sonnmatt",,0.00005,20,1,1,2,11574,11574,23148,6,0.285714,0.408333,1130,0,0
8583059,"Niederuzwil, Friedeck",,0.000054,20,1,1,2,11574,11117,22691,5,0.333333,0.456667,906,0,0
8583060,"Niederuzwil, Post",,0.000056,20,1,1,2,11117,11574,22691,4,0.4,0.520833,680,0,0
8583061,"Niederuzwil, Bienenstrasse",,0.000059,20,1,1,2,11574,11490,23064,3,0.5,0.611111,452,0,0
8583066,"Brienz BE, Engi",,0.00005,114,1,1,2,975,975,1950,12,0.155556,0.245467,288,0,0
8583070,"Lungern, Zihl",,0.000074,92,1,1,2,244,244,488,1,1,1,23,0,0
8583482,"Obfelden, Bachstrasse",,0.00007,115,1,1,2,10462,10462,20924,8,0.202703,0.223426,629.561404,0,0.00194
8583101,"Günsberg, Grüngli",,0.000087,56,2,2,4,5729,5729,11458,2,0.75,0.833333,63,0,0
8583103,"Solothurn, Sternen",,0.000048,56,1,2,3,2861,2861,5722,1,1,1,22,0,0
8588590,"Solothurn, Kunstmuseum",,0.000031,56,1,1,2,2134,2134,4268,1,1,1,0,0,0
8583108,"Herbligen, Dorf",,0.000051,100,2,1,3,2575,2555,5130,3,0.5,0.611111,126,0,0
8583110,"Lucens, gare",,0.000208,13,7,3,10,8889,8118,17007,6,0.34375,0.50303,3893.015368,0,0
8591864,"Lucens, centre",,0.00007,13,1,1,2,4282,3997,8279,6,0.3,0.392593,0,0,0
8583432,"Gland, Communet",,0.000058,32,2,1,3,11454,4874,16328,4,0.37037,0.433333,31,0,0
8583223,"Egg SZ, Roblosen",,0.000059,69,1,1,2,2678,2678,5356,3,0.5,0.611111,222,0,0
8583224,"Willerzell, Mösli",,0.000061,69,1,1,2,2678,1571,4249,2,0.666667,0.75,150,0,0
8583226,"Müllheim Dorf, Rosengasse",,0.000116,65,2,1,3,11071,4614,15685,1,1,1,276,0,0
8583233,"Willisau, Schlossfeld",,0.000067,59,2,1,3,450,450,900,2,0.666667,0.75,266,0,0
8583234,"Willisau, Geissburg",,0.000068,59,1,1,2,450,450,900,1,1,1,134,0,0
8583241,"Frasco, Campagne",,0.000046,101,1,1,2,8355,8355,16710,1,1,1,441,0,0
8583242,"Sursee, Post",,0.00003,59,2,1,3,6937,6978,13915,6,0.304348,0.421429,175,0,0
8583244,"Törbel, Biela",,0.000091,40,1,1,2,3142,3142,6284,1,1,1,27,0,0
8583247,"Naters, Aletsch Campus",,0.00008,40,2,2,4,17748,17183,34931,1,1,1,86,0,0
8587704,"Bitsch, Kraftwerk SBB",,0.000045,40,1,1,2,16538,7796,24334,1,1,1,0,0,0
8583248,"La Chaux-de-Fonds, Swin Golf",,0.000074,134,2,2,4,3650,3650,7300,4,0.461538,0.597222,496,0,0
8583702,"Les Joux-Derrière, 44",,0.000043,134,1,1,2,3395,3140,6535,4,0.416667,0.516667,0,0,0
8593670,Balancier,,0.000179,134,10,9,19,213756,212773,426529,8,0.317241,0.460585,23474.466667,0,0
8593685,Marché,,0.000063,134,2,1,3,44800,44262,89062,4,0.416667,0.516667,50,0,0
8583257,"Charmoille, Près de l'Epine",,0.000071,50,1,1,2,5549,5549,11098,6,0.269231,0.378571,161,0,0
8583259,"Sion, Aéroport",,0.000047,39,2,1,3,9771,9714,19485,21,0.093052,0.123504,988,0,0
8583260,"Sion, Agasse",,0.000031,39,1,1,2,1050,1050,2100,18,0.122034,0.165696,874.333333,0,0
8583261,"Sion, Amandiers",,0.000029,39,1,1,2,988,988,1976,18,0.122034,0.165696,21.5,0,0
8583270,"Sion, Gare Bus Sédunois",,0.000176,39,5,5,10,23975,24029,48004,16,0.1566,0.259985,7028.916667,0,0
8583264,"Sion, Châteauneuf",,0.000051,39,1,1,2,9714,9714,19428,20,0.101231,0.134514,815,0,0
8583267,"Sion, Envol Est",,0.000054,39,1,1,2,9714,9714,19428,19,0.111111,0.149373,640,0,0
8583268,"Sion, Envol Ouest",,0.000057,39,1,1,2,9714,9714,19428,18,0.123288,0.17112,463,0,0
8583271,"Sion, Garenne",,0.000066,39,2,2,4,9769,9714,19483,12,0.15859,0.237094,582.916667,0,0
8583281,"Sion, Promenade du Rhône",,0.000085,39,3,1,4,13027,13027,26054,11,0.174699,0.238931,125,0,0
8583273,"Sion, Hôpital de Sion",,0.000069,39,2,2,4,13027,13027,26054,11,0.169082,0.2515,1859.166667,0,0
8583274,"Sion, Jonction",,0.000068,39,2,2,4,9714,9714,19428,11,0.17801,0.266727,816.333333,0,0
8583275,"Sion, Manège",,0.000069,39,2,3,5,13027,13027,26054,10,0.19186,0.295731,1056.75,0,0
8583277,"Sion, Matze",,0.000031,39,1,1,2,5030,5030,10060,11,0.170213,0.236523,0,0,0
8583279,"Sion, Potences",,0.000085,39,3,3,6,9714,9714,19428,10,0.198718,0.306208,925.75,0,0
8583280,"Sion, Pratifori",,0.000035,39,1,1,2,5030,5030,10060,12,0.153061,0.206708,0,0,0
8583283,"Sion, Sacré Coeur",,0.000113,39,2,3,5,21945,21380,43325,10,0.20438,0.306732,3087.333333,0,0
8583284,"Sion, Tennis de Valère",,0.000043,39,1,1,2,9281,10731,20012,10,0.194805,0.275265,0,0,0
8583286,"Sion, Valais de Coeur Champsec",,0.000043,39,1,1,2,8353,8919,17272,9,0.213592,0.278698,1552.5,0,0
8583287,"Sion, Vissigen",,0.000079,39,2,1,3,14477,13027,27504,9,0.225806,0.317545,586.833333,0,0
8583291,"Uvrier, centre commercial",,0.000145,39,4,3,7,3577,3577,7154,15,0.132075,0.216482,6436.833333,0,0
8583292,"Uvrier, Ecole",,0.000052,39,1,1,2,157,157,314,16,0.115108,0.161008,0,0,0
8583366,"Uvrier, Lienne",,0.000096,39,2,1,3,572,572,1144,15,0.127371,0.18314,47,0,0
8583298,"Hofstetten SO, Bergmattenweg",,0.000036,54,1,1,2,113,103,216,1,1,1,34,0,0
8583310,"Ettingen, Chirsgärten",,0.000064,54,1,1,2,7113,7113,14226,1,1,1,9,0,0
8583299,"Hofstetten SO,Witterswilerstr.",,0.000063,54,1,1,2,7425,7113,14538,2,0.666667,0.75,50,0,0
8583301,"Villars-le-Terroir, av. d'Orbe",,0.000041,35,1,1,2,2638,2567,5205,1,1,1,270,0,0
8583306,"Cornol, église",,0.000071,50,1,1,2,5549,5549,11098,5,0.315789,0.422222,144,0,0
8583307,"Cornol, haut du village",,0.000071,50,1,1,2,5549,5549,11098,4,0.384615,0.483333,125,0,0
8583316,"Wichtrach, Murachere",,0.000055,100,1,1,2,2555,2555,5110,2,0.666667,0.75,86,0,0
8583346,"Asuel, La Malcôte",,0.000072,50,1,1,2,5549,5549,11098,3,0.5,0.583333,104,0,0
8583347,"Charmoille, place de l'école",,0.000072,50,1,2,3,5549,5549,11098,2,0.75,0.833333,81,0,0
8583349,"Courgenay, Noires Terres",,0.000041,50,1,1,2,2963,2963,5926,2,0.666667,0.75,0,0,0
8583350,"Courgenay, zone industrielle",,0.000077,50,2,1,3,5549,5549,11098,1,1,1,29,0,0
8583352,"Unterschächen, Hältikehr",,0.000039,93,1,1,2,851,851,1702,8,0.224638,0.273195,417,0,0
8583354,"Unterschächen, Äbnet",,0.00003,93,1,1,2,456,456,912,8,0.218045,0.2633,141,0,0
8588513,"Granges VS, sud",,0.000066,39,2,1,3,7184,7184,14368,14,0.131833,0.17982,3035,0,0
8583374,"Sion, Batassé",,0.000049,39,1,1,2,157,157,314,3,0.5,0.611111,978,0,0
8583375,"Uvrier, Diva",,0.000052,39,1,1,2,157,157,314,2,0.666667,0.75,654,0,0
8583376,"Sion, Chanoine Berchtold",,0.000055,39,1,1,2,157,106,263,1,1,1,328,0,0
8583378,"Cossonay-Ville, Chien-Boeuf",,0.000026,5,1,1,2,7087,7087,14174,7,0.248276,0.289153,120,0,0
8591836,"Morges, Patinoire",,0.000058,5,2,1,3,9812,1588,11400,7,0.248276,0.289153,222.666667,0,0
8592250,"Lonay, église",,0.00009,5,3,2,5,24022,23811,47833,7,0.253012,0.306179,2785.481818,0,0
8583381,"Monthey, Au-delà du Pont",,0.000038,103,1,2,3,545,545,1090,1,1,1,102,0,0
8583718,"Monthey, Collège de l'Europe",,0.000027,103,1,1,2,135,135,270,1,1,1,0,0,0
8583392,"Brig, Zirkusplatz",,0.000041,40,1,1,2,3829,3708,7537,2,0.666667,0.75,558,0,0
8583393,"Brig, Nordstrasse",,0.000046,40,1,1,2,3708,3708,7416,1,1,1,280,0,0
8583402,"Lussery-Villars, rue Villars",,0.000022,5,1,1,2,874,874,1748,1,1,1,98,0,0
8583415,"Bänk (Dägerlen), Hanfland",,0.000056,68,2,1,3,3860,3846,7706,4,0.352941,0.444444,448,0,0
8583416,"Unterseen, Breite",,0.000068,43,1,1,2,3609,3609,7218,1,1,1,197,0,0
8583420,"Courtedoux, le Clôtre",,0.000058,50,1,1,2,68,68,136,2,0.666667,0.75,41,0,0
8583430,"Gland, Lignière-Dullive",,0.000031,32,1,1,2,3653,3653,7306,4,0.363636,0.4375,76,0,0
8583431,"Gland, Les Tuillières",,0.0001,125,2,1,3,4516,3668,8184,1,1,1,40,0,0
8583435,"Zinal, village de vacances",,0.00011,39,1,1,2,302,302,604,1,1,1,22,0,0
8583440,"Gurbrü, Schulhaus",,0.000052,126,3,5,8,8389,6540,14929,10,0.27027,0.475615,514,0,0
8587393,"Lurtigen, Dorf",,0.000047,126,1,1,2,3466,3466,6932,10,0.192982,0.311724,4845,0,0
8587801,"Wileroltigen, Dorf",,0.00002,126,1,2,3,2589,2589,5178,7,0.275862,0.449107,43,0,0
8587802,"Golaten, Dorf",,0.000028,126,2,1,3,2704,2704,5408,7,0.25,0.370408,6,0,0
8587807,"Kerzers, Spittelgässli",,0.000055,126,1,1,2,3195,3195,6390,3,0.5,0.611111,14,0,0
8583441,"Bad Zurzach, Uf Raine",,0.000032,98,1,1,2,872,872,1744,1,1,1,137,0,0
8583452,"Murten, Merlachfeld",,0.000062,126,1,1,2,2118,2118,4236,13,0.157407,0.24491,1445,0,0
8583461,"Rivera, Bivio Sorencino",,0.000061,102,1,1,2,12850,12850,25700,2,0.666667,0.75,300,0,0
8583462,"Rivera, Casa Comunale",,0.000063,102,1,1,2,12850,12850,25700,1,1,1,151,0,0
8583465,"Rolle, Martinet",,0.000043,32,2,2,4,2548,2548,5096,2,0.75,0.833333,4.5,0,0
8583530,"Rolle, déchetterie",,0.000131,32,5,3,8,8287,9167,17454,2,0.714286,0.8,261.5,0,0
8583475,"Cadenazzo, ex Segheria",,0.000148,108,5,1,6,19843,16235,36078,1,1,1,930,0,0
8583478,"Agra, Bivio",,0.000049,102,2,1,3,11774,11774,23548,2,0.666667,0.75,422,0,0
8583479,"Agra, Roncone",,0.000052,102,1,1,2,11774,11774,23548,1,1,1,212,0,0
8583481,"Obfelden, Gessnerstrasse",,0.000069,115,3,1,4,10462,10462,20924,9,0.170093,0.18748,996.561404,0.001139,0
8583485,"Chevroux, La Motte",,0.000036,13,1,1,2,3066,3066,6132,3,0.5,0.611111,333,0,0
8593524,"Hittnau, Isikon",,0.000048,84,2,1,3,363,363,726,4,0.416667,0.516667,500.8,0,0
8595261,"Auslikon, Ober Balm",,0.000092,84,3,2,5,1602,1607,3209,3,0.571429,0.708333,547,0,0
8595262,"Hittnau, Hofhalden",,0.00005,84,1,1,2,363,363,726,3,0.5,0.611111,0,0,0
8583490,"Enges, Verger-du-Bas",,0.000072,48,1,1,2,2605,2605,5210,12,0.140078,0.168106,2014.5,0,0
8593554,Indiennes,,0.000079,48,2,1,3,72517,72531,145048,12,0.140078,0.168106,7101.333333,0,0
8583492,"Stans, Oberstmühle",,0.000034,62,1,1,2,3730,3730,7460,2,0.666667,0.75,220,0,0
8583493,"Stans, Sportanlage Eichli",,0.00004,62,1,1,2,3730,3730,7460,1,1,1,111,0,0
8583495,"Prêles, lavage",,0.000073,117,2,1,3,3082,3082,6164,2,0.666667,0.75,1158,0,0
8583496,"La Neuveville, Château",,0.000073,117,1,1,2,3082,637,3719,1,1,1,580,0,0
8583505,"Züberwangen, Lindenbaum",,0.000097,20,3,1,4,7929,7825,15754,3,0.454545,0.533333,350.833333,0,0
8591663,"Wil SG, Rudenzburg",,0.000028,20,1,1,2,27413,27413,54826,3,0.454545,0.533333,714.166667,0,0
8583507,"Eich, Eichberg",,0.000015,59,1,1,2,3206,3205,6411,4,0.352941,0.444444,236,0,0
8583508,"Eich, Vogelsang",,0.000024,59,1,1,2,3205,3206,6411,3,0.454545,0.533333,123,0,0
8583516,"Avenches, Milavy",,0.000024,126,2,1,3,2814,2814,5628,5,0.3125,0.386667,2.333333,0,0
8583519,"Avenches, Pré-Vert",,0.000097,126,5,1,6,6139,6139,12278,4,0.411765,0.488095,840.333333,0,0
8583521,"Oleyres, collège",,0.000049,126,2,2,4,3047,3048,6095,2,0.75,0.833333,582,0,0
8583726,"Oleyres, Les Carrières",,0.000032,126,1,1,2,1643,1526,3169,2,0.666667,0.75,0,0,0
8583527,"Féchy, En Burnens",,0.000069,32,2,1,3,4562,4561,9123,2,0.666667,0.75,55,0,0
8583528,"Willerzell, Dimmerbach",,0.000063,69,1,1,2,1571,1579,3150,1,1,1,76,0,0
8583532,"Eich, Brand",,0.000096,59,2,1,3,3206,3206,6412,2,0.666667,0.75,251,0,0
8583545,"Diemtigen, Zelgli",,0.000082,46,2,1,3,1302,872,2174,1,1,1,24,0,0
8583547,"Ruggell, Giessa",,0.000116,73,3,2,5,3493,4302,7795,4,0.428571,0.569444,1675.557143,0,0
8583548,"Ruggell, Industriering",,0.00006,73,1,1,2,3366,3456,6822,4,0.384615,0.483333,0,0,0
8583549,"Ruggell, Flandera",,0.000112,73,2,1,3,4392,454,4846,3,0.5,0.583333,537.557143,0,0
8588955,"Haag (Rheintal), Rheinstrasse",,0.000099,73,3,3,6,23683,23449,47132,3,0.583333,0.690476,13573.407143,0,0
8591463,"Buchs SG, Sternstrasse",,0.000063,73,1,1,2,16142,16623,32765,3,0.5,0.583333,8,0,0
8583798,"Martigny, Rossettan",,0.000136,39,4,1,5,3132,3132,6264,5,0.291667,0.390476,1825.25,0,0
8583876,"Bodio TI, Sud",,0.000071,108,2,2,4,12752,12752,25504,6,0.305556,0.430303,1958.25,0,0
8583574,"Oensingen, Gallihof",,0.000044,94,1,1,2,1590,3100,4690,5,0.333333,0.456667,590,0,0
8583576,"Oensingen, Katholische Kirche",,0.000048,94,1,1,2,3100,3100,6200,4,0.4,0.520833,476,0,0
8583577,"Oensingen, Rebhöfli",,0.000052,94,1,1,2,3100,3100,6200,3,0.5,0.611111,360,0,0
8583579,"Oensingen, Schlossstrasse",,0.000055,94,1,1,2,3100,3100,6200,2,0.666667,0.75,242,0,0
8583580,"Oensingen, Schule Oberdorf",,0.000057,94,1,1,2,3100,3100,6200,1,1,1,122,0,0
8583589,"Rafz, Usserdorf",,0.000055,68,1,1,2,11762,6052,17814,2,0.666667,0.75,150,0,0
8583590,"Rafz, Pflegeheim Peteracker",,0.000057,68,1,1,2,6052,5937,11989,1,1,1,76,0,0
8583591,"Seuzach, Im Räbhag",,0.000059,68,1,1,2,3846,3848,7694,3,0.454545,0.533333,343,0,0
8583615,"Flawil, Schändrich",,0.000036,20,1,1,2,2955,2955,5910,1,1,1,230,0,0
8583616,"Flawil, Luegisland",,0.000054,20,1,1,2,11192,11192,22384,1,1,1,205,0,0
8583620,"Spiez, Grueb",,0.000014,43,1,1,2,1636,1636,3272,8,0.238095,0.346786,1026,0,0
8583621,"Spiez, Rütti",,0.000023,43,1,2,3,1636,1636,3272,7,0.28125,0.436243,921,0,0
8583622,"Spiez, Schachen",,0.000021,43,1,1,2,724,724,1448,7,0.258065,0.365774,0,0,0
8588607,"Faulensee, Oberdorf",,0.000083,43,1,1,2,6246,6246,12492,7,0.258065,0.365774,304,0,0
8583667,"Netstal, Wydeli",,0.000079,106,1,1,2,4834,4834,9668,1,1,1,46,0,0
8583676,"Giubiasco, Cimitero",,0.000091,108,2,1,3,36362,18588,54950,1,1,1,1080,0,0
8583682,"Rolle, Les Eaux",,0.000107,32,2,1,3,7192,2631,9823,1,1,1,77,0,0
8583684,"Fideris, Bord",,0.000076,112,2,1,3,3845,3626,7471,1,1,1,1941,0,0
8583700,"Le Cachot, Le Bas-du-Crêt",,0.000074,134,2,1,3,2567,2567,5134,14,0.12114,0.145663,604,0,0
8583727,"Bözberg, Gäbi",,0.00007,57,1,1,2,5465,5465,10930,1,1,1,101,0,0
8583730,"La Côte-aux-Fées, Les Tattets",,0.000075,35,2,1,3,4620,1222,5842,1,1,1,76,0,0
8593785,"L'Auberson, ch. des Grangettes",,0.000094,35,2,1,3,5853,5752,11605,1,1,1,4,0,0
8583735,"Laupen BE, Poly-Areal",,0.000038,126,1,1,2,3833,3832,7665,3,0.5,0.611111,114,0,0
8583756,"Mettmenstetten, Zentrum",,0.000057,115,2,1,3,2193,1579,3772,1,1,1,59,0,0
8583770,"Pfäffikon ZH, Güchweg",,0.000032,84,1,1,2,12206,7305,19511,1,1,1,539,0,0
8589594,"St. Gallen, Krontal",,0.000102,71,5,7,12,106166,106088,212254,12,0.222449,0.311395,4425.674596,0,0
8583800,"Martigny, ch. du Scex",,0.000155,39,2,1,3,3276,3276,6552,4,0.352941,0.444444,1794,0,0
8583801,"Martigny, Bassin du Manoir",,0.000143,39,1,1,2,3276,3276,6552,3,0.454545,0.533333,1500,0,0
8583802,"Martigny, St-Théodule",,0.000132,39,1,2,3,3276,3276,6552,2,0.666667,0.75,1204,0,0
8583864,"Martigny-Croix, Chanton-Bas",,0.000067,39,1,1,2,1147,1147,2294,2,0.6,0.666667,0,0,0
8583803,"Gland, Perron/Fleurs",,0.000066,32,2,1,3,3653,3650,7303,1,1,1,59,0,0
8583810,"Münchwilen AG, Dorfplatz",,0.000078,57,2,1,3,3580,3627,7207,1,1,1,86,0,0
8583834,"Arzo, Via Rossi",,0.000077,99,3,1,4,13759,7652,21411,8,0.194444,0.268112,376.333333,0,0
8589503,"Morbio Inferiore, Polenta",,0.000121,99,1,2,3,33457,20200,53657,8,0.254237,0.370079,646.666667,0,0
8591482,"Balerna, Rimessa AMSA",,0.000066,99,2,3,5,47243,46261,93504,8,0.266667,0.409449,416.216667,0,0
8591486,"Capolago, Posta",,0.000091,99,2,2,4,19350,19350,38700,8,0.217949,0.328641,694.666667,0,0
8583833,"Balerna, Industrie",,0.000044,99,1,1,2,6776,6776,13552,5,0.333333,0.456667,745,0,0
8583836,"Saxon, Route du Léman",,0.000066,39,3,1,4,537,564,1101,4,0.384615,0.483333,295,0,0
8583880,"Martigny, Rue des Meillerettes",,0.000124,39,2,2,4,3276,467,3743,1,1,1,606,0,0
8583891,"Vufflens-Aclens, zone industr.",,0.000048,5,2,3,5,4374,4373,8747,6,0.298507,0.367083,1762.166667,0,0
8592246,"Echichens, église",,0.000032,5,2,3,5,29927,29915,59842,6,0.284615,0.351802,582.922045,0,0
8592252,"Lonay, Maraîchère",,0.000102,5,3,3,6,34952,34952,69904,6,0.284672,0.348718,2703.674925,0,0
8592254,"Lonay, parc",,0.00012,5,3,3,6,24498,21169,45667,6,0.321101,0.394286,2094.2,0,0
8592255,"Lonay, Vozy",,0.000045,5,1,4,5,34625,34620,69245,6,0.324561,0.398198,727,0,0
8592260,"Morges, Blancherie",,0.000056,5,1,2,3,34257,34258,68515,6,0.275591,0.329048,9074,0,0
8592261,"Morges, Casino",,0.000126,5,6,5,11,46928,46930,93858,5,0.365591,0.451961,5144.054679,0,0
8595215,"Bussigny, Reculan",,0.000058,5,2,1,3,34271,34296,68567,3,0.5,0.566667,58.4,0,0
8583894,"Avenches, Hôtel de Ville",,0.000059,126,2,1,3,2931,2814,5745,1,1,1,196,0,0
8584698,"Ernen, Uf dr Blatte",,0.000045,16,1,1,2,1559,1459,3018,1,1,1,6,0,0
8584720,"Menznau, Tanzeren",,0.000061,60,1,1,2,1341,1431,2772,1,1,1,10,0,0
8584837,"Les Diablerets, Les Diablotins",,0.000194,42,1,2,3,1970,1970,3940,4,0.454545,0.616667,385,0,0
8584838,"Les Diablerets, Les Ormonts",,0.000093,42,1,1,2,995,995,1990,3,0.5,0.611111,234,0,0
8584839,"Les Diablerets, Commune",,0.00009,42,1,1,2,995,995,1990,2,0.666667,0.75,158,0,0
8584840,"Les Diablerets,parc des sports",,0.000088,42,1,1,2,995,995,1990,1,1,1,80,0,0
8584988,"Schüpfheim, Biberebrüggli",,0.000047,92,2,1,3,1270,1284,2554,3,0.5,0.611111,66,0,0
8585196,"Unterbach BE, Guntleren",,0.000073,114,2,1,3,2415,2415,4830,2,0.666667,0.75,408,0,0
8585197,"Unterbach BE, Tremelmad",,0.000073,114,1,1,2,2415,2415,4830,1,1,1,205,0,0
8585203,"Mattsand, Kapelle",,0.000034,6,1,1,2,138,138,276,3,0.444444,0.541667,20,0,0
8585405,"Bütschwil, Gemeindehaus",,0.000052,20,2,1,3,87,87,174,5,0.310345,0.396296,404,0,0
8585807,"Uetendorf, Kirche",,0.000065,43,2,1,3,2483,1066,3549,1,1,1,250,0,0
8586483,"Savièse, rue du Patrimoine",,0.000049,39,2,1,3,329,80,409,1,1,1,247,0,0
8588486,Bernoullianum,,0.000045,2,2,3,5,25679,25680,51359,11,0.186613,0.221289,572.145292,0,0
8587014,"St. Niklaus VS, Bahnhof",,0.00015,6,4,2,6,901,894,1795,1,1,1,52,0,0
8587311,"St. Niklaus VS, Stock",,0.000075,6,1,1,2,276,276,552,1,1,1,0,0,0
8587016,"Orselina, al Ponte",,0.00002,101,1,1,2,6136,6331,12467,6,0.285714,0.379167,435.25,0,0
8587017,"Winterthur, Bhf Oberwinterthur",,0.000079,68,2,2,4,23198,20095,43293,11,0.164336,0.227584,3955.333333,0,0
8590200,"Bergdietikon, Baltenschwil",,0.000017,22,2,2,4,16733,16694,33427,7,0.26087,0.370899,470.666667,0.00003,0.000005
8590201,"Bergdietikon, Bergli",,0.000021,22,2,1,3,16695,16617,33312,7,0.25,0.333894,1.666667,0.00002,0.000002
8590220,"Dietikon, Marmori-Weiher",,0.000064,22,3,3,6,16758,16744,33502,5,0.342857,0.481944,72,0,0.000003
8590222,"Dietikon, Oetwilerstrasse",,0.000025,22,3,4,7,38354,32364,70718,15,0.120476,0.143239,2831.804967,0.000034,0.000026
8590235,"Ennetbaden, Schiefe Brücke",,0.000131,22,5,3,8,22208,22208,44416,19,0.085341,0.105831,6146.101649,0.000143,0.000028
8590276,"Spreitenbach, Interio",,0.000071,22,3,2,5,32406,27788,60194,15,0.116841,0.131786,17510.701221,0,0.000021
8590279,"Spreitenbach, Shopping Center",,0.000134,22,4,5,9,54186,54195,108381,15,0.116788,0.135449,19727.11053,0.000001,0.000261
8590223,"Dietikon, Stadthaus",,0.000032,22,2,3,5,51927,51323,103250,4,0.423077,0.537879,768,0.00001,0.000002
8590516,"Dietikon, Hätschen",,0.000023,22,2,2,4,27474,27478,54952,3,0.533333,0.604167,263,0.00001,0.000011
8590518,"Dietikon, Lätten",,0.00003,22,2,1,3,15279,15372,30651,3,0.5,0.547619,28,0.000001,0.00001
8590602,"Fahrweid, Brunaustrasse",,0.000014,22,1,2,3,58287,58549,116836,17,0.152271,0.173239,2210.996187,0.00001,0.000023
8590739,"Oetwil an der Limmat, Post",,0.000038,85,2,2,4,24121,24052,48173,2,0.625,0.7,14,0,0.00105
8591829,"Fahrweid, Au",,0.00016,85,6,4,10,58783,58197,116980,1,1,1,297.868901,0.000957,0.00209
8591833,"Unterengstringen, Sennenbüel",,0.000136,85,5,3,8,40431,37184,77615,1,1,1,3912.192213,0.001888,0.000202
8593529,"Unterengstringen, Langwisen",,0.000083,85,2,2,4,34782,34529,69311,1,1,1,0,0.000053,0.000023
8594732,"Unterengstringen, Sennenbüel N",,0.000119,85,3,1,4,36709,16963,53672,1,1,1,0,0.000056,0.000014
8590241,"Kindhausen AG, Eichholz",,0.000038,22,2,1,3,16588,434,17022,1,1,1,1,0.000001,0.000002
8587021,"Brienz BE, Abzw. Giessbach",,0.000053,114,1,1,2,975,975,1950,11,0.171053,0.263067,229,0,0
8587022,"Brienzerberg, Bramisegg",,0.000056,114,1,1,2,975,975,1950,10,0.190476,0.285747,168,0,0
8587023,"Brienzerberg, Teiffental",,0.000059,114,1,1,2,975,975,1950,9,0.215686,0.317785,105,0,0
8587025,"Hasle LU, Heiligkreuz Kirche",,0.00009,92,3,1,4,1809,944,2753,1,1,1,68,0,0
8587028,"Aire-la-Ville, centre",,0.000017,120,1,1,2,18088,18094,36182,21,0.134873,0.155905,96.25,0,0
8587030,"Athenaz, village",,0.000011,120,0,1,1,0,17390,17390,21,0.134873,0.155905,0,0,0
8587032,"Avusy, village",,0.00002,120,1,1,2,17193,17210,34403,21,0.134873,0.155905,34.5,0,0
8587034,"Bernex, place",,0.000059,120,4,5,9,70107,93784,163891,20,0.15565,0.190514,2716.799924,0,0
8587033,"Bardonnex, village",,0.000011,120,0,1,1,0,11546,11546,21,0.135093,0.154104,0,0,0
8587073,"La Plaine, gare",,0.00008,120,5,6,11,31776,37830,69606,20,0.133188,0.159921,3054.416966,0,0
8587076,"Bernex, Lully-Croisée",,0.000025,120,2,2,4,40960,41123,82083,20,0.151142,0.179659,569.574359,0,0
8587080,"Onex, Salle communale",,0.000045,120,4,6,10,142072,149801,291873,19,0.17087,0.213683,3642.966443,0,0
8587081,"Perly, village",,0.000022,120,1,3,4,17621,17470,35091,20,0.160824,0.194817,109.738356,0,0
8587089,"Sézegnin, village",,0.000025,120,1,2,3,17404,17387,34791,20,0.150651,0.179374,785.725535,0,0
8587091,"Soral, mairie",,0.000035,120,2,2,4,22145,21460,43605,20,0.151691,0.181739,964.060946,0,0
8587035,Bossy,,0.000083,120,3,2,5,14546,28340,42886,18,0.139419,0.158237,6051,0,0
8587064,"Genthod, village",,0.000019,120,1,2,3,27261,27259,54520,19,0.131916,0.152239,290,0,0
8587036,"Vessy, Plateau de Pinchat",,0.000011,120,0,1,1,0,18865,18865,21,0.149428,0.171275,0,0,0
8587050,"Bardonnex, Compesières",,0.00002,120,1,1,2,11546,11544,23090,20,0.155937,0.185499,608,0,0
8587051,"Confignon, mairie",,0.000023,120,2,2,4,24118,24122,48240,20,0.157187,0.188524,378.898739,0,0
8587062,"Genève, Jonction",,0.000028,120,4,8,12,192658,239243,431901,18,0.184882,0.233899,2442.039833,0,0
8587070,"Croix-de-Rozon, douane",,0.000013,120,1,2,3,19018,22597,41615,20,0.160889,0.192881,0,0,0
8587093,"Troinex, mairie",,0.000013,120,1,1,2,18865,18865,37730,20,0.144359,0.168255,0,0,0
8587095,"Versoix, gare",,0.000074,120,3,2,5,28050,28041,56091,18,0.149869,0.177926,4903.241978,0,0
8587904,"Genève, OMS",,0.000029,120,4,5,9,130083,129733,259816,19,0.155885,0.192299,968.450653,0,0
8587042,"Vandoeuvres, Chougny",,0.000014,120,1,2,3,19362,19363,38725,20,0.147188,0.166428,5.5,0,0
8587043,"Choulex, village",,0.000017,120,1,2,3,19157,32566,51723,20,0.148122,0.168601,19.194048,0,0
8587046,"Cologny, chemin des Fours",,0.000014,120,1,1,2,18285,18283,36568,20,0.146685,0.164293,1,0,0
8587094,"Vandoeuvres, village",,0.000041,120,3,4,7,32788,32787,65575,21,0.149694,0.178992,1566.452264,0,0
8587053,"Corsier GE, village",,0.000011,120,0,1,1,0,16956,16956,20,0.152608,0.17388,0,0,0
8587065,"Genthod-Bellevue, gare",,0.000027,120,2,1,3,13677,13679,27356,17,0.135798,0.154249,91.243322,0,0
8587069,"Vésenaz, Capite",,0.00006,120,5,4,9,37601,37598,75199,21,0.147763,0.174701,2675.803625,0,0
8587382,"Choulex, Chevrier",,0.000027,120,2,2,4,32565,32567,65132,21,0.146497,0.171397,315.631037,0,0
8587083,"Plan-les-Ouates, mairie",,0.000015,120,1,2,3,53829,53825,107654,19,0.168907,0.206701,0,0,0
8587084,"Pregny, village",,0.000013,120,1,2,3,25523,25849,51372,19,0.168611,0.20801,5.897619,0,0
8587437,"Carouge GE, Rondeau",,0.000061,120,9,8,17,195400,195755,391155,19,0.168415,0.210739,3521.873395,0,0
8587901,"Bernex, Aigues-Vertes",,0.000017,120,1,1,2,9010,9010,18020,20,0.135203,0.154975,0,0,0
8587384,"Cologny, Gradelle",,0.000066,120,6,5,11,111939,112752,224691,20,0.162663,0.195016,5528.448115,0,0
8587902,"Grand-Lancy, mairie",,0.000051,120,7,3,10,67726,67787,135513,19,0.156049,0.188148,934.25697,0,0
8587086,"Puplinge, mairie",,0.000034,120,1,2,3,17727,37089,54816,20,0.137783,0.166735,2149.385267,0,0
8587906,"Veyrier, école",,0.000029,120,2,3,5,33281,33447,66728,20,0.137507,0.168581,1296.351102,0,0
8592704,"Chêne-Bougeries,Coll.Claparède",,0.000075,120,2,8,10,97736,97730,195466,18,0.17261,0.223535,9593.849352,0,0
8592743,"Cologny, Clos du Môlan",,0.000045,132,2,2,4,75087,75082,150169,21,0.138184,0.167353,374.848413,0,0
8592773,"Genève, 31-Décembre",,0.000137,132,4,6,10,112729,112720,225449,20,0.159847,0.208207,8250.806357,0,0
8592702,"Chêne-Bougeries, Villette",,0.000038,120,2,4,6,55355,55355,110710,19,0.145441,0.184871,922.883227,0,0
8592763,"Corsier GE, Maisons-Neuves",,0.000078,120,1,5,6,34533,29613,64146,20,0.170242,0.216574,5598.849039,0,0
8592765,"Corsier GE, Prés-Palais",,0.000058,120,1,4,5,30883,30883,61766,20,0.170009,0.214563,2928.3317,0,0
8592777,"Genève, Alpes",,0.000062,132,4,2,6,39253,39235,78488,20,0.139231,0.170908,116.919264,0,0
8592797,"Genève, Camille-Martin",,0.000042,132,3,4,7,69341,69342,138683,19,0.157251,0.200895,799.086066,0,0
8592798,"Genève, Canonnière",,0.000043,132,4,3,7,55372,55376,110748,19,0.142857,0.177522,491.698688,0,0
8592801,"Genève, Chantepoulet",,0.000119,132,9,5,14,91914,91898,183812,19,0.159931,0.206749,4710.119692,0,0
8587900,"Chêne-Bougeries, Conches",,0.000017,120,2,3,5,55327,55378,110705,20,0.135677,0.161394,75.282143,0,0
8592774,"Genève, Acacias",,0.00005,132,3,7,10,80329,80362,160691,19,0.162712,0.213897,3634.631558,0,0
8592789,"Genève, Blanche",,0.000033,132,3,7,10,91540,91569,183109,18,0.174278,0.22951,2520.00389,0,0
8592791,"Genève, Bouchet",,0.000091,132,8,9,17,162478,179773,342251,18,0.168626,0.228647,14004.633856,0,0
8592775,"Genève-Aéroport, Terminal",,0.000066,132,8,7,15,184302,207233,391535,17,0.188541,0.239018,17131.275971,0,0
8592782,"Genève, Bains",,0.000031,132,4,4,8,52982,53307,106289,19,0.165337,0.209177,519.975713,0,0
8592793,"Genève, Bout-du-Monde",,0.000042,132,3,4,7,79801,79812,159613,19,0.160171,0.206,1161.346958,0,0
8592802,"Genève, Charmilles",,0.000072,132,7,5,12,165423,165446,330869,18,0.161996,0.209297,2712.376273,0,0
8592812,"Genève, Coutance",,0.000115,132,10,7,17,292860,292554,585414,17,0.168063,0.220382,8208.411899,0,0
8587924,"Vernier, Blandonnet",,0.000069,120,9,10,19,191316,199585,390901,18,0.184539,0.243394,11517.897101,0,0
8588802,"Carouge GE, Stade de Genève",,0.000085,120,8,7,15,170057,169854,339911,18,0.166279,0.213855,6744.388686,0,0
8592649,"Bellevue GE, Valavran",,0.000066,120,2,7,9,71680,71735,143415,16,0.183138,0.233481,2350.572823,0,0
8592757,"Confignon, Berthet",,0.000028,132,1,3,4,37162,37160,74322,19,0.164613,0.205499,405.316587,0,0
8592780,"Genève, Augustins",,0.000031,132,3,4,7,91504,117951,209455,19,0.159763,0.20152,1332.829832,0,0
8592835,"Genève, Guye",,0.000039,132,2,5,7,118588,118590,237178,19,0.176439,0.229243,1275.516897,0,0
8592862,"Genève, Molard",,0.000184,132,12,14,26,218336,218201,436537,19,0.192749,0.270583,22038.032293,0,0
8587071,"Vésenaz, Pallanterie",,0.000028,120,2,3,5,27575,27567,55142,22,0.133082,0.155835,1144.514069,0,0
8587085,"Presinge, village",,0.000054,120,3,2,5,23831,23822,47653,21,0.12944,0.153204,2201.189459,0,0
8587097,"Vésenaz, village",,0.00006,120,4,5,9,69781,69779,139560,21,0.128927,0.156311,1550.318453,0,0
8592622,"Anières, Sous-Chevrens",,0.000047,120,2,2,4,43937,43937,87874,23,0.104534,0.119045,1003,0,0
8589098,"Lancy-Pont-Rouge, gare",,0.000027,120,2,3,5,95466,95522,190988,21,0.141977,0.177802,747.566667,0,0
8587087,"Russin, village",,0.000022,120,1,2,3,12917,12598,25515,17,0.085756,0.133689,19,0,0
8592766,"Dardagny, Essertines",,0.00002,120,1,1,2,11073,11073,22146,17,0.084425,0.118752,0,0,0
8587074,"Laconnex, village",,0.000032,120,2,2,4,22319,22322,44641,21,0.132092,0.152483,1167.670515,0,0
8587477,"Chancy, douane",,0.000029,120,2,2,4,25444,25463,50907,19,0.143224,0.172658,2416.245261,0,0
8587903,"Bernex, Loëx-Hôpital",,0.000025,120,1,1,2,18174,18212,36386,19,0.142817,0.169802,0,0,0
8592922,"Genève, Vieusseux",,0.00011,132,5,7,12,88705,88707,177412,10,0.20467,0.2717,7948.245864,0,0
8592978,"Petit-Lancy, Chemin du Bac",,0.000065,132,4,7,11,156937,156919,313856,10,0.206946,0.265482,13212.502058,0,0
8592983,"Grand-Lancy, Place du 1er-Août",,0.00013,132,8,5,13,117644,94717,212361,10,0.191977,0.240521,9573.205803,0,0
8592984,"Plan-les-Ouates, Le Rolliet",,0.000058,132,2,2,4,45271,45263,90534,10,0.185358,0.219344,513.73764,0,0
8592988,"Grand-Lancy, Palettes",,0.000083,132,5,3,8,106848,106629,213477,9,0.215328,0.258054,8588.525383,0,0
8592991,"Grand-Lancy, Lancy-Piscine",,0.000081,132,3,4,7,75152,53190,128342,9,0.215867,0.264035,1783.308478,0,0
8592660,"Bernex, P+R",,0.000161,120,7,5,12,153103,153111,306214,20,0.137442,0.173375,12942.064361,0,0
8587905,"Veyrier, douane",,0.000021,120,2,3,5,27335,27820,55155,20,0.121537,0.148266,32.934777,0,0
8592716,"Chêne-Bourg, Stade Trois-Chêne",,0.000034,132,2,2,4,36513,36527,73040,14,0.139818,0.192818,2068.685931,0,0
8593083,"Puplinge, Cornière",,0.000067,132,1,1,2,17727,17726,35453,14,0.125237,0.162848,422.119048,0,0
8592629,"Avully, Printanière",,0.000039,120,2,2,4,13000,13000,26000,23,0.099175,0.117372,522.278371,0,0
8592630,"Avully, Gennecy",,0.000043,120,2,2,4,25466,25456,50922,22,0.109464,0.130879,956.108569,0,0
8587385,"Cologny, mairie",,0.000022,120,1,2,3,18285,18283,36568,25,0.097175,0.116231,679.175758,0,0
8587579,Châtaigneriaz,,0.00002,125,1,2,3,10451,10446,20897,19,0.086667,0.11439,142.666667,0,0
8592625,"Anières, Gravière",,0.000058,120,2,2,4,43935,43937,87872,21,0.12246,0.141139,1739.742819,0,0
8592697,"Chêne-Bougeries, Montagne",,0.000059,120,2,2,4,87368,87369,174737,21,0.118562,0.137307,1538.467424,0,0
8592699,"Chêne-Bougeries, village",,0.000031,120,1,2,3,12361,12260,24621,20,0.129947,0.152125,76.065909,0,0
8587104,"Cordast, Kirche",,0.000033,126,1,1,2,3189,3685,6874,12,0.127155,0.143082,6793.666667,0,0
8587105,"Cordast, Schulhaus",,0.000039,126,1,1,2,3685,3685,7370,11,0.144444,0.162733,5711.666667,0,0
8587107,"Courtaman, Studenmatt",,0.000044,126,1,2,3,3685,3685,7370,10,0.167388,0.192655,4627.666667,0,0
8587109,Kleinguschelmuth,,0.000036,126,1,1,2,3189,3189,6378,10,0.165217,0.182877,114,0,0
8587108,Gross Guschelmuth,,0.000029,126,1,1,2,3189,3189,6378,11,0.142857,0.158316,1202,0,0
8594706,"Miège, les Vergers",,0.000075,39,3,1,4,26488,8951,35439,2,0.6,0.666667,168.333333,0,0
8587119,"Porto Ronco, Posta",,0.000021,101,1,1,2,13747,13747,27494,10,0.166667,0.240256,1683.633333,0,0
8591481,"Balerna, Pontegana",,0.000059,99,1,1,2,46261,46261,92522,9,0.220779,0.306186,180.333333,0,0
8587130,"Melano, Tre Pini",,0.000036,99,1,1,2,8097,8097,16194,1,1,1,66,0,0
8587132,"Riva S. Vitale, Scuola Media",,0.000071,99,2,2,4,19350,19350,38700,10,0.184,0.285197,1600.666667,0,0
8587134,"Riva S. Vitale, Cimitero",,0.000041,99,1,1,2,11311,11311,22622,9,0.1875,0.26616,778.666667,0,0
8591485,"Brusino Arsizio, S. Giorgio",,0.000053,99,1,1,2,8039,8039,16078,9,0.1875,0.26616,54,0,0
8587135,"Amriswil, Almensberg",,0.00002,121,1,1,2,16803,16803,33606,18,0.102293,0.123985,9826,0,0
8587138,"Amriswil, Bahnhof",,0.000146,121,6,5,11,63636,72819,136455,16,0.127031,0.175548,46880,0,0
8587143,"Amriswil, Köpplishaus",,0.000046,121,1,2,3,25297,25297,50594,16,0.144118,0.225853,98,0,0
8587145,"Amriswil, Marktplatz",,0.000055,121,2,3,5,38592,38592,77184,15,0.163823,0.276305,7502,0,0
8587146,"Amriswil, Mühlebach",,0.000046,121,2,2,4,25297,21889,47186,16,0.142424,0.226599,525.5,0,0
8587172,"Hefenhofen, Auenhofen",,0.000031,121,1,2,3,5385,5385,10770,3,0.571429,0.708333,1557,0,0
8587178,"Hefenhofen, Sonnenberg",,0.000038,121,1,1,2,4893,4893,9786,1,1,1,2,0,0
8587139,"Amriswil, Grenzstrasse",,0.000036,121,1,1,2,28735,28300,57035,18,0.115646,0.162569,1022,0,0
8587140,"Amriswil, Quellenhof",,0.000041,121,1,1,2,28300,25297,53597,17,0.128205,0.185223,561,0,0
8587147,"Amriswil, Säntisstrasse",,0.000071,121,3,3,6,29461,29461,58922,15,0.159011,0.271763,8976.5,0,0
8587148,"Amriswil, St. Gallerstrasse",,0.000031,121,1,1,2,6892,6892,13784,15,0.144444,0.221692,0,0,0
8587150,"Amriswil, Zentrum",,0.000073,121,3,4,7,38592,37628,76220,14,0.164502,0.295132,12460,0,0
8587156,"Bischofszell, Bruggmühle",,0.000033,121,1,1,2,15974,15974,31948,5,0.307692,0.389583,8,0,0
8587152,"Arbon, Scheidweg",,0.000068,71,3,1,4,31781,31413,63194,14,0.143611,0.16756,29040,0,0
8587154,"Arbon, Alter Werkhof",,0.000057,71,3,3,6,23634,23919,47553,12,0.193694,0.242919,42220.018651,0,0
8587185,"Neukirch (Egnach), Dorf",,0.000096,121,2,2,4,31317,30923,62240,11,0.194915,0.294394,2532,0,0
8589586,"St. Gallen, Heimatstrasse",,0.000068,71,4,2,6,65811,65811,131622,12,0.201852,0.247838,1769.104498,0,0
8587155,"Bischofszell, Ibergstrasse",,0.000026,121,1,1,2,15974,15974,31948,6,0.257143,0.344444,519,0,0
8587158,"Egnach, Bahnhof",,0.000027,71,1,1,2,14514,14120,28634,15,0.122727,0.179336,4991,0,0
8587159,"Egnach, Buech",,0.00004,121,1,1,2,16397,16397,32794,16,0.112903,0.168741,2494,0,0
8587160,"Egnach, Kehlhof",,0.000034,121,1,1,2,14120,14514,28634,14,0.134715,0.192903,4242,0,0
8587161,"Egnach, Kreisel",,0.00004,121,1,1,2,14514,14120,28634,13,0.149701,0.211412,3491,0,0
8587162,"Egnach, Mooswiesen",,0.000045,121,1,1,2,14120,14514,28634,12,0.169014,0.239535,2738,0,0
8587169,"Frasnacht, Domino",,0.000056,121,1,1,2,16803,16803,33606,12,0.169014,0.239535,530,0,0
8587163,"Egnach, Wiedehorn",,0.000045,121,1,1,2,16397,16397,32794,15,0.122727,0.179336,2006,0,0
8587167,"Frasnacht, Arbonia",,0.000049,121,1,1,2,16397,16803,33200,14,0.134715,0.192903,1516,0,0
8587168,"Frasnacht, Bruderer",,0.000053,121,1,1,2,16803,16803,33606,13,0.149701,0.211412,1024,0,0
8587170,"Hagenwil bei Amriswil, Käserei",,0.000026,121,1,1,2,6892,6892,13784,5,0.333333,0.456667,2595,0,0
8587173,"Hefenhofen, Brüschwil",,0.000024,121,1,1,2,4893,4893,9786,3,0.5,0.611111,1036,0,0
8587174,"Hefenhofen, Hamisfeld",,0.000031,121,1,1,2,4893,4893,9786,2,0.666667,0.75,520,0,0
8587175,"Hefenhofen, Hatswil",,0.000026,121,1,1,2,14516,14516,29032,13,0.132075,0.200001,3689,0,0
8587176,"Hefenhofen, Metropol",,0.000033,121,1,1,2,14516,14516,29032,12,0.144928,0.214488,3190,0,0
8587177,"Hefenhofen, Moos",,0.000039,121,1,1,2,14516,14516,29032,11,0.161017,0.23415,2689,0,0
8587180,"Muolen, Bahnhof",,0.000033,121,1,1,2,6892,6892,13784,4,0.4,0.520833,2080,0,0
8587181,"Muolen, Bahnhofstrasse",,0.000039,121,1,1,2,6892,6892,13784,3,0.5,0.611111,1563,0,0
8587182,"Muolen, Dorf",,0.000044,121,1,1,2,6892,6892,13784,2,0.666667,0.75,1044,0,0
8587183,"Muolen, Hirschen",,0.000049,121,1,1,2,6892,6892,13784,1,1,1,523,0,0
8587186,"Neukirch (Egnach), Haldenring",,0.000052,121,1,1,2,16803,16803,33606,4,0.4,0.520833,1590,0,0
8587187,"Neukirch (Egnach), Ost",,0.000068,121,2,1,3,14610,14610,29220,10,0.202128,0.279219,12907,0,0
8587193,"Roggwil TG, Ebnet",,0.000069,121,1,2,3,14610,14610,29220,9,0.24,0.353461,12140,0,0
8587194,"Romanshorn, Alleestrasse",,0.000044,121,1,1,2,14516,14516,29032,10,0.181818,0.26433,2186,0,0
8587208,"Salmsach, Bodana",,0.000058,121,1,1,2,14514,14514,29028,4,0.4,0.520833,68,0,0
8587195,"Romanshorn, Bahnhof",,0.000078,121,2,2,4,28636,29030,57666,9,0.209877,0.326284,10435,0,0
8587196,"Romanshorn, Blumenweg",,0.000044,121,1,1,2,14516,14516,29032,7,0.25,0.370408,5600,0,0
8587197,"Romanshorn, Coop",,0.000044,121,1,1,2,14514,14514,29028,8,0.222222,0.339732,3252,0,0
8587198,"Romanshorn, Gärtliszelg",,0.000048,121,1,1,2,14516,14516,29032,6,0.285714,0.408333,4806,0,0
8587199,"Romanshorn, Hofstrasse",,0.000048,121,1,1,2,14514,14514,29028,7,0.25,0.370408,2459,0,0
8587200,"Romanshorn, Holzenstein",,0.000052,121,1,1,2,14516,14516,29032,5,0.333333,0.456667,4010,0,0
8587201,"Romanshorn, Holzgasse",,0.000055,121,1,1,2,14516,14516,29032,4,0.4,0.520833,3212,0,0
8587202,"Romanshorn, Hueb",,0.000058,121,1,1,2,14516,14516,29032,3,0.5,0.611111,2412,0,0
8587203,"Romanshorn, Oberhüseren",,0.00006,121,1,1,2,14516,14516,29032,2,0.666667,0.75,1610,0,0
8587204,"Romanshorn, Salmsacherstrasse",,0.000052,121,1,1,2,14514,14514,29028,6,0.285714,0.408333,1664,0,0
8587205,"Romanshorn, Spitz",,0.000062,121,1,1,2,14516,14516,29032,1,1,1,806,0,0
8587207,"Salmsach, Birkenweg",,0.000055,121,1,1,2,14514,14514,29028,5,0.333333,0.456667,867,0,0
8587211,"Sitterdorf, Bahnhof",,0.000062,121,2,2,4,20625,20625,41250,3,0.545455,0.638889,3132,0,0
8587214,"Sitterdorf, alte Post",,0.000047,121,1,1,2,15594,15974,31568,2,0.6,0.666667,6,0,0
8587212,"Sitterdorf, Bruggfeld",,0.000037,121,1,1,2,15974,15974,31948,4,0.357143,0.466667,1046,0,0
8587213,"Sitterdorf, Landhaus",,0.000043,121,1,1,2,15974,15594,31568,3,0.444444,0.541667,527,0,0
8587217,"Steinebrunn, Dorf",,0.000055,121,1,1,2,16803,16803,33606,3,0.5,0.611111,808,0,0
8587218,"Steinebrunn, Erdhausen",,0.000058,121,1,1,2,16803,16803,33606,2,0.666667,0.75,24,0,0
8587221,"Steineloh, Sternen",,0.000087,121,1,1,2,14610,14120,28730,2,0.666667,0.75,1592,0,0
8587220,"Frasnacht, Rotbuch",,0.000089,121,2,1,3,15004,14610,29614,3,0.5,0.611111,2395,0,0
8587222,"Zihlschlacht, Rehaklinik",,0.000077,121,2,2,4,20625,20625,41250,1,1,1,1052,0,0
8587223,"Zihlschlacht, Oberdorf",,0.000044,121,1,1,2,16220,16220,32440,1,1,1,0,0,0
8594857,"Rizenbach, Ofenhausstrasse",,0.000068,126,1,1,2,5821,3466,9287,7,0.25,0.370408,152,0,0
8587229,"Reutigen, Dorf",,0.000029,43,1,1,2,1290,1290,2580,13,0.142857,0.184575,100.666667,0,0
8587230,"Mägenwil, Gewerbepark",,0.000033,22,2,1,3,7302,7274,14576,1,1,1,263,0.000332,0
8587232,"Brienz BE, Im Brunnen",,0.000051,114,1,1,2,975,975,1950,6,0.285714,0.408333,486,0,0
8587233,"Brienzerberg, Margel",,0.000054,114,1,1,2,975,975,1950,5,0.333333,0.456667,410,0,0
8587234,"Brienzerberg, Balmi",,0.000057,114,1,1,2,975,975,1950,4,0.4,0.520833,332,0,0
8587235,"Axalp, Totzweg",,0.00006,114,1,1,2,975,975,1950,3,0.5,0.611111,252,0,0
8589154,"Fribourg, Industrie",,0.00016,126,4,1,5,156898,156922,313820,7,0.273333,0.312834,7100.61751,0,0
8589152,"Fribourg, Mon-Repos",,0.000057,126,1,3,4,54452,54452,108904,6,0.333333,0.399593,126.383333,0,0
8589153,"Fribourg, Midi",,0.000098,126,3,2,5,51877,53080,104957,6,0.318182,0.370238,5284.507864,0,0
8589157,"Fribourg, Beaumont-Centre",,0.000053,126,1,2,3,33251,33665,66916,6,0.315385,0.367073,1909,0,0
8589158,"Fribourg, Windig",,0.000031,126,1,2,3,33437,33437,66874,6,0.320312,0.373171,41,0,0
8589159,"Fribourg, Vignettaz-Daler",,0.000079,126,4,2,6,95214,87673,182887,6,0.31746,0.37,597.493254,0,0
8589160,"Fribourg, Veveyse",,0.000033,126,1,1,2,17023,17023,34046,6,0.310078,0.35125,0,0,0
8588353,"Langnau i.E., Hotel Emmental",,0.000173,123,11,3,14,29407,33492,62899,18,0.150424,0.229067,2202.666667,0,0
8587244,"Sumiswald-Grünen, Bahnhof",,0.000103,45,3,1,4,21328,21357,42685,10,0.207792,0.304936,637,0,0
8587245,"Sumiswald, Post",,0.000098,45,1,3,4,21357,21357,42714,9,0.245902,0.407487,596,0,0
8587246,"Sumiswald, Arch",,0.000039,45,1,1,2,9122,9093,18215,4,0.4,0.520833,232,0,0
8587247,"Wasen i.E., Kirche",,0.000044,45,1,1,2,9093,9093,18186,3,0.5,0.611111,177,0,0
8587248,"Wasen i.E., Stegmatt",,0.000048,45,1,1,2,9093,9093,18186,2,0.666667,0.75,120,0,0
8588640,"Wyssachen, Abzw. Roggengrat",,0.00005,45,2,1,3,5852,615,6467,1,1,1,43,0,0
8588602,"Schmitten FR, Schlossmatte",,0.000104,126,4,1,5,12039,4081,16120,6,0.255814,0.316667,146.164502,0,0
8588858,"Fribourg, J. Vogt",,0.000179,126,9,5,14,151166,156922,308088,7,0.259542,0.32563,40306.130611,0,0
8587265,"Balerna, Stazione",,0.000048,99,1,1,2,6776,6164,12940,4,0.4,0.520833,600,0,0
8587599,Bürglen Sonneggstrasse,,0.000044,93,1,2,3,24276,22517,46793,5,0.4,0.535417,767.702381,0,0
8588652,Altdorf Pro Familia,,0.00008,93,1,2,3,17287,9924,27211,2,0.75,0.833333,212.559524,0,0
8588498,"Gossau SG, Oberdorf",,0.000042,71,2,1,3,9040,8801,17841,14,0.144589,0.170134,458.416667,0,0
8590240,"Killwangen, Mühlehalde",,0.00003,22,1,2,3,22927,22927,45854,19,0.083333,0.096783,6402.078571,0,0.000006
8587347,"Zürich, Rote Fabrik",,0.000011,130,0,3,3,0,45207,45207,14,0.129304,0.145771,0,0,0.000099
8590673,"Kilchberg ZH, Bahnhof",,0.000038,130,2,3,5,10345,13634,23979,14,0.130096,0.147944,1359.333333,0,0.003997
8590671,"Kilchberg ZH, Auf Brunnen",,0.000014,130,1,1,2,22481,22316,44797,16,0.126263,0.136602,0,0.000002,0.000002
8590889,"Wallisellen, Herti",,0.000072,107,2,3,5,66542,66521,133063,9,0.187533,0.209487,5879.494751,0,0.037347
8591049,"Zürich, Auzelg",,0.000047,85,3,5,8,112280,115275,227555,8,0.226378,0.258754,6343.998363,0.03558,0.045316
8590631,"Glattbrugg, Zentrum",,0.000053,107,2,3,5,72099,72099,144198,9,0.206917,0.232725,33742.788749,0.000497,0.048747
8590634,"Glattpark, Lindbergh-Allee",,0.000054,85,1,1,2,50504,50502,101006,9,0.205066,0.226879,680,0,0.04647
8590762,"Rümlang, Bäuler",,0.000053,107,2,2,4,102774,92591,195365,11,0.203492,0.228427,11966.724927,0.005051,0.047629
8591048,"Zürich, Ausserdorfstrasse",,0.000026,85,1,2,3,18784,70662,89446,9,0.209102,0.234344,1773.240886,0.000055,0.010323
8591177,"Zürich, Hardplatz",,0.000135,85,11,15,26,257754,257615,515369,7,0.298507,0.35872,28656.267233,0.057723,0.43225
8591247,"Zürich, Lehenstrasse",,0.000038,85,2,2,4,44111,44105,88216,9,0.192308,0.219314,251.605988,0.010263,0.047599
8587350,"Sumiswald, Mauer",,0.000052,45,1,1,2,9093,9093,18186,1,1,1,61,0,0
8589134,"Villars-sur-Glâne, Rochettes",,0.00006,126,2,2,4,54429,55456,109885,7,0.254237,0.299841,1903.72753,0,0
8588860,"Fribourg, Bethléem",,0.000075,126,4,3,7,103948,96581,200529,9,0.209003,0.264035,12348.60015,0,0
8592001,"Lausanne, Boston",,0.000078,10,8,4,12,150810,155738,306548,14,0.192909,0.255899,8154.776097,0,0
8592003,"Lausanne, casernes",,0.000055,10,4,6,10,109316,109307,218623,14,0.196292,0.266273,3292.500131,0,0
8587720,École des Girardet,,0.000043,134,2,3,5,11934,11930,23864,10,0.196903,0.257749,917.82381,0,0
8587436,Vue-des-Alpes,,0.000023,134,1,1,2,282,141,423,11,0.157407,0.193908,0,0,0
8587721,Eplatures-Jaune,,0.000035,134,2,3,5,48986,50218,99204,9,0.216216,0.266712,7605.06746,0,0
8588214,"La Chaux-de-F, Combe-à-l'Ours",,0.000067,134,4,5,9,61920,60998,122918,10,0.203747,0.284364,6525.090476,0,0
8593633,Lycée-Blaise-C,,0.000077,134,4,3,7,47010,47028,94038,13,0.166292,0.239977,12553.566667,0,0
8593649,Jacob-Brandt,,0.000053,134,2,3,5,60167,59673,119840,11,0.211656,0.281775,888.533333,0,0
8592714,"Thônex, Belle-Idée réception",,0.000043,132,2,3,5,50867,50825,101692,22,0.128326,0.155998,757.599207,0,0
8592718,"Choulex, Petit-Miolan",,0.000042,132,3,2,5,32530,32567,65097,23,0.114561,0.136008,1088.382143,0,0
8592719,"Choulex, Rouette",,0.000042,120,1,3,4,31378,31375,62753,25,0.09559,0.114194,4676.5,0,0
8587389,"Satigny, gare",,0.000069,132,3,6,9,45295,51584,96879,24,0.102833,0.140885,4011.641115,0,0
8592639,"Avusy, Sur-le-Moulin",,0.000041,120,1,1,2,17390,17404,34794,23,0.098264,0.111788,1443,0,0
8592667,"Carouge GE, Gavard",,0.000014,120,1,2,3,46878,46888,93766,22,0.119949,0.142154,25.813889,0,0
8592669,"Carouge GE, Armes",,0.000029,120,2,3,5,114907,114906,229813,21,0.132587,0.160605,502.295517,0,0
8592670,"Carouge GE, De Staël",,0.000032,120,2,2,4,91562,91540,183102,21,0.133977,0.159123,361.345264,0,0
8592677,"Carouge GE, Marché",,0.00004,120,3,4,7,115071,115082,230153,20,0.150817,0.18876,1831.019201,0,0
8592679,"Lancy-Pont-Rouge, gare/Etoile",,0.0001,120,7,9,16,198431,198407,396838,20,0.160055,0.211388,14673.913208,0,0
8592786,"Genève, Beau-Séjour",,0.000024,132,2,2,4,26460,26462,52922,19,0.154424,0.189442,94.983412,0,0
8592795,"Genève, Butini",,0.000037,132,5,2,7,48781,48782,97563,19,0.154977,0.191717,1252.507568,0,0
8592796,"Genève, Calas",,0.000044,132,3,3,6,68434,68584,137018,19,0.155107,0.193975,365.279069,0,0
8592803,"Genève, De-Châteaubriand",,0.000089,132,5,3,8,78351,78356,156707,19,0.156157,0.196433,2049.721783,0,0
8592804,"Genève, Cirque",,0.000136,132,12,11,23,193293,193247,386540,18,0.181639,0.245169,11407.220694,0,0
8592805,"Genève, Place Claparède",,0.000062,132,5,8,13,155582,155638,311220,18,0.148902,0.197623,868.724883,0,0
8592843,"Genève, Jardin Botanique",,0.000115,132,6,9,15,144939,147781,292720,20,0.163772,0.219151,3070.871511,0,0
8592844,"Genève, Jean-Jacques",,0.000059,132,3,3,6,69342,69330,138672,21,0.146243,0.183012,411.060374,0,0
8592849,"Genève, Aubert",,0.00007,132,2,3,5,102153,102135,204288,20,0.151828,0.189766,425.188389,0,0
8592851,"Genève, M. d'art et d'histoire",,0.000058,132,3,4,7,34127,34133,68260,20,0.165147,0.213879,633.272314,0,0
8592854,"Genève, Merle-d'Aubigné",,0.000054,132,4,4,8,97415,99516,196931,19,0.172892,0.225126,3910.572333,0,0
8592850,"Genève, Lyon",,0.000097,132,7,7,14,144655,144711,289366,19,0.172178,0.229162,5783.632586,0,0
8587416,"Satigny, Peissy",,0.000028,132,1,1,2,6072,6071,12143,13,0.142857,0.170274,99,0,0
8592992,"Grand-Lancy, Pontets",,0.00007,132,4,4,8,70380,70373,140753,9,0.232,0.284312,3989.409452,0,0
8593012,"Genève-Aéroport, Grand-Hangar",,0.000108,132,6,2,8,98383,98529,196912,10,0.216,0.261679,5488.625431,0,0
8592771,"Dardagny, Malval-Hameau",,0.000026,120,1,1,2,11073,11059,22132,12,0.126492,0.160366,303.333333,0,0
8593089,"Russin, Les Baillets",,0.000047,120,1,2,3,11289,11289,22578,10,0.16242,0.217196,462,0,0
8593100,"Satigny, Rue Carrée",,0.000056,132,2,2,4,16665,16666,33331,9,0.184502,0.237468,1918.1,0,0
8593101,"Satigny, mairie",,0.000047,132,1,1,2,6072,6072,12144,10,0.159744,0.20154,200,0,0
8587395,"Biberen, Bernstrasse",,0.00006,126,2,2,4,5821,5821,11642,9,0.217391,0.382897,3785,0,0
8589137,"Salvenach, Wilerstrasse",,0.000036,126,1,1,2,3466,3466,6932,9,0.2,0.31433,0,0,0
8587401,Altdorf Frauenkloster,,0.00023,93,9,6,15,50518,50244,100762,6,0.355263,0.487037,3845.702381,0,0
8587430,Wassen Pfaffensprung,,0.00006,93,1,1,2,7340,7340,14680,6,0.3,0.377778,60,0,0
8587431,Wassen Wattingen,,0.000094,93,2,3,5,7518,7518,15036,5,0.392857,0.525758,414,0,0
8587505,Erstfeld Birtschen,,0.00007,93,2,1,3,12121,12122,24243,7,0.25641,0.342619,0,0,0
8587506,Erstfeld Reformierte Kirche,,0.00013,93,3,1,4,24255,24648,48903,6,0.310345,0.401852,44,0,0
8587404,"Oberriet SG, Rathaus",,0.00005,73,2,2,4,16706,16472,33178,19,0.099435,0.144354,3606,0,0
8587447,"Lienz, Dorf",,0.000038,73,1,1,2,16142,16142,32284,19,0.097506,0.130269,86,0,0
8587405,"Rüthi (Rheintal), Bahnhofstr.",,0.000032,73,1,1,2,16389,16142,32531,20,0.089783,0.118066,471,0,0
8587570,"Buchs SG, Flösweg",,0.000074,73,4,4,8,29914,29914,59828,11,0.206478,0.294321,61951.568394,0,0
8587571,"Weite, Plattis",,0.000053,73,2,1,3,17320,17320,34640,10,0.197802,0.268276,5283.213632,0,0
8587415,"Satigny, Choully",,0.000021,132,1,1,2,4210,6072,10282,14,0.126103,0.148231,89,0,0
8593137,"Vernier, Aïre",,0.000088,132,5,3,8,79238,79236,158474,6,0.284024,0.352431,3522.356765,0,0
8593142,"Vernier, Barde",,0.000047,132,2,2,4,53092,53096,106188,6,0.272189,0.328623,1199.684025,0,0
8593151,"Vernier, Château-Bloch",,0.000034,132,1,1,2,28369,28364,56733,11,0.157205,0.218288,457.89359,0,0
8593152,"Vernier, Châtelaine",,0.000106,132,3,3,6,127635,127598,255233,7,0.285714,0.360655,2890.684536,0,0
8587419,"Satigny, La Boverie",,0.000045,132,2,3,5,17989,17989,35978,12,0.164983,0.207771,756.65,0,0
8592929,"Genève-Aéroport, WTC",,0.000032,132,2,7,9,113518,113534,227052,17,0.192374,0.256742,12867.205466,0,0
8593010,"Meyrin, Forumeyrin",,0.000034,132,2,2,4,75332,79500,154832,10,0.184158,0.224676,583.429221,0,0
8593011,"Zimeysa, gare",,0.000042,132,3,2,5,33779,33782,67561,11,0.185484,0.222658,3417.874242,0,0
8588313,Baltenswil,,0.000029,107,1,1,2,33502,33518,67020,20,0.085747,0.09697,1764.083333,0.002292,0.002283
8587425,Intschi Aelmen,,0.000044,93,1,1,2,7171,7340,14511,11,0.147826,0.221407,870,0,0
8587426,Gurtnellen Graggental,,0.000048,93,1,1,2,7340,7340,14680,10,0.163265,0.23626,712,0,0
8587427,Gurtnellen Meitschligen,,0.000052,93,1,1,2,7340,7340,14680,9,0.182927,0.254947,552,0,0
8587428,Gurtnellen Fellital,,0.000055,93,1,1,2,7340,7340,14680,8,0.208955,0.279847,390,0,0
8587429,Gurtnellen Surüti,,0.000057,93,1,1,2,7340,7340,14680,7,0.245283,0.316117,226,0,0
8587433,"Vésenaz, Saint-Maurice",,0.000021,120,1,1,2,13054,13054,26108,24,0.094824,0.105598,67,0,0
8592621,"Anières, Chavannes",,0.000021,120,1,1,2,30876,30883,61759,24,0.094824,0.105598,67,0,0
8587442,"Davos Dischma, Dürrboden",,0.000019,131,1,1,2,1145,1145,2290,2,0.666667,0.75,2826,0,0
8587450,"Salvenach, Merzeli",,0.000099,126,2,1,3,4227,4227,8454,2,0.666667,0.75,2430,0,0
8587452,"Chésopelloz, Champ-Montant",,0.000057,126,1,2,3,4309,4308,8617,10,0.164912,0.213458,90.458333,0,0
8588863,"Corminboeuf, Amont",,0.000065,126,2,2,4,41299,41300,82599,9,0.191667,0.241209,3774.458333,0,0
8587453,"Font, école",,0.000038,13,2,1,3,4735,4735,9470,3,0.5,0.611111,966,0,0
8587465,"Osogna, Paese",,0.000144,108,1,2,3,28969,27803,56772,3,0.5,0.611111,4043.9,0,0
8587464,"Biasca, Industrie",,0.000157,108,4,1,5,32075,28969,61044,4,0.368421,0.452381,5123.9,0,0
8587467,"Claro, Sud",,0.000103,108,2,1,3,16864,16687,33551,1,1,1,1089,0,0
8587470,"Pollegio, Pasquerio",,0.000137,108,2,1,3,12033,12752,24785,2,0.666667,0.75,2176,0,0
8587472,"Bodio, Bivio per Personico",,0.000127,108,1,1,2,12752,12752,25504,1,1,1,1089,0,0
8587476,"Champex, télé",,0.000049,104,1,1,2,1395,1424,2819,3,0.5,0.611111,21,0,0
8592627,"Avully, école",,0.00003,120,2,2,4,22342,22360,44702,24,0.090568,0.105472,327.490079,0,0
8587478,St-Martin,,0.000063,48,2,1,3,23034,23094,46128,16,0.125908,0.193758,1117.633333,0,0
8587480,Ostring,,0.000054,44,3,2,5,31432,31405,62837,11,0.203474,0.257666,5607.778571,0,0
8587484,Schönburg,,0.000031,44,1,1,2,15491,15490,30981,12,0.179601,0.220547,144.7,0,0
8589001,Petruskirche,,0.000045,44,1,2,3,6324,6324,12648,9,0.193548,0.252881,165,0,0
8589002,Saali,,0.00004,44,2,1,3,23309,23320,46629,9,0.183051,0.228601,12,0,0
8587483,Salem,,0.000023,44,2,1,3,15474,15491,30965,13,0.153846,0.183663,1281.7,0,0
8590007,Sportplatzweg,,0.000034,44,2,2,4,11686,11684,23370,8,0.222222,0.319286,134.566667,0,0
8590020,Kursaal,,0.000063,44,4,1,5,28904,28912,57816,8,0.213483,0.283459,316.035714,0,0
8587486,"Altstätten SG, Eichbergerstr.",,0.000038,73,1,1,2,16142,16389,32531,19,0.095781,0.12345,474,0,0
8587489,"Oberriet SG, Oberdorf",,0.000047,73,1,1,2,16472,16225,32697,16,0.122222,0.157179,2884,0,0
8587490,"Oberriet SG, Moos",,0.000051,73,1,1,2,16225,16225,32450,15,0.137131,0.180082,2472,0,0
8587492,"Rüthi (Rheintal), Feffetstrasse",,0.000034,73,1,1,2,7891,7891,15782,15,0.135484,0.178656,502,0,0
8588956,"Haag (Rheintal), Thalisstrasse",,0.000039,73,1,1,2,16156,16156,32312,5,0.315789,0.422222,4176,0,0
8587497,"Esslingen, Loogarten",,0.000054,84,2,1,3,21411,21414,42825,2,0.666667,0.75,164,0,0
8587503,Mairie,,0.000044,49,2,1,3,3871,3875,7746,6,0.305556,0.381818,564.5,0,0
8587507,"La Tzoumaz, Le Belochet",,0.000056,122,1,1,2,1524,1524,3048,7,0.242424,0.349107,64,0,0
8587509,"Niederurnen, Ziegelbrückstr.",,0.00008,106,3,1,4,10037,10305,20342,3,0.5,0.566667,118.5,0,0
8589107,"Mühlehorn, Dorf",,0.00006,106,2,1,3,6105,5857,11962,3,0.5,0.611111,29.5,0,0
8588115,"Steinen, Rest. Löwen",,0.000051,91,2,2,4,13973,13641,27614,13,0.174274,0.242932,1720.6,0,0
8587960,"Muotathal, Hölloch",,0.000052,91,2,1,3,15003,9529,24532,15,0.130742,0.175526,896.166667,0,0
8587535,"Rothenthurm, Bahnhof",,0.000085,91,2,2,4,10498,7440,17938,4,0.461538,0.597222,1974,0,0
8587856,"Rothenthurm, Altmatt Bahnhof",,0.000051,91,1,1,2,9423,9423,18846,4,0.4,0.520833,4,0,0
8587549,"Lausanne, La Vulliette",,0.00008,13,3,2,5,19331,19330,38661,12,0.211765,0.295261,2054.433333,0,0
8587550,"Montblesson, La Perronnaz",,0.000057,13,2,1,3,32785,32791,65576,12,0.207101,0.275126,35,0,0
8587547,"Lausanne, Chalet à Matthey",,0.00002,13,1,1,2,32750,32791,65541,14,0.155738,0.205283,325,0,0
8587569,"Buchs SG, NTB/BZB",,0.000027,73,1,1,2,16623,16623,33246,11,0.157258,0.202799,9296.733333,0,0
8588220,"Buchs SG, Langäulistrasse",,0.000077,73,3,3,6,29305,29305,58610,8,0.233083,0.321083,24884.385714,0,0
8591449,"Buchs SG, Grünaustrasse",,0.000049,73,2,2,4,6340,6340,12680,7,0.235294,0.332262,1482.385714,0,0
8591450,"Buchs SG, Brunnenstrasse",,0.000053,73,2,2,4,12682,12682,25364,7,0.260274,0.354887,3869,0,0
8587575,"Commugny, centre",,0.000024,125,1,1,2,83,83,166,20,0.082484,0.106957,1280,0,0
8587576,"Coppet, Les Rojalets",,0.000032,125,2,2,4,25331,25938,51269,20,0.082748,0.110625,5355,0,0
8587591,"Mergoscia, ai Mulini",,0.000028,101,1,1,2,6331,6331,12662,5,0.35,0.445238,9.25,0,0
8591548,"Locarno, Via Monteguzzo",,0.000163,101,2,1,3,17352,17316,34668,5,0.35,0.445238,1330.75,0,0
8587592,"Cevio, Boscioli",,0.00002,101,1,1,2,17582,17582,35164,2,0.6,0.666667,1299,0,0
8587594,"L'Auberson, Vers-chz-ls-Jaques",,0.000097,35,2,1,3,5783,5854,11637,3,0.5,0.583333,226,0,0
8587597,"Hermiswil, Brücke",,0.000066,88,1,2,3,9006,9006,18012,3,0.555556,0.666667,440,0,0
8588093,"Wynigen, Oberer Kasten",,0.000039,88,1,1,2,8758,8758,17516,3,0.5,0.583333,0,0,0
8587598,"Oberhofen, Wichterheer",,0.000252,43,5,1,6,4911,569,5480,2,0.666667,0.75,404,0,0
8587608,"Scheuren, Schulhaus",,0.000025,87,1,1,2,8959,8959,17918,14,0.126984,0.186591,3640,0,0
8587610,"Schwadernau, Gemeindehaus",,0.000033,87,1,1,2,8959,8959,17918,13,0.139394,0.199361,2753,0,0
8587611,"Schwadernau, Sagibach",,0.000039,87,1,1,2,8959,8959,17918,12,0.15493,0.215965,1864,0,0
8587612,"Schwadernau, Chrumenacher",,0.000044,87,1,1,2,8959,8958,17917,11,0.175,0.239098,973,0,0
8587614,"Biel/Bienne, Heilmann-Strasse",,0.000031,87,1,1,2,48514,48511,97025,22,0.117246,0.145022,1836,0,0
8587615,"Biel/Bienne, BBZ/CFP",,0.000037,87,1,1,2,48511,48511,97022,21,0.132115,0.169902,1106,0,0
8587622,"Biel/Bienne, Schlösslistrasse",,0.000044,87,1,1,2,48503,48511,97014,20,0.111111,0.14303,1547,0,0
8587624,"Biel/Bienne, Zollhaus/Octroi",,0.000052,87,2,1,3,50287,50291,100578,18,0.135279,0.184933,60095.911111,0,0
8587623,"Biel/Bienne, Bözingen/Boujean",,0.000069,87,3,2,5,99376,98742,198118,19,0.12395,0.167893,7884.5,0,0
8588061,"Frinvillier, gare",,0.000054,87,3,4,7,5526,3178,8704,3,0.6,0.703704,3789.5,0,0
8588494,"Vauffelin, Dynamic Test Center",,0.000034,87,2,3,5,1251,1251,2502,4,0.470588,0.614583,5.5,0,0
8587621,"Biel/Bienne, Redernweg",,0.000039,87,2,1,3,48481,48503,96984,21,0.100756,0.127017,2684,0,0
8587899,"Biel/Bienne, Bf Mett/gare Mache",,0.000061,87,4,3,7,118199,118324,236523,9,0.243243,0.319716,14705.588889,0,0
8592466,"Biel/Bienne, Lechmann",,0.000045,87,2,1,3,38427,38402,76829,9,0.211982,0.261603,28,0,0
8587626,"Biel/Bienne, Rolex",,0.000053,87,4,3,7,53624,53518,107142,16,0.157729,0.233885,57225.271429,0,0
8587628,"Pieterlen, Schlössli",,0.000033,87,1,1,2,11530,11530,23060,17,0.134986,0.179155,98,0,0
8587629,"Pieterlen, Gemeindehaus",,0.000054,87,2,2,4,12105,12112,24217,16,0.154459,0.222218,2718,0,0
8587627,"Pieterlen, Bahnhof",,0.000026,87,1,1,2,11530,11530,23060,18,0.12,0.153736,1262,0,0
8587630,"Pieterlen, Industrie West",,0.000034,87,1,1,2,11530,11530,23060,16,0.137536,0.179163,1265,0,0
8587634,"Wangen b. Olten, Am Kreuzbach",,0.000073,94,3,1,4,15170,15170,30340,14,0.140562,0.221305,1390.307143,0,0
8588647,"Härkingen, Altgraben",,0.000026,94,1,1,2,10700,10700,21400,15,0.12,0.178223,0,0,0
8594152,"Trimbach, Grossfeld",,0.00004,94,1,2,3,31826,31826,63652,3,0.555556,0.666667,124.458333,0,0
8587636,"Egerkingen, Thalrich",,0.000051,94,1,1,2,14412,14412,28824,18,0.119565,0.22099,451,0,0
8587639,"Aegerten, Salismatte",,0.000094,87,4,2,6,31397,31397,62794,9,0.240506,0.348016,23338.666667,0,0
8588321,"Schüpfen, Bahnhof",,0.000054,87,1,1,2,82,82,164,9,0.223684,0.300724,17,0,0
8588317,"Bassersdorf, Bächli",,0.000026,107,1,1,2,30791,33518,64309,17,0.106061,0.115893,12161.16286,0.000002,0.005807
8587653,"Dübendorf, Bahnhof",,0.000011,129,0,6,6,0,132088,132088,19,0.128672,0.157636,0,0,0
8590488,"Aesch bei Maur, Zollingerheim",,0.00002,129,1,2,3,5960,5959,11919,19,0.107327,0.123027,457,0,0
8590547,"Dübendorf, Alterszentrum",,0.000021,129,2,2,4,17254,32951,50205,19,0.107294,0.123406,14,0,0
8590549,"Dübendorf, Bauhof",,0.000012,129,1,1,2,19879,19879,39758,20,0.104372,0.117528,0,0,0
8590550,"Dübendorf, Bettlistrasse",,0.000032,129,3,4,7,54183,54194,108377,19,0.116279,0.136561,569.700935,0,0
8590551,"Dübendorf, Branzenäsch",,0.000018,129,1,1,2,19843,19843,39686,19,0.106172,0.118574,0,0,0
8588745,"Wallisellen, Steinacker",,0.000024,107,1,1,2,5985,5985,11970,14,0.146151,0.158964,408.833333,0,0.000231
8590583,"Dübendorf, Ringwiesen",,0.000047,107,1,2,3,35282,35275,70557,11,0.152208,0.168858,1874.691667,0,0.00139
8587683,"Männedorf, Spital",,0.000091,8,2,1,3,8356,8356,16712,4,0.375,0.458333,582,0,0
8587684,"Männedorf, Asylstrasse",,0.000088,8,1,1,2,8356,8353,16709,3,0.5,0.566667,490,0,0
8587685,"Stäfa, Lattenberg",,0.00005,8,1,1,2,6754,6760,13514,5,0.333333,0.456667,480,0,0
8587686,"Stäfa, Echtlenbach",,0.000054,8,1,1,2,6760,6761,13521,4,0.4,0.520833,388,0,0
8587687,"Stäfa, Rain",,0.000056,8,1,1,2,6761,6761,13522,3,0.5,0.611111,294,0,0
8587688,"Stäfa, Wiesengrund",,0.000059,8,1,1,2,6761,6761,13522,2,0.666667,0.75,198,0,0
8587689,"Männedorf, Sonnenfeld",,0.000086,8,1,3,4,8353,7290,15643,2,0.8,0.875,396,0,0
8588139,"Stäfa, Strandbad",,0.000035,8,1,1,2,6045,6042,12087,3,0.5,0.611111,0,0,0
8588734,"Männedorf, Im Russer",,0.000066,8,1,1,2,7115,7111,14226,1,1,1,2,0,0
8587690,"Bisisthal, Schwarzenbach",,0.000037,91,1,2,3,1767,1767,3534,5,0.388889,0.540476,1824,0,0
8587795,"Bisisthal, Schlänggen",,0.000034,91,1,1,2,770,770,1540,5,0.333333,0.456667,5,0,0
8587691,"Bisisthal, Sahli Seilbahnstat.",,0.000027,91,1,1,2,822,770,1592,6,0.285714,0.408333,305,0,0
8587698,"Bitsch, Eiche",,0.000054,40,1,1,2,1934,1934,3868,5,0.333333,0.456667,215,0,0
8587699,"Bitsch, Wasen",,0.000057,40,1,1,2,1934,1928,3862,4,0.4,0.520833,176,0,0
8587700,"Bitsch, Sattel",,0.000059,40,1,1,2,1928,1934,3862,3,0.5,0.611111,135,0,0
8587701,"Bitsch, Unners Äbnet",,0.000061,40,1,1,2,1934,1934,3868,2,0.666667,0.75,92,0,0
8587702,"Bitsch, Bitschschlüecht",,0.000063,40,1,1,2,1934,1934,3868,1,1,1,47,0,0
8588667,"Founex, village",,0.000061,125,1,2,3,15286,15267,30553,9,0.190909,0.290779,681,0,0
8587717,Adlikon bei Andelfingen,,0.000037,68,1,1,2,3239,3229,6468,3,0.5,0.611111,113,0,0
8589282,Entilles,,0.000032,134,2,2,4,48989,49888,98877,11,0.186158,0.224237,1279.616667,0,0
8591897,"La Chaux-de-Fonds, Tourbillon",,0.000025,134,1,1,2,27230,27231,54461,11,0.184211,0.214162,0,0,0
8593621,Vy-Perroud,,0.000057,49,1,2,3,10667,4330,14997,2,0.75,0.833333,22,0,0
8595197,La Léchère,,0.00005,49,1,1,2,999,999,1998,3,0.5,0.611111,9,0,0
8588797,Grand-Rue,,0.000109,49,5,2,7,12749,10889,23638,2,0.666667,0.75,567,0,0
8595198,Le Preyel,,0.000103,49,3,1,4,5922,3970,9892,2,0.666667,0.75,8,0,0
8587735,"Sursee, Holzacherstrasse",,0.000058,59,3,1,4,7139,2950,10089,4,0.4,0.520833,426,0,0
8587736,"Kottwil, Zuswil",,0.00006,59,1,1,2,2950,2950,5900,3,0.5,0.611111,262,0,0
8587739,"Ibach, Oberschönenbuch",,0.000022,91,2,2,4,4609,4635,9244,10,0.176056,0.255698,1116,0,0
8592394,"Ibach, Abzw. Unterschönenbuch",,0.00002,91,1,1,2,2310,2310,4620,10,0.170213,0.224686,0,0,0
8587740,"Schwyz, Mangelegg",,0.000013,91,1,1,2,4795,6024,10819,7,0.24,0.294974,25,0,0
8587744,"Bronschhofen, Himmelrich",,0.000043,20,2,2,4,14217,14217,28434,6,0.318182,0.492857,1169,0,0
8587755,"Bronschhofen, Würe",,0.000029,20,1,2,3,13975,13975,27950,5,0.375,0.547222,420,0,0
8587745,"Avegno, Grotti",,0.000028,101,1,2,3,17582,17582,35164,1,1,1,868,0,0
8591542,"Cavergno, Vingera",,0.000023,101,1,1,2,8792,8792,17584,1,1,1,0,0,0
8587746,"Yvorne, Clos de l'Ombren",,0.000038,103,1,1,2,2709,2709,5418,5,0.333333,0.456667,360,0,0
8587756,"Bronschhofen, Eggwilstrasse",,0.000042,20,2,1,3,7225,6983,14208,5,0.333333,0.456667,420,0,0
8587758,"Rossrüti, Oberdorf",,0.000072,20,2,1,3,28617,28617,57234,7,0.243243,0.317725,1403.666667,0,0
8587762,"Wuppenau, Abzw. Welfensberg",,0.000079,20,2,2,4,6108,9481,15589,7,0.253521,0.364021,362.666667,0,0
8587865,"Rossrüti, Altersheim",,0.000106,20,2,3,5,33490,16916,50406,6,0.303571,0.432353,1452.5,0,0
8591549,"Losone, Agricola",,0.000118,101,3,3,6,89804,92016,181820,5,0.354839,0.506061,4339.186905,0,0
8587778,"Bazenheid, Ochsen",,0.000113,20,4,1,5,7411,7411,14822,4,0.352941,0.444444,5610,0,0
8587779,"Kirchberg SG, Breiti",,0.000107,20,1,1,2,7411,7411,14822,3,0.454545,0.533333,4157,0,0
8589965,"Orvin, Petit-Moulin",,0.000034,87,2,2,4,3861,1304,5165,4,0.461538,0.597222,2,0,0
8587796,"Bisisthal, Mettlen",,0.000055,91,2,1,3,1715,1767,3482,4,0.4,0.520833,924,0,0
8587797,"Bisisthal, Laui",,0.000058,91,1,1,2,1767,1767,3534,3,0.5,0.611111,620,0,0
8588091,"Wileroltigen, Mösli",,0.000067,126,1,1,2,2089,2089,4178,1,1,1,6,0,0
8587804,"Kerzers, Schwimmbad",,0.000044,126,2,1,3,3195,3195,6390,6,0.285714,0.408333,140,0,0
8587805,"Kerzers, Reservoirweg",,0.000048,126,1,1,2,3195,3195,6390,5,0.333333,0.456667,100,0,0
8587806,"Kerzers, Alte Oele",,0.000052,126,1,1,2,3195,3195,6390,4,0.4,0.520833,58,0,0
8587808,"Kerzers, Käserei",,0.000066,126,2,1,3,3685,2089,5774,2,0.666667,0.75,54,0,0
8587810,"Fraubrunnen, Bahnhof",,0.000052,45,2,1,3,4651,4511,9162,14,0.106013,0.129588,102,0,0
8587811,Zauggenried,,0.000055,45,1,1,2,4511,4511,9022,13,0.116814,0.140074,117,0,0
8587813,"Lyssach, Bernstrasse (Ikea)",,0.000101,45,3,1,4,28317,28450,56767,11,0.147465,0.171132,345,0,0
8587814,"Lyssach, Lyssachschachen",,0.000097,45,1,1,2,28450,28441,56891,10,0.17027,0.195729,354,0,0
8587815,"Burgdorf, Fabrikweg",,0.000093,45,1,1,2,28441,28459,56900,9,0.201954,0.232559,361,0,0
8587828,"Kirchberg BE, Einkaufszentrum",,0.000036,45,1,1,2,12819,12819,25638,9,0.2,0.235807,52,0,0
8588910,"Burgdorf, Lorraine",,0.000028,45,1,2,3,9731,9731,19462,5,0.375,0.457778,51,0,0
8588908,"Burgdorf, Gyrischachen",,0.000032,45,1,3,4,18718,18718,37436,4,0.425,0.509804,245.5,0,0
8588912,"Burgdorf, Choserfeld",,0.000041,45,1,1,2,9735,9736,19471,5,0.333333,0.39359,19,0,0
8587819,"Burgdorf, Oberdorf",,0.000018,45,1,1,2,13569,13569,27138,12,0.134185,0.176287,420,0,0
8587820,"Oberburg, Post",,0.000026,45,1,2,3,13569,13569,27138,11,0.151292,0.207037,401,0,0
8587821,"Oberburg, Schwandgasse",,0.000022,45,1,1,2,6652,6652,13304,11,0.145522,0.179193,62,0,0
8587822,"Oberburg, Schulstrasse",,0.000022,45,1,1,2,6917,6917,13834,10,0.165939,0.1993,256,0,0
8587823,"Oberburg, Schulhaus Stöckern",,0.00003,45,1,1,2,6652,6652,13304,10,0.165939,0.1993,38,0,0
8587824,"Oberburg, Pfisternstrasse",,0.000055,45,2,1,3,13569,13569,27138,9,0.193717,0.2281,305,0,0
8587825,"Oberburg, Ziegelgut",,0.000057,45,1,1,2,13569,13569,27138,8,0.233766,0.273446,276,0,0
8587827,"Kirchberg BE, Grossmatt",,0.00003,45,2,1,3,12573,12819,25392,10,0.169884,0.201506,69,0,0
8587829,"Burgdorf, Eybrücke",,0.000054,45,2,2,4,27646,28088,55734,8,0.244186,0.296684,564,0,0
8587832,"Obergetwing, Rottenbrücke",,0.000087,40,4,1,5,7451,7486,14937,6,0.262295,0.316667,193,0,0
8587834,"Niedergampel,Zivilschutzanlage",,0.000084,40,1,1,2,7486,7487,14973,5,0.333333,0.393333,118,0,0
8588474,"Raron, Turtig",,0.000105,40,6,4,10,12415,12415,24830,3,0.615385,0.729167,529.6,0,0
8588545,"Raron, Dorf",,0.000052,40,2,3,5,5662,4806,10468,3,0.583333,0.690476,8.416667,0,0
8587869,"Burgdorf, Kornhaus",,0.000171,45,8,7,15,64264,64781,129045,6,0.39759,0.514646,1910.904762,0,0
8592468,"Biel/Bienne, Mühle/Moulin",,0.000028,87,1,2,3,62253,62265,124518,8,0.25,0.326116,2854.266667,0,0
8593318,"Biel/Bienne, Beaulieuweg/Ch. B",,0.000023,87,1,2,3,31135,31135,62270,8,0.246032,0.320507,1272,0,0
8593319,"Biel/Bienne, Bermenstrasse",,0.000021,87,1,1,2,15738,15737,31475,8,0.24,0.297857,0,0,0
8587849,"Chamues-ch, Müsella",,0.00006,30,4,2,6,6249,14866,21115,6,0.26087,0.334722,612,0,0
8587850,"Madulain, vih",,0.000036,30,1,3,4,8893,8893,17786,6,0.277108,0.367391,416,0,0
8587852,"S-chanf, Parc Naziunal",,0.000021,30,1,2,3,948,1207,2155,6,0.28,0.351587,318,0,0
8587863,"Chapella, La Resgia",,0.000021,30,1,1,2,6048,6047,12095,7,0.225806,0.27551,0,0,0
8587886,"Zuoz, Chaunt da Crusch",,0.000032,30,1,1,2,8893,8893,17786,8,0.192771,0.263839,18,0,0
8592004,"Lausanne, Cécil",,0.000063,10,5,6,11,152999,152932,305931,14,0.200225,0.27614,3923.060189,0,0
8592010,"Lausanne, Chauderon",,0.000092,10,7,16,23,269181,269629,538810,13,0.227749,0.337124,21255.177134,0,0
8592019,"Lausanne, Clochatte",,0.000033,10,3,2,5,41885,41885,83770,14,0.161458,0.21043,418.04058,0,0
8587855,"Rothenthurm, Distel",,0.000047,91,1,1,2,7382,9423,16805,5,0.333333,0.456667,330,0,0
8588055,"Uster, Oberlandstrasse",,0.000079,84,2,2,4,20572,18605,39177,3,0.571429,0.708333,133,0,0
8588054,"Uster, Meieracher",,0.00005,84,1,1,2,9141,9141,18282,4,0.416667,0.516667,36.333333,0,0
8588106,"Wilen bei Wil, Gemeindezentrum",,0.000041,20,1,2,3,10912,27650,38562,6,0.265306,0.373077,214,0,0
8588721,"Wilen bei Wil, Sonnenplatz",,0.000028,20,1,1,2,13824,13824,27648,6,0.25,0.320833,0,0,0
8587867,"Brusino Arsizio, Rondello",,0.000041,99,1,1,2,8039,8039,16078,12,0.134615,0.200931,507,0,0
8588913,"Burgdorf, Meiefeld",,0.000066,45,3,3,6,18542,18616,37158,4,0.461538,0.5625,284.595238,0,0
8588915,"Burgdorf, Im Choser",,0.000036,45,1,2,3,8687,8687,17374,4,0.434783,0.525,12.742857,0,0
8588917,"Burgdorf, Katholische Kirche",,0.000057,45,1,3,4,11379,11379,22758,4,0.478261,0.583333,88.166667,0,0
8588921,"Burgdorf, Mühlegasse",,0.000064,45,2,1,3,19557,19557,39114,4,0.4,0.458333,30,0,0
8588467,"Burgdorf, Bleichimatt",,0.000055,45,2,3,5,27995,28459,56454,5,0.342857,0.484722,457,0,0
8588715,"Oberburg, Bärenstrasse",,0.000027,45,1,2,3,6652,6652,13304,5,0.323529,0.437879,0,0,0
8589070,"Hasle b.B., Mühle",,0.000061,45,1,2,3,8341,8341,16682,5,0.391304,0.512963,16,0,0
8589196,"Lyssach, Bernstrasse West",,0.000066,45,1,3,4,28450,28455,56905,3,0.6,0.722222,173,0,0
8589910,"Kirchberg BE, Neuhof Süd",,0.000046,45,2,1,3,12817,4339,17156,3,0.5,0.583333,7.333333,0,0
8587872,"Thun, Scherzligen/Schadau",,0.000049,43,2,1,3,5787,5787,11574,13,0.139908,0.176965,2279,0,0
8587876,"Thun, Hännisweg",,0.000037,43,1,1,2,5722,5722,11444,15,0.133739,0.187249,204,0,0
8588481,"Thun, Zeughaus",,0.000075,43,2,1,3,1379,1290,2669,2,0.666667,0.75,171.333333,0,0
8587875,"Thun, Schulstrasse",,0.000031,43,2,1,3,5722,5722,11444,16,0.120321,0.165865,174,0,0
8587877,"Thun, Schorenstrasse",,0.000073,43,2,2,4,7101,7101,14202,14,0.150877,0.225536,2578,0,0
8587878,"Thun, Bodmerstrasse",,0.000042,43,1,1,2,1379,1379,2758,13,0.143564,0.211945,1001,0,0
8587879,"Thun, Schorendörfli",,0.000047,43,1,2,3,1379,1379,2758,12,0.16185,0.258463,731,0,0
8587884,"La Punt, Krone",,0.000074,30,4,1,5,14865,14866,29731,6,0.277778,0.334167,163.5,0,0
8587889,"Zuoz, staziun",,0.000047,30,2,1,3,9152,9099,18251,7,0.223881,0.30127,300.5,0,0
8587891,"Cinuos-chel-Brail, staziun",,0.000064,30,3,2,5,7999,8013,16012,6,0.26,0.369231,229,0,0
8587894,"Zuoz, Aguêl",,0.00006,30,2,1,3,9099,9099,18198,5,0.297297,0.369697,244.5,0,0
8588196,"Genève, Appia",,0.000043,120,5,4,9,130311,130264,260575,19,0.133151,0.166778,1298.314193,0,0
8588310,"Thônex, Sous-Moulin",,0.000069,120,6,9,15,151172,150859,302031,19,0.157584,0.204103,8218.199235,0,0
8592692,"Chêne-Bougeries, Calandrini",,0.000026,120,1,2,3,55379,55380,110759,20,0.127481,0.153441,14.556324,0,0
8592788,"Genève, BIT",,0.000028,120,2,3,5,81170,81167,162337,18,0.156432,0.197524,1293.791024,0,0
8589097,"Veyrier, Tournettes",,0.00005,120,6,4,10,59037,57788,116825,21,0.12278,0.149046,1300.644648,0,0
8592655,"Bernex, Loëx-Lanance",,0.000036,120,1,1,2,9010,9010,18020,21,0.138228,0.167005,930,0,0
8592665,"Bernex, Vuillonnex",,0.000122,120,3,5,8,94423,94220,188643,21,0.140257,0.176999,6962.93346,0,0
8592694,"Chêne-Bougeries, Grangettes",,0.00005,132,5,2,7,96712,96711,193423,21,0.126618,0.151194,4351.697329,0,0
8592706,"Chêne-Bougeries,Grange-Falquet",,0.000032,132,1,2,3,96686,96683,193369,20,0.135937,0.164489,1917.988429,0,0
8592708,"Chêne-Bourg, gare-Place",,0.000047,132,2,2,4,49735,49734,99469,21,0.130258,0.157862,923.51424,0,0
8592634,"Avusy, Eaumorte Hameau",,0.000037,120,2,3,5,34593,34619,69212,21,0.121628,0.147664,1727.429997,0,0
8592638,"Athenaz, Passeiry",,0.000057,120,3,2,5,22158,22157,44315,21,0.121243,0.145483,1319.669219,0,0
8592656,"Bernex, Lully village",,0.00005,120,2,2,4,24123,24123,48246,21,0.121474,0.145816,747.080231,0,0
8592657,"Bernex, mairie",,0.000056,120,2,2,4,41107,41102,82209,21,0.121281,0.145074,2529.238035,0,0
8592658,"Bernex, Maisonnette",,0.000035,120,1,1,2,17401,17401,34802,21,0.121058,0.143277,0,0,0
8592659,"Bernex, Malpertuis",,0.000042,120,1,1,2,18093,18091,36184,21,0.121058,0.143277,3250,0,0
8592758,"Confignon, La Dode",,0.000082,120,3,2,5,92935,93316,186251,19,0.147709,0.184683,9754.451842,0,0
8592778,"Genève, Amandolier",,0.00004,132,3,6,9,143427,143421,286848,19,0.162151,0.211317,1199.784897,0,0
8592826,"Genève, Franchises",,0.000046,132,3,4,7,80856,80856,161712,19,0.161119,0.205941,2601.56992,0,0
8587925,"Meinier, Le Carre-d'Amont",,0.000029,120,2,2,4,18362,18363,36725,27,0.082105,0.098444,1156.233333,0,0
8592715,"Chêne-Bourg, Saut-du-Loup",,0.000032,132,2,2,4,32380,32424,64804,27,0.086502,0.106905,3504.166667,0,0
8592883,"Genève, Place des Eaux-Vives",,0.000139,132,7,8,15,228122,226135,454257,18,0.181088,0.239464,11292.385154,0,0
8592954,"Gy, Turaines",,0.000026,132,1,1,2,8393,8393,16786,7,0.255319,0.343849,0,0,0
8587927,Schattdorf Gandrütti,,0.000154,93,2,2,4,26353,26392,52745,5,0.4,0.535417,887,0,0
8588198,Erstfeld Oberdorf,,0.000076,93,1,1,2,22367,22368,44735,5,0.368421,0.469048,0,0,0
8589525,"Epalinges, Planches",,0.00005,13,2,3,5,79221,79390,158611,15,0.170588,0.313368,6002.68431,0,0
8591963,"Epalinges, Biolleyre",,0.000032,13,1,1,2,32479,32475,64954,16,0.139665,0.231674,25,0,0
8591905,"Ropraz, Ussières",,0.000105,13,1,2,3,4818,4818,9636,9,0.245614,0.386593,1919.8,0,0
8587931,"Bauma, Holderbaum",,0.00003,67,2,1,3,1008,1008,2016,19,0.097778,0.139754,2240,0,0
8587932,"Bauma, Lipperschwändi",,0.000037,67,1,1,2,1008,999,2007,18,0.105911,0.149543,1835,0,0
8587933,"Fischenthal, Bahnhof",,0.000042,67,1,1,2,999,1008,2007,17,0.115702,0.162376,1428,0,0
8587935,"Fischenthal, Schmittenbach",,0.000047,67,1,1,2,1008,1006,2014,16,0.127726,0.180356,1019,0,0
8587936,"Gibswil, Bahnhof",,0.000051,67,1,1,2,1006,1008,2014,15,0.142857,0.208619,608,0,0
8587941,"Hombrechtikon, Grossacher",,0.000033,8,1,1,2,5513,5513,11026,1,1,1,18,0,0
8590449,"Wolfhausen, Zinkereistrasse",,0.000042,8,1,1,2,6009,2819,8828,1,1,1,73,0,0
8587942,"Männedorf, Widenbad",,0.000021,84,1,1,2,8910,7423,16333,1,1,1,18,0,0
8591737,"Jona, Neuhof",,0.000029,67,1,1,2,11329,11326,22655,6,0.307692,0.410417,10,0,0
8591725,"Jona, Bahnhof",,0.000064,67,3,5,8,38537,38554,77091,8,0.25,0.416071,6435,0,0
8595486,"Jona, Buechstrasse Ost",,0.000031,67,2,1,3,2880,2880,5760,1,1,1,0,0,0
8587945,"Rüti ZH, Gubel",,0.000057,67,4,2,6,4703,4697,9400,13,0.175115,0.25566,3491.5,0,0
8587946,"Rüti ZH, Laufenbach",,0.000035,67,1,1,2,4589,4593,9182,13,0.171296,0.235543,0,0,0
8587955,"Wald ZH, Riet",,0.000086,67,1,2,3,899,900,1799,14,0.142857,0.222619,313,0,0
8588012,"Rapperswil SG, Hanfländerstr.",,0.000046,67,3,3,6,16991,16474,33465,11,0.221429,0.341053,5684.166667,0,0
8587948,"Stäfa, Metzg",,0.000061,8,1,1,2,6761,6761,13522,1,1,1,100,0,0
8587951,"Uetikon am See, Bahnhof",,0.000018,84,1,2,3,8716,8716,17432,4,0.409091,0.518519,126,0,0
8588045,"Uetikon am See, Talstrasse",,0.000027,84,1,1,2,6581,6581,13162,4,0.368421,0.452381,7,0,0
8587952,"Uster, Zentralstrasse",,0.000057,84,1,1,2,21414,20968,42382,1,1,1,83,0,0
8587953,"Wald ZH, Elbastrasse",,0.000092,67,3,1,4,1385,900,2285,16,0.117021,0.171048,1207,0,0
8587954,"Wald ZH, Jonatal",,0.000089,67,1,1,2,900,899,1799,15,0.128514,0.188899,761,0,0
8587957,"Wetzikon ZH, Stadion",,0.000053,84,2,1,3,3095,2043,5138,2,0.666667,0.75,534,0,0
8587961,"Bisisthal, vorder Seeberg",,0.00006,91,1,1,2,1767,1767,3534,2,0.666667,0.75,314,0,0
8587988,"Ottikon (Gossau), Hellberg",,0.000053,8,1,1,2,3694,3694,7388,4,0.4,0.520833,12,0,0
8587964,"Erlenbach ZH, Alterswohnheim",,0.000011,8,0,1,1,0,8410,8410,13,0.16568,0.243182,0,0,0
8587965,"Erlenbach ZH, Bahnhof",,0.00002,8,1,3,4,8410,16803,25213,12,0.191489,0.316624,27,0,0
8587966,"Erlenbach ZH, Bahnhofstrasse",,0.000017,8,1,3,4,8076,8199,16275,11,0.208,0.343545,15,0,0
8587967,"Erlenbach ZH, Im Bindschädler",,0.000021,8,2,2,4,8341,8218,16559,11,0.205128,0.350201,18,0,0
8587972,"Erlenbach ZH, Im Streuli",,0.00002,8,1,1,2,3976,4090,8066,11,0.194805,0.306881,0,0,0
8587968,"Erlenbach ZH, Chapf",,0.000021,8,2,1,3,8408,8409,16817,8,0.222222,0.339732,24,0,0
8587969,"Erlenbach ZH, Erlenhöhe",,0.000029,8,1,1,2,8409,8410,16819,7,0.25,0.370408,28,0,0
8587970,"Erlenbach ZH, Föhrenstrasse",,0.000036,8,1,1,2,8410,8410,16820,6,0.285714,0.408333,30,0,0
8587971,"Erlenbach ZH, Im Loo",,0.000041,8,1,1,2,8410,8409,16819,5,0.333333,0.456667,30,0,0
8587973,"Erlenbach ZH, Im Vogelsang",,0.000046,8,1,1,2,8409,8410,16819,4,0.4,0.520833,28,0,0
8587974,"Erlenbach ZH,Kirchgemeindehaus",,0.000042,8,3,3,6,8509,8378,16887,10,0.225806,0.411593,70,0,0
8587975,"Erlenbach ZH, Pflugstein",,0.000023,8,1,1,2,3967,4090,8057,11,0.178082,0.27717,0,0,0
8587977,"Erlenbach ZH, Rebstrasse",,0.000042,8,2,1,3,8324,8012,16336,10,0.2,0.313525,12,0,0
8587976,"Erlenbach ZH, Rankstrasse",,0.00005,8,1,1,2,8410,8410,16820,3,0.5,0.611111,24,0,0
8587978,"Erlenbach ZH, Sandfelsenstr.",,0.000053,8,1,1,2,8410,8410,16820,2,0.666667,0.75,18,0,0
8587979,"Erlenbach ZH, Schulhaus",,0.000058,8,2,2,4,8189,8208,16397,9,0.229167,0.393543,88,0,0
8587997,"Herrliberg, Freudacherstrasse",,0.000041,8,1,1,2,4090,4291,8381,9,0.2,0.31433,9,0,0
8588001,"Herrliberg, Harzerstrasse",,0.000023,8,1,2,3,15440,15878,31318,7,0.288136,0.384874,45,0,0
8587980,"Erlenbach ZH, Trottgatter",,0.000056,8,1,1,2,8410,4299,12709,1,1,1,10,0,0
8587982,"Meilen, Zentrum Feldmeilen",,0.000025,8,2,1,3,7651,7651,15302,6,0.25,0.322727,231,0,0
8587983,"Meilen, Schulhaus Feld",,0.000032,8,1,1,2,7651,7651,15302,5,0.30303,0.37,220,0,0
8587984,"Meilen, Schwabach",,0.000038,8,1,1,2,7651,7651,15302,4,0.391304,0.453704,207,0,0
8588006,"Herrliberg, Rietli",,0.000021,8,1,2,3,10461,10460,20921,4,0.428571,0.527778,30,0,0
8588010,"Herrliberg, Vogtei",,0.000052,8,1,1,2,5414,5414,10828,4,0.391304,0.453704,54,0,0
8587985,"Grüt (Gossau ZH), Bönler",,0.000041,8,2,1,3,3633,3694,7327,7,0.25,0.370408,273,0,0
8587986,"Ottikon (Gossau), Brüschweid",,0.000046,8,1,1,2,3694,3693,7387,6,0.285714,0.408333,188,0,0
8587987,"Ottikon (Gossau), Hasenacher",,0.00005,8,1,1,2,3693,3694,7387,5,0.333333,0.456667,101,0,0
8587989,"Ottikon (Gossau),Herschmettlen",,0.000072,8,2,1,3,3923,3692,7615,3,0.5,0.611111,195,0,0
8587990,"Grüt (Gossau ZH), Hundsruggen",,0.000072,8,1,1,2,3692,3693,7385,2,0.666667,0.75,102,0,0
8587992,"Herrliberg, Alterssiedlung",,0.000018,8,1,1,2,5414,5414,10828,10,0.153061,0.234153,126,0,0
8587993,"Herrliberg, Aryanastrasse",,0.000011,8,0,1,1,0,5419,5419,10,0.183486,0.246508,0,0,0
8587994,"Herrliberg, Bergstrasse",,0.000036,8,1,1,2,3974,4090,8064,10,0.181818,0.292897,9,0,0
8587996,"Herrliberg, Forchstrasse",,0.00002,8,1,1,2,5419,5419,10838,9,0.213483,0.284482,19,0,0
8587998,"Herrliberg, Gartenstrasse",,0.000028,8,1,2,3,5419,21296,26715,8,0.257143,0.361177,36,0,0
8588032,"Meilen, Tobel",,0.000079,8,2,2,4,11997,11997,23994,1,1,1,73,0,0
8590645,"Herrliberg, Rebberg",,0.000076,8,1,1,2,5418,5418,10836,2,0.666667,0.75,34,0,0
8590646,"Herrliberg, Wetzwil",,0.000051,8,1,1,2,10461,5229,15690,2,0.666667,0.75,3,0,0
8587999,"Herrliberg, Grundhofstrasse",,0.000026,8,1,1,2,5414,5414,10828,9,0.168675,0.249263,119,0,0
8588000,"Herrliberg, Grüt",,0.000033,8,1,1,2,5414,5414,10828,8,0.188406,0.267674,110,0,0
8588002,"Herrliberg, Holzwies",,0.00008,8,3,1,4,13942,5418,19360,8,0.222222,0.339732,112,0,0
8588003,"Herrliberg, Humrigen",,0.000039,8,1,1,2,5414,5414,10828,7,0.214286,0.291071,99,0,0
8588005,"Herrliberg, Pfarrgasse",,0.000044,8,1,1,2,5414,5414,10828,6,0.25,0.322727,86,0,0
8588011,"Herrliberg-Feldmeilen, Bahnhof",,0.000096,8,3,3,6,18296,18297,36593,3,0.571429,0.666667,271,0,0
8588007,"Herrliberg, Schulhaus",,0.000049,8,1,1,2,5414,5414,10828,5,0.30303,0.37,71,0,0
8588008,"Herrliberg, Sportplatz",,0.000079,8,1,1,2,5418,5419,10837,7,0.25,0.370408,104,0,0
8588009,"Herrliberg, Tennisplätze",,0.000078,8,1,1,2,5419,5419,10838,6,0.285714,0.408333,94,0,0
8588030,"Meilen, Rebbergstrasse",,0.000048,8,1,1,2,7651,6583,14234,2,0.6,0.666667,6,0,0
8589104,"Rapperswil SG, H.-Rathgeb-Weg",,0.000044,67,2,1,3,15922,16538,32460,11,0.203008,0.286642,350,0,0
8588013,"Meilen, Aebleten",,0.000018,8,1,1,2,5959,5959,11918,7,0.241379,0.318537,34,0,0
8588014,"Meilen, Allmend",,0.000017,8,1,3,4,6044,6044,12088,5,0.375,0.485556,300,0,0
8588015,"Meilen, Alte Sonne",,0.000026,8,1,2,3,5959,5959,11918,6,0.295455,0.405128,26,0,0
8588020,"Meilen, Charrhalten",,0.000043,8,2,1,3,3113,3113,6226,5,0.310345,0.383333,32,0,0
8588016,"Meilen, Au",,0.000027,8,2,2,4,1513,1513,3026,6,0.307692,0.422222,85.5,0,0
8588019,"Meilen, Bundi",,0.000024,8,1,1,2,2312,2312,4624,6,0.25641,0.335,10,0,0
8588017,"Meilen, Bezibüel/Chilchbüel",,0.000016,8,1,1,2,2312,2312,4624,7,0.22,0.302381,21,0,0
8588021,"Meilen, Grueb",,0.000034,8,2,1,3,5959,5959,11918,5,0.333333,0.433333,57.5,0,0
8588022,"Meilen, Grüt",,0.000039,8,1,2,3,5959,5959,11918,4,0.428571,0.569444,38.5,0,0
8588024,"Meilen, Halten",,0.000055,8,1,3,4,5959,5959,11918,3,0.583333,0.690476,170.5,0,0
8588026,"Meilen, In der Au",,0.000043,8,2,2,4,5336,5336,10672,3,0.555556,0.666667,37.5,0,0
8588023,"Meilen, Hallenbad",,0.000052,8,2,1,3,6044,5959,12003,4,0.4,0.46875,191.5,0,0
8588025,"Meilen, Hohenegg",,0.000027,8,1,1,2,5425,5425,10850,3,0.5,0.583333,0,0,0
8588027,"Meilen, Ormis",,0.000068,8,3,2,5,5959,5959,11918,2,0.75,0.833333,102,0,0
8588033,"Meilen, Vorderer Pfannenstiel",,0.000045,8,1,1,2,2312,2312,4624,1,1,1,1,0,0
8588028,"Meilen, Parkresidenz",,0.000038,8,1,1,2,7651,7644,15295,4,0.357143,0.466667,74,0,0
8588029,"Meilen, Plätzli",,0.000043,8,1,1,2,7644,7651,15295,3,0.444444,0.541667,41,0,0
8588031,"Meilen, Roren",,0.00004,8,1,1,2,2312,2312,4624,2,0.666667,0.75,35,0,0
8590647,"Herrliberg-Feldmeilen,Bhf West",,0.000164,8,4,1,5,25208,4971,30179,1,1,1,23,0,0
8588037,"Rüti ZH, Bergacher",,0.000091,67,3,1,4,2143,2144,4287,4,0.4,0.520833,1832,0,0
8588039,"Rüti ZH, Gruebenplatz",,0.000088,67,1,1,2,2144,2143,4287,3,0.5,0.611111,1377,0,0
8588040,"Rüti ZH, Moosstrasse",,0.000086,67,1,1,2,2143,2144,4287,2,0.666667,0.75,920,0,0
8588041,"Rüti ZH, Pilgerhof",,0.000098,67,4,1,5,4704,4701,9405,13,0.159574,0.233836,1304,0,0
8588042,"Rüti ZH, Steinacher",,0.000084,67,1,1,2,2144,2144,4288,1,1,1,461,0,0
8588044,"Uetikon am See, Bergheim",,0.000018,84,1,1,2,6581,6581,13162,5,0.296296,0.383333,15,0,0
8588046,"Uetikon am See, Gemeindehaus",,0.000041,84,2,2,4,8716,8716,17432,3,0.5,0.611111,102,0,0
8588048,"Uetikon am See, Oergelacher",,0.000028,84,1,1,2,6581,6581,13162,2,0.666667,0.75,36,0,0
8588049,"Uetikon am See, Rundi",,0.000035,84,1,1,2,6581,6581,13162,1,1,1,19,0,0
8588052,"Uster, Gschwader",,0.000041,84,1,1,2,9137,9141,18278,6,0.28,0.385714,262.333333,0,0
8588053,"Uster, Haberweid",,0.000045,84,1,1,2,9141,9141,18282,5,0.333333,0.436111,150.333333,0,0
8588058,"Uster, Wageren",,0.000066,84,3,1,4,17822,1101,18923,1,1,1,27,0,0
8589963,"Frinvillier, bif. sur Bienne",,0.000048,87,3,3,6,5019,5018,10037,3,0.583333,0.690476,4384,0,0
8589966,"Romont BE, rte de Vauffelin",,0.000047,87,3,1,4,2409,2409,4818,3,0.5,0.611111,6,0,0
8588064,Gempenfluh,,0.000017,2,1,1,2,3044,3044,6088,12,0.136778,0.154751,0,0,0
8588943,St.Jakob,,0.000042,2,3,2,5,23563,23592,47155,11,0.178304,0.211802,1915.306683,0,0
8589372,Waldenburgerstrasse,,0.000051,2,2,2,4,11799,11799,23598,9,0.206612,0.271175,81.642857,0,0
8589381,Zoo Bachletten,,0.000087,2,4,6,10,24959,16811,41770,8,0.25,0.355709,1213.229067,0,0
8590413,"Niedergösgen, Kraftwerk",,0.000037,94,1,1,2,16362,13912,30274,2,0.666667,0.75,57.333333,0,0
8590716,"Maur, See",,0.000094,129,2,4,6,34620,34646,69266,11,0.198513,0.224763,6589.919318,0,0.1726
8591174,"Zürich, Haldenegg",,0.000062,85,4,6,10,182401,182367,364768,9,0.253039,0.292355,3340.509914,0.024647,0.242125
8591180,"Zürich, Hedwigsteig",,0.00006,85,1,3,4,54590,54570,109160,8,0.261261,0.295998,245.847836,0,0.26263
8588079,"Thörishaus Dorf, Bahnhof",,0.000035,126,1,1,2,353,5275,5628,8,0.222222,0.339732,224,0,0
8588080,"Thörishaus, Camping",,0.00004,126,1,1,2,5275,5275,10550,7,0.25,0.370408,203,0,0
8588081,"Neuenegg, Striten",,0.000045,126,1,1,2,5275,5275,10550,6,0.285714,0.408333,180,0,0
8588082,"Neuenegg, Flamingo",,0.000049,126,1,1,2,5275,5275,10550,5,0.333333,0.456667,155,0,0
8588083,"Neuenegg, Tennis",,0.000053,126,1,1,2,5275,5275,10550,4,0.4,0.520833,128,0,0
8588084,"Neuenegg, Dorfzentrum",,0.000056,126,1,1,2,5275,5275,10550,3,0.5,0.611111,99,0,0
8588086,"Neuenegg, Bahnhof",,0.000058,126,1,1,2,5275,5275,10550,2,0.666667,0.75,68,0,0
8588087,"Laupen BE, Schützenstrasse",,0.000043,126,1,1,2,3832,3833,7665,2,0.666667,0.75,78,0,0
8588088,"Gammen, Gammenrain",,0.000048,126,1,1,2,3833,3833,7666,1,1,1,40,0,0
8588095,"Gutenswil, Grossenacher",,0.000087,84,3,1,4,23258,23257,46515,2,0.666667,0.75,164,0,0
8588097,"Volketswil, Gries",,0.00003,84,1,1,2,26829,25574,52403,2,0.666667,0.75,212,0.000004,0
8588099,"Einigen, Chanderbrügg",,0.000041,43,1,1,2,3119,3119,6238,17,0.107914,0.163151,2539,0,0
8588100,"Einigen, Dorf",,0.000046,43,1,1,2,3119,3119,6238,16,0.116935,0.173584,2275,0,0
8588101,"Einigen, Teller",,0.00005,43,1,1,2,3119,3119,6238,15,0.127854,0.187047,2009,0,0
8588102,"Spiez, Ghei",,0.000053,43,1,1,2,3119,3119,6238,14,0.141361,0.205523,1741,0,0
8588103,"Spiez, Längmaad",,0.000056,43,1,1,2,3119,3119,6238,13,0.158537,0.233409,1471,0,0
8588707,"Wengi b. Frutigen, Schlundbach",,0.000072,43,3,1,4,3222,494,3716,2,0.666667,0.75,52.095798,0,0
8588901,"Davesco, Casteldavesco",,0.000035,102,1,1,2,2758,2758,5516,11,0.200351,0.230263,133,0,0
8588109,"Rothenthurm, Dorf",,0.00009,91,2,1,3,9481,9481,18962,3,0.5,0.611111,996,0,0
8588110,"Rothenthurm, Schoosstrasse",,0.000088,91,1,1,2,9481,9423,18904,2,0.666667,0.75,666,0,0
8588112,"Schwyz, Gartenlaubenstrasse",,0.000108,91,4,1,5,17108,17095,34203,7,0.25,0.314536,621,0,0
8588114,"Muotathal, Militärspital",,0.000082,91,2,1,3,11476,15569,27045,14,0.146341,0.194941,1227.5,0,0
8588116,"Steinen, Wyler",,0.000043,91,2,1,3,13801,13593,27394,12,0.183857,0.238077,477.733333,0,0
8588118,"Steinen, Oelberg",,0.000053,91,2,1,3,13429,13643,27072,12,0.19697,0.26389,1075.666667,0,0
8588120,"Schwyz, Grossfeld",,0.000023,91,1,1,2,5478,3783,9261,12,0.19171,0.255632,329,0,0
8588125,"Neuenegg, Louelemoos",,0.00006,126,1,1,2,5275,5275,10550,1,1,1,35,0,0
8588133,"Corzoneso Piano, Roccabella",,0.000055,108,1,1,2,4890,4890,9780,3,0.5,0.611111,39,0,0
8588134,"Acquarossa, Casa Anziani",,0.000058,108,1,1,2,4890,4890,9780,2,0.666667,0.75,28,0,0
8588142,"Wolhusen, Kreisel",,0.000054,92,1,1,2,2475,2475,4950,5,0.3,0.413889,1074,0,0
8588143,"Wolhusen, Berghofstrasse",,0.000057,92,1,1,2,2475,2475,4950,4,0.357143,0.466667,900,0,0
8588144,"Wolhusen, Bahnhof Weid",,0.000059,92,1,1,2,2475,2475,4950,3,0.444444,0.541667,724,0,0
8588145,"Wolhusen, Ankenberg",,0.000061,92,1,1,2,2475,2475,4950,2,0.6,0.666667,546,0,0
8588147,"Wolhusen, Spital",,0.000063,92,1,2,3,2475,1575,4050,1,1,1,366,0,0
8588803,"Ruswil, Rebstockstrasse",,0.000038,92,1,1,2,1150,425,1575,1,1,1,0,0,0
8588148,"Albinen, Tschäss",,0.000071,40,2,1,3,9439,5986,15425,4,0.4,0.520833,148,0,0
8588149,"Biel/Bienne, Magglingenbahn",,0.000039,87,2,2,4,29789,23049,52838,3,0.5,0.595238,8708,0,0
8592459,"Biel/Bienne, Beau-Rivage",,0.00004,87,1,1,2,16319,16319,32638,3,0.5,0.583333,8,0,0
8588153,La Râpe VD,,0.000058,13,2,1,3,773,773,1546,12,0.161905,0.238984,166.266667,0,0
8588155,"St-Sulpice VD, Chantres",,0.000037,5,1,1,2,49616,50287,99903,22,0.102537,0.116645,6858.5,0,0
8588156,"St-Sulpice VD, Laviau",,0.000043,5,1,1,2,50287,50287,100574,21,0.113854,0.131613,7080.5,0,0
8588157,"St-Sulpice VD, Bochet",,0.000047,5,1,1,2,50287,50287,100574,20,0.128032,0.15248,7300.5,0,0
8588846,"Villars-Ste-Croix, Croix Péage",,0.000038,5,3,3,6,58972,58979,117951,19,0.126869,0.158915,1409.75,0,0
8588848,"Villars-Ste-Croix, Le Sansy",,0.000029,5,1,1,2,14646,14646,29292,19,0.122449,0.147302,270,0,0
8588873,"Ecublens VD, Pontet",,0.00003,5,1,1,2,30110,30661,60771,19,0.122449,0.147302,1451.416667,0,0
8588168,"Thun, Allmendhof",,0.000041,43,1,2,3,2904,2904,5808,12,0.168,0.269958,711.65,0,0
8588166,"Thun, Reitweg/Expo",,0.00007,43,2,1,3,5780,5780,11560,14,0.150327,0.243267,2463.15,0,0
8588167,"Thun, Militärstrasse",,0.00007,43,1,2,3,5780,5780,11560,13,0.169231,0.30642,2224.15,0,0
8588478,"Thun, Kleine Allmend",,0.000076,43,1,4,5,8061,8061,16122,9,0.257143,0.443739,609.8,0,0
8591921,"Thun, Schönau",,0.000087,43,2,1,3,2906,2906,5812,1,1,1,7,0,0
8588475,"Oberstocken, Hofacker",,0.00009,43,3,2,5,1646,1077,2723,11,0.173611,0.267224,637.333333,0,0
8588172,"Thun, Hauptkaserne",,0.000077,43,2,1,3,8061,8061,16122,11,0.183486,0.260637,1101.8,0,0
8594920,"Achseten, Marchbach",,0.000053,43,1,1,2,11452,8007,19459,3,0.5,0.611111,114,0,0
8588177,"Sevelen, Bahnhof",,0.000037,73,1,1,2,1568,1568,3136,1,1,1,1956,0,0
8588187,"Susten, Abzw. St. Josef",,0.000117,40,6,2,8,11501,11507,23008,5,0.354839,0.457576,429.7,0,0
8588190,"Spiez, Parkplatz Regez",,0.000028,43,1,1,2,1493,1493,2986,1,1,1,117,0,0
8588193,Gryon Bois-Gentil,,0.000098,4,2,1,3,7559,7821,15380,1,1,1,153,0,0
8588194,"Bisisthal, Steinweid",,0.000062,91,1,1,2,1767,1767,3534,1,1,1,6,0,0
8589874,"Goldau, Kehlmattli",,0.000067,91,1,1,2,8989,7618,16607,1,1,1,304.5,0,0
8588195,"Troinex, ville",,0.000017,120,1,1,2,18865,18865,37730,13,0.118421,0.148401,906.355532,0,0
8588897,"Les Enfers, bif. Les Saignes",,0.000032,1,1,1,2,1187,1187,2374,1,1,1,0,0,0
8594495,"Muriaux, gare",,0.000055,1,1,1,2,359,242,601,1,1,1,30,0,0
8588209,"Bettlach, Post",,0.000065,127,4,4,8,42928,42928,85856,7,0.242857,0.321008,482.683333,0,0
8593637,Paysans-Horlog.,,0.000023,134,1,1,2,40415,44315,84730,13,0.153518,0.187384,2109.444444,0,0
8593702,Ptes Crosettes,,0.000107,134,2,1,3,21543,21543,43086,4,0.388889,0.464286,356,0,0
8588221,"Hinterforst, Oberrüti",,0.000072,73,2,1,3,7432,7347,14779,1,1,1,3,0,0
8591470,"Sennwald, Forstegg",,0.00021,73,4,2,6,20871,19903,40774,2,0.75,0.833333,1830.6,0,0
8588218,"Altstätten SG, Ruppendörfli",,0.000046,73,1,1,2,890,890,1780,3,0.5,0.611111,4653,0,0
8588223,"Kriessern, Gassermadstrasse",,0.000058,73,2,1,3,7104,7337,14441,9,0.159091,0.243736,6678,0,0
8588225,"Montlingen, Anger",,0.000061,73,1,1,2,7337,7337,14674,8,0.175676,0.25989,6214,0,0
8588226,"Montlingen, Hirschen",,0.000062,73,1,1,2,7337,7104,14441,7,0.196721,0.279563,5748,0,0
8588227,"Montlingen, Letzau",,0.000064,73,1,1,2,7104,7337,14441,6,0.22449,0.304545,5280,0,0
8588228,"Montlingen, Reitzentrum",,0.000065,73,1,1,2,7337,7337,14674,5,0.263158,0.338333,4810,0,0
8588229,"Montlingen, Tänneli",,0.000066,73,1,1,2,7337,7337,14674,4,0.321429,0.388889,4338,0,0
8588230,"Montlingen, Wiesenweg",,0.000067,73,1,1,2,7337,7104,14441,3,0.421053,0.479167,3864,0,0
8588231,"Oberriet SG, Finkenweg",,0.000068,73,1,3,4,7104,7104,14208,2,0.636364,0.714286,3388,0,0
8588234,"Oberriet SG, Mettlen",,0.000037,73,1,1,2,3551,3551,7102,4,0.416667,0.516667,5,0,0
8595377,"Oberriet SG, Kobelwies",,0.000037,73,1,1,2,3551,3551,7102,2,0.666667,0.75,3,0,0
8595378,"Oberriet SG, Loogarten",,0.000037,73,1,1,2,3550,3550,7100,2,0.666667,0.75,3,0,0
8588232,"Oberriet SG, Franziskusstrasse",,0.00003,73,1,1,2,3332,3551,6883,5,0.333333,0.436111,485,0,0
8588235,"Sennwald, Kirche",,0.000033,73,1,1,2,16623,16142,32765,5,0.310345,0.383333,16819.104762,0,0
8588236,"Rothenthurm, Erste Altmatt",,0.000085,91,1,1,2,9423,6581,16004,1,1,1,334,0,0
8588238,"Schwyz, Sonnenplätzli",,0.00008,91,1,1,2,15569,14804,30373,13,0.166667,0.224342,957.5,0,0
8588962,"Abtwil SG, Hüslenweg",,0.000031,71,1,2,3,25545,25545,51090,12,0.180539,0.215809,228.857143,0,0
8589890,"St. Gallen, Im Feld",,0.000062,71,3,3,6,15886,15920,31806,9,0.264957,0.368676,2342.351299,0,0
8589908,"Abtwil SG, St. Josefen",,0.000114,71,5,3,8,61413,51662,113075,9,0.255556,0.375897,9296.85641,0,0
8590325,"Herisau, Kreuzweg",,0.000174,71,1,1,2,16898,8004,24902,9,0.232558,0.307282,180,0,0
8588243,"Herisau, Landersberg",,0.000058,71,2,1,3,9646,535,10181,4,0.4,0.520833,8.666667,0,0
8590326,"Herisau, Wiesental",,0.000223,71,4,3,7,86008,78557,164565,8,0.287879,0.416729,15923.6,0,0
8588242,"Boudry, Buchilles",,0.00006,105,1,1,2,10238,10238,20476,1,1,1,808,0,0
8588253,Konolfingen Bahnhof,,0.000037,100,2,2,4,7469,7562,15031,14,0.157534,0.280107,12415,0,0
8588257,Tägertschi Dorf,,0.000039,100,1,2,3,7470,7341,14811,11,0.19802,0.314387,1300,0,0
8588704,Belp Fahrhubelweg,,0.000072,100,1,2,3,5406,5149,10555,3,0.5,0.595238,1261,0,0
8588254,Konolfingen Haldenweg,,0.000027,100,1,1,2,7434,7462,14896,13,0.152778,0.223087,3756,0,0
8588255,Konolfingen Ursellen,,0.000034,100,1,1,2,7462,7470,14932,12,0.172131,0.25346,2529,0,0
8588259,Rubigen Dorfmatte,,0.000052,100,3,1,4,5406,5406,10812,9,0.176471,0.237919,5035,0,0
8588260,Rubigen Hunzigenbrügg,,0.000055,100,1,1,2,5406,5406,10812,8,0.202381,0.262395,3800,0,0
8588261,Belp Lehn,,0.000058,100,1,1,2,5406,5406,10812,7,0.238806,0.298512,2563,0,0
8588267,Belp Schützen,,0.00005,100,3,2,5,14800,14675,29475,5,0.317073,0.415385,8734,0,0
8588275,Belp Zelgweg,,0.000048,100,1,2,3,14419,14419,28838,4,0.428571,0.527778,27,0,0
8588706,Konolfingen Grünegg,,0.000074,100,1,3,4,7438,5258,12696,2,0.714286,0.8,4959.5,0,0
8588269,Belp Neumatt,,0.000032,100,1,1,2,14419,14419,28838,7,0.222222,0.298016,3774,0,0
8588270,Belp Muristrasse Süd,,0.000038,100,1,1,2,14419,14417,28836,6,0.261905,0.334848,2527,0,0
8588273,Belp Giessenbad,,0.000043,100,1,1,2,14417,14419,28836,5,0.322581,0.395,1278,0,0
8588282,"Susten, Schule",,0.000016,40,1,1,2,4447,4447,8894,1,1,1,19,0,0
8588291,"Lugano, Corso Elvezia",,0.000022,102,1,1,2,24460,24460,48920,10,0.211765,0.242359,90.633333,0,0
8591591,"Cassarate, Scuole",,0.000035,102,1,1,2,52747,52747,105494,10,0.211765,0.242359,212,0,0
8591597,"Castagnola, Villa Favorita",,0.000045,102,1,1,2,36124,36124,72248,10,0.211765,0.242359,180,0,0
8588294,"Sierre, Borzuat",,0.000044,39,2,2,4,24622,24622,49244,7,0.247191,0.327381,1659.5,0,0
8594604,"Sierre, Stand",,0.00003,39,1,1,2,8452,8452,16904,7,0.238636,0.295351,0,0,0
8588296,"Albinen, Schwelli",,0.000071,40,1,1,2,5986,5986,11972,3,0.5,0.611111,114,0,0
8588297,"Albinen, Dorben",,0.000071,40,1,1,2,5986,5986,11972,2,0.666667,0.75,78,0,0
8588298,Chavannes-des-Bois,,0.000061,120,3,3,6,19102,19108,38210,18,0.090299,0.115283,8074,0,0
8588663,"Crans VD, village",,0.00006,125,1,2,3,15294,15295,30589,7,0.231481,0.311429,196.333333,0,0
8592648,"Bellevue GE, Planet",,0.000043,120,2,2,4,14015,14015,28030,16,0.156737,0.185848,960.87494,0,0
8588299,"La Tzoumaz, Domus",,0.000059,122,1,1,2,1524,1524,3048,6,0.28,0.385714,63,0,0
8588300,"La Tzoumaz, Larzine",,0.000061,122,1,1,2,1524,1524,3048,5,0.333333,0.436111,60,0,0
8588301,"La Tzoumaz, Les Crus",,0.000063,122,1,1,2,1524,1524,3048,4,0.416667,0.516667,55,0,0
8588302,"La Tzoumaz, Place de l'Ours",,0.000064,122,1,2,3,1524,1524,3048,3,0.571429,0.708333,48,0,0
8588303,"Isérables, église",,0.000038,122,1,1,2,1214,1333,2547,3,0.5,0.611111,0,0,0
8588304,"Isérables, parc",,0.000071,122,2,1,3,1643,1524,3167,2,0.666667,0.75,28,0,0
8588305,"Isérables, Les Chenevieres",,0.000071,122,1,1,2,1524,1524,3048,1,1,1,15,0,0
8588306,"Kirchberg BE, Rosenweg",,0.000034,45,1,1,2,15269,15269,30538,4,0.428571,0.513889,378,0,0
8588307,"Ersigen, Oberdorf",,0.00004,45,1,3,4,15269,12154,27423,3,0.625,0.766667,320,0,0
8589489,"Alchenstorf, Wil",,0.000036,45,1,2,3,6487,6487,12974,1,1,1,4,0,0
8591684,"Burgdorf, Willestrasse",,0.000037,45,2,1,3,8088,4057,12145,1,1,1,0,0,0
8588308,"Richterswil, Schwyzerstrasse",,0.000138,113,2,2,4,34816,34829,69645,2,0.75,0.833333,243,0,0
8592698,"Chêne-Bougeries, Parc Stagni",,0.000046,120,2,2,4,13443,13546,26989,20,0.129972,0.15151,1308.165626,0,0
8592700,"Chêne-Bougeries, Seymaz",,0.000084,120,4,4,8,100425,100425,200850,20,0.133681,0.159218,4014.400661,0,0
8592701,"Chêne-Bougeries, Vallon",,0.000068,120,4,1,5,97611,97711,195322,19,0.147477,0.175647,4829.014915,0,0
8592707,"Chêne-Bourg, De Haller",,0.000035,132,2,1,3,32436,32424,64860,22,0.115473,0.134033,76.984153,0,0
8592733,"Vésenaz, église",,0.000058,120,2,2,4,19315,19314,38629,24,0.110961,0.133825,3308.255001,0,0
8592960,"Jussy, Centre Horticole",,0.000056,132,3,3,6,23714,23822,47536,16,0.106308,0.165185,3536.373077,0,0
8592961,"Jussy, Châtaignières",,0.000026,132,1,1,2,12938,12937,25875,18,0.087081,0.114618,91,0,0
8593086,"Puplinge, Les Petoux",,0.000093,132,1,3,4,37095,37093,74188,12,0.161616,0.239214,1103.005959,0,0
8593112,"Thônex, Graveson",,0.000104,132,4,2,6,113129,113132,226261,8,0.225806,0.323186,2422.107461,0,0
8588314,"Dietlikon, Bahnhof",,0.000012,129,1,3,4,19867,25988,45855,20,0.094395,0.109187,16,0,0
8590538,"Dietlikon, Aegert",,0.000014,129,1,1,2,19868,19868,39736,21,0.086127,0.09525,0,0,0
8590541,"Dietlikon, Dornenstrasse",,0.000027,129,2,2,4,25754,25754,51508,20,0.094033,0.106314,448,0,0
8590542,"Dietlikon, Dübendorferstrasse",,0.000022,129,1,1,2,19868,19330,39198,20,0.093842,0.104305,0,0,0
8588318,"Brüttisellen, Obere Wangenstr.",,0.00004,107,2,1,3,66522,64127,130649,16,0.118362,0.131472,15782.259422,0.005807,0
8590503,"Bassersdorf, Chlupfgasse",,0.00007,107,3,2,5,36474,36503,72977,15,0.09833,0.109533,7702.790164,0.000082,0.002245
8590508,"Brüttisellen, Haldenbrücke",,0.00002,107,1,1,2,14799,14795,29594,15,0.098303,0.108163,365,0,0.00217
8588320,"Suberg-Grossaffoltern, Bahnhof",,0.000051,87,1,1,2,82,82,164,10,0.191489,0.259546,1250,0,0
8588322,"Leukerbad, Lochwald",,0.000071,40,1,1,2,5986,5986,11972,1,1,1,40,0,0
8588336,"Wollerau, Verenahof",,0.00007,113,1,1,2,18175,18175,36350,1,1,1,82,0,0
8588859,"Fribourg, Châtelet",,0.000151,126,3,5,8,69281,75018,144299,8,0.243986,0.313464,4671.098842,0,0
8589129,"Villars-sur-Glâne, Martinets",,0.000067,126,2,3,5,29045,29165,58210,8,0.242063,0.300215,17867.775211,0,0
8588342,"Matran, village",,0.000025,126,1,1,2,17825,17825,35650,9,0.159176,0.181629,887,0,0
8588345,"Matran, Rte de la Tire",,0.000041,126,1,1,2,17825,17825,35650,11,0.149897,0.178017,10745.136219,0,0
8588346,"Avry-sur-Matran, école",,0.000045,126,1,1,2,17825,17825,35650,10,0.173913,0.210505,8974.136219,0,0
8588833,"Lentigny, Treysalles",,0.000114,126,4,2,6,7290,6704,13994,9,0.193038,0.238863,3017.217716,0,0
8589130,"Villars-sur-Glâne, Méridienne",,0.000032,126,1,2,3,55456,55456,110912,8,0.223048,0.266607,937.018728,0,0
8588391,"Langnau i.E., Gerbeplatz",,0.000078,123,2,1,3,8294,8189,16483,13,0.156,0.20177,349.833333,0,0
8588631,"Langnau i.E., Berufsschule",,0.000112,123,6,3,9,15722,15832,31554,5,0.358491,0.455263,921.25,0,0
8588926,"Langnau i.E., Kreuzstrasse",,0.000064,123,1,1,2,6059,6059,12118,5,0.333333,0.411111,18,0,0
8588355,"Langnau i.E., Sonnegg",,0.000042,123,2,1,3,2818,2818,5636,9,0.177914,0.230036,177.166667,0,0
8588356,"Langnau i.E., Sonnenfeld",,0.000047,123,1,2,3,2818,2818,5636,8,0.208955,0.281378,154.166667,0,0
8588385,"Langnau i.E., Marktstrasse",,0.000063,123,3,3,6,7464,7400,14864,6,0.285714,0.376923,545.75,0,0
8588395,"Bärau, Sonne",,0.000098,123,1,4,5,17654,17654,35308,10,0.255474,0.364161,973.75,0,0
8588405,"Trub, Löwenplatz",,0.000056,123,2,3,5,12919,12919,25838,7,0.278351,0.370106,514,0,0
8588406,"Trub, Mülihof",,0.000027,123,1,3,4,9492,9493,18985,6,0.288889,0.378846,378,0,0
8588412,"Fankhaus (Trub), Gärstengraben",,0.000049,123,1,2,3,6177,6177,12354,6,0.289855,0.37,100,0,0
8588361,"Schüpbach, Furen",,0.000029,123,1,1,2,950,950,1900,15,0.133858,0.229504,613,0,0
8588365,"Signau, Hof",,0.000072,123,1,2,3,12576,11756,24332,12,0.164557,0.315632,125,0,0
8588364,"Signau, Friedhof",,0.000072,123,3,1,4,12709,12576,25285,13,0.150538,0.262867,168,0,0
8588366,"Aeschau, Säge",,0.000073,123,2,1,3,11900,12033,23933,12,0.153846,0.258601,564,0,0
8588367,"Aeschau, Gärtnerei",,0.000103,123,2,1,3,12125,12098,24223,11,0.166667,0.274534,649,0,0
8588368,"Aeschau, Horben Schulhaus",,0.000099,123,1,1,2,12098,12098,24196,10,0.181818,0.292897,600,0,0
8588369,"Eggiwil, Zimmertsei",,0.000095,123,1,1,2,12098,12098,24196,9,0.2,0.31433,549,0,0
8588370,"Eggiwil, Skilift",,0.000092,123,1,1,2,12098,12098,24196,8,0.222222,0.339732,496,0,0
8588371,"Eggiwil, Buchschachen",,0.000089,123,1,1,2,12098,12098,24196,7,0.25,0.370408,441,0,0
8588372,"Eggiwil, Schwelli",,0.000086,123,1,1,2,12098,11928,24026,6,0.285714,0.408333,384,0,0
8588373,"Eggiwil, Leimen",,0.000084,123,1,1,2,11928,11928,23856,5,0.333333,0.456667,325,0,0
8588374,"Eggiwil, obere Zilmatt",,0.000083,123,1,1,2,11928,11928,23856,4,0.4,0.520833,264,0,0
8588375,"Eggiwil, Brambach",,0.000081,123,1,1,2,11928,11928,23856,3,0.5,0.611111,201,0,0
8588376,"Röthenbach i.E., Fischbachbrü",,0.00008,123,1,1,2,11928,11928,23856,2,0.666667,0.75,136,0,0
8588377,"Röthenbach i.E., Fambach Gara",,0.000079,123,1,1,2,11928,11928,23856,1,1,1,69,0,0
8588386,"Oberfrittenbach, Badmätteli",,0.000049,123,2,1,3,2805,2818,5623,5,0.333333,0.456667,285,0,0
8588387,"Oberfrittenbach, Stockmatte",,0.000052,123,1,1,2,2818,2818,5636,4,0.4,0.520833,232,0,0
8588388,"Oberfrittenbach, Buuchi",,0.000055,123,1,1,2,2818,2818,5636,3,0.5,0.611111,177,0,0
8588389,"Oberfrittenbach, Im Bach",,0.000058,123,1,1,2,2818,2818,5636,2,0.666667,0.75,120,0,0
8588390,"Oberfrittenbach, Deckhus",,0.00006,123,1,1,2,2818,2818,5636,1,1,1,61,0,0
8588392,"Langnau i.E., Sonnweg",,0.000105,123,3,2,5,17619,17654,35273,12,0.180095,0.242252,1030.75,0,0
8588393,"Langnau i.E., Hinterdorf Mühle",,0.000056,123,1,1,2,9426,9426,18852,12,0.17619,0.221773,0,0,0
8588394,"Bärau, Bäraugrund",,0.000103,123,2,1,3,17654,17654,35308,11,0.208092,0.267285,994.75,0,0
8588398,"Gohl, Schulhaus",,0.000043,123,1,1,2,3194,3194,6388,1,1,1,2,0,0
8593270,"Langnau i.E., Ilfis Center",,0.000112,123,2,2,4,15833,11233,27066,1,1,1,42.25,0,0
8588396,"Gohl, Grindlenbach",,0.000032,123,1,1,2,3194,3194,6388,3,0.5,0.611111,116,0,0
8588397,"Gohl, Matten",,0.000038,123,1,1,2,3194,3194,6388,2,0.666667,0.75,60,0,0
8588400,"Trubschachen, Bahnhofstrasse",,0.000032,123,1,1,2,13082,12891,25973,9,0.194969,0.245635,638,0,0
8588401,"Trub, Miescheli",,0.000038,123,1,2,3,12891,12929,25820,8,0.234375,0.309563,610,0,0
8588404,"Trub, Sägegasse",,0.000034,123,1,1,2,3315,3315,6630,8,0.224,0.278104,28,0,0
8588403,"Trub, Grundsäge",,0.000027,123,1,1,2,3325,3315,6640,9,0.188312,0.23384,60,0,0
8588407,"Trub, Furenbrücke",,0.000018,123,1,1,2,6177,6177,12354,11,0.13587,0.188749,320,0,0
8588408,"Trub, Hüseren",,0.000027,123,1,1,2,6177,6177,12354,10,0.150943,0.20291,280,0,0
8588409,"Trub, Loos",,0.000033,123,1,1,2,6177,6177,12354,9,0.17037,0.221567,238,0,0
8588410,"Trub, Mülebachbrücke",,0.000039,123,1,1,2,6177,6177,12354,8,0.196429,0.247835,194,0,0
8588411,"Fankhaus (Trub), Schnidershus",,0.000044,123,1,1,2,6177,6177,12354,7,0.233333,0.289002,148,0,0
8588413,"Brienz BE, Stegmatte",,0.000061,114,1,1,2,975,975,1950,2,0.666667,0.75,170,0,0
8588414,"Brienzerberg, Flielti",,0.000063,114,1,1,2,975,975,1950,1,1,1,86,0,0
8588422,"Achseten, Bönigen",,0.00004,43,2,1,3,11654,11452,23106,6,0.285714,0.408333,264,0,0
8588423,"Frutigen, Innerbräschgen",,0.000045,43,1,1,2,11452,11452,22904,5,0.333333,0.456667,216,0,0
8588424,"Frutigen, Ausser Rohrbach",,0.000049,43,1,1,2,11452,11452,22904,4,0.4,0.520833,166,0,0
8588427,"Aarau, Sonnmattweg",,0.000055,57,1,1,2,11849,11849,23698,12,0.171123,0.226564,299.153846,0,0
8590289,"Suhr, Waldhofweg",,0.000094,57,2,2,4,17068,17068,34136,3,0.5,0.611111,383.846154,0,0
8588430,"Uetikon am See, Tramstrasse",,0.000065,8,2,1,3,7109,7115,14224,2,0.666667,0.75,102,0,0
8588435,"Pully, Chenaulaz",,0.000035,10,2,1,3,34002,34342,68344,21,0.099649,0.121441,1848.676382,0,0
8588438,"Lutry, Echerins",,0.000033,10,2,3,5,34728,34729,69457,20,0.102977,0.127317,6723.323618,0,0
8588439,"Pully, port",,0.000032,10,2,1,3,34340,71243,105583,19,0.110653,0.131036,2789.499808,0,0
8588440,"Pully, Somais",,0.000038,10,1,1,2,71243,71235,142478,18,0.124034,0.152117,2774.499808,0,0
8588441,"Pully, Châtaignier",,0.000043,10,1,2,3,71235,71242,142477,17,0.141156,0.184663,2757.499808,0,0
8592171,"Pully, Bruyère",,0.000021,10,1,1,2,23632,23632,47264,7,0.230769,0.328836,0,0,0
8588447,"Pully, Rochettaz",,0.000021,10,1,1,2,34341,34342,68683,10,0.181818,0.292897,2446.8,0,0
8588448,"Pully, Boverattes",,0.000029,10,1,1,2,34342,34342,68684,9,0.2,0.31433,2102.8,0,0
8588449,"Pully, Vallon",,0.000035,10,1,1,2,34342,34343,68685,8,0.222222,0.339732,1756.8,0,0
8588450,"Pully, Pré Pariset",,0.000041,10,1,1,2,34343,16551,50894,7,0.25,0.370408,1408.8,0,0
8588451,"Lutry, Sapelle",,0.000046,10,1,1,2,16551,16551,33102,6,0.285714,0.408333,1058.8,0,0
8588452,"Lutry, Jordillon",,0.00005,10,1,1,2,16551,16550,33101,5,0.333333,0.456667,706.8,0,0
8588454,"Grandvaux, Pra Grana",,0.000132,10,3,1,4,19754,2033,21787,3,0.5,0.611111,2010,0,0
8588464,"Grenchen, Schwimmbad",,0.000056,127,2,1,3,16598,16598,33196,10,0.15625,0.194295,225,0,0
8588465,"Grenchen, Flughafen",,0.000059,127,1,2,3,16598,16598,33196,9,0.18107,0.233261,248,0,0
8588472,"Büren an der Aare, Aarbergstr.",,0.000046,127,1,1,2,5822,5822,11644,9,0.172996,0.205614,82,0,0
8588469,"Nürensdorf, Lindauerstrasse",,0.000041,84,3,1,4,8811,8811,17622,2,0.6,0.666667,99.333333,0,0
8588470,"Büren an der Aare,Solothurnstr",,0.000036,127,1,1,2,5822,5822,11644,11,0.13354,0.165652,46,0,0
8588471,"Büren an der Aare, Städtli",,0.000041,127,1,1,2,5822,5822,11644,10,0.150538,0.182379,65,0,0
8589515,"Turtmann, Abzw. Bahnhof",,0.000136,40,6,2,8,8357,5287,13644,3,0.571429,0.708333,156.25,0,0
8594333,"Turtmann, Bini",,0.000068,40,1,1,2,3949,696,4645,3,0.5,0.611111,0,0,0
8588480,"Thun, Rösslimatte",,0.000031,43,1,1,2,1290,1290,2580,3,0.5,0.611111,51,0,0
8588476,"Thun, Dufourkaserne",,0.000077,43,1,1,2,8061,8061,16122,10,0.213483,0.313513,856.8,0,0
8588477,"Thun, Eigerplatz",,0.000091,43,3,1,4,5994,5994,11988,10,0.181034,0.246126,1376.5,0,0
8591911,"Thun, Feldheimstrasse",,0.000057,43,2,2,4,2906,2906,5812,2,0.625,0.7,1015.5,0,0
8589068,"Steffisburg, Schule Bernstr.",,0.000079,43,2,3,5,5695,5546,11241,7,0.292683,0.466071,3748.2,0,0
8594301,"Blumenstein, Gemeindehaus",,0.000074,43,3,2,5,1168,1168,2336,8,0.229167,0.373701,579.7,0,0
8588479,"Thun, Länggasse",,0.000088,43,1,1,2,5994,5994,11988,9,0.210526,0.288532,1093.5,0,0
8588483,"Wachseldorn, Feuerwehrmagazin",,0.000131,43,3,2,5,810,810,1620,9,0.225352,0.348165,1996.216667,0,0
8588580,"Steffisburg, Zulgbrücke",,0.000053,43,1,1,2,5855,5695,11550,9,0.222222,0.316915,3167.983333,0,0
8588581,"Steffisburg, Alte Bernstrasse",,0.000111,43,2,3,5,5725,5725,11450,8,0.267857,0.429603,4632.533333,0,0
8588763,Engehollenweg,,0.000041,2,1,2,3,3247,3247,6494,11,0.182203,0.211478,200.054762,0,0
8588772,Johanniterbrücke,,0.000056,2,3,2,5,18034,18033,36067,11,0.183631,0.213377,503.823488,0,0
8589296,Birmannsgasse,,0.000029,2,2,2,4,12582,12581,25163,10,0.190923,0.222047,168.310174,0,0
8588495,"Gossau SG, Herisauerstrasse",,0.000109,71,6,2,8,62153,61715,123868,15,0.130337,0.160078,8553.284998,0,0
8588501,"St. Gallen Bruggen, Erlachstr.",,0.000088,71,5,5,10,130178,130178,260356,12,0.188769,0.241665,10128.272491,0,0
8589552,"St. Gallen, Altenwegen",,0.000096,71,5,5,10,82351,82328,164679,11,0.214397,0.274554,15180.077859,0,0
8589537,"Gossau SG, Migros BZ",,0.000032,71,1,2,3,39527,39527,79054,12,0.17673,0.218083,346,0,0
8589534,"Gossau SG, Schlachthofstrasse",,0.000033,71,1,2,3,48136,48136,96272,14,0.134361,0.165177,1362,0,0
8589642,"St. Gallen, Waldau",,0.000118,71,4,4,8,82516,82451,164967,10,0.238636,0.338445,4104.873657,0,0
8589644,"St. Gallen, Westcenter",,0.000036,71,1,2,3,40269,40347,80616,11,0.2,0.279821,313.5,0,0
8589646,"St. Gallen, Winkeln",,0.000041,71,2,3,5,47995,33804,81799,10,0.230769,0.326924,382.795238,0,0
8589648,"St. Gallen, Wolfganghof",,0.000055,71,2,2,4,41692,41680,83372,12,0.179612,0.253862,350.286328,0,0
8589649,"St. Gallen, Zil",,0.00007,71,3,1,4,26700,38719,65419,15,0.117904,0.183952,70.911111,0,0
8588503,"Zwieselberg, Hani",,0.000105,43,2,1,3,1380,630,2010,1,1,1,305,0,0
8594606,"Sierre, Liddes",,0.000034,39,1,1,2,16534,16534,33068,11,0.163793,0.245616,396.5,0,0
8588517,"Bramois, Clodevis",,0.000031,39,1,2,3,4158,4158,8316,11,0.192308,0.300637,831.666667,0,0
8588518,"Bramois, Institut",,0.000024,39,1,1,2,2891,2891,5782,11,0.184466,0.263828,0,0,0
8588519,"Bramois, Cassières",,0.000108,39,3,2,5,10927,10927,21854,10,0.214286,0.326609,1966.5,0,0
8588520,"Bramois, La Borgne",,0.000057,39,1,1,2,6769,6769,13538,10,0.204819,0.286998,0,0,0
8588521,"Bramois, Paradis",,0.000105,39,2,2,4,10927,10927,21854,9,0.242424,0.361186,1290.5,0,0
8588601,"Sorens, Foyer",,0.000057,13,1,1,2,6179,6179,12358,6,0.3,0.392593,36,0,0
8593288,"La Tour-de-Trême, St-Michel",,0.000059,13,2,2,4,29605,29138,58743,6,0.325,0.432051,2712,0,0
8588536,"Walenstadt, Zollacher",,0.000047,124,1,1,2,6590,6614,13204,6,0.266667,0.3625,116,0,0
8588537,"Walenstadt, Stutz",,0.000051,124,1,1,2,6614,6614,13228,5,0.318182,0.409524,108,0,0
8588538,"Tscherlach, Dorf",,0.000054,124,1,1,2,6614,6795,13409,4,0.4,0.486111,98,0,0
8588551,Seftau,,0.000036,44,1,2,3,4136,4197,8333,7,0.292683,0.41746,14268,0,0
8589022,Kalchacker,,0.000044,44,1,2,3,4136,4136,8272,6,0.333333,0.49375,24,0,0
8590918,"Winterthur, Autobahn",,0.000055,68,1,1,2,12999,12995,25994,6,0.285714,0.39375,0,0,0
8588740,"Kloten, Neubrunnenstrasse",,0.000036,107,1,1,2,13629,13632,27261,1,1,1,1,0,0.000079
8588738,"Kloten, Härdlen",,0.000097,107,2,1,3,16137,1367,17504,2,0.666667,0.75,6.8,0,0.000081
8590698,"Kloten, Schulstrasse",,0.000048,107,1,1,2,15222,15217,30439,2,0.666667,0.75,6,0,0.000081
8588554,"Schwanden GL, Hauptstrasse",,0.000095,128,3,2,5,7745,7661,15406,6,0.3125,0.448333,1400,0,0
8588555,"Schwanden GL, Spittel",,0.000051,128,1,1,2,2242,2256,4498,5,0.315789,0.422222,846,0,0
8588556,"Haslen GL, Hinterhaslen",,0.000054,128,1,1,2,2256,2256,4512,4,0.384615,0.483333,710,0,0
8588557,"Haslen GL, Zünli",,0.000057,128,1,1,2,2256,2256,4512,3,0.5,0.583333,572,0,0
8588558,"Leuggelbach, Abzweigung Haslen",,0.000059,128,1,2,3,2256,2256,4512,2,0.75,0.833333,432,0,0
8590016,Beaumont,,0.00005,44,3,3,6,21738,21709,43447,9,0.201923,0.331784,3195.333333,0,0
8590021,Viktoriaplatz,,0.000103,44,4,2,6,42858,39724,82582,7,0.257143,0.359392,8398.580952,0,0
8588564,"Kiesen, Dorf",,0.000057,100,1,1,2,2555,2575,5130,1,1,1,44,0,0
8593515,Attinghausen Plätzli,,0.000076,93,1,1,2,6564,1440,8004,1,1,1,8.983333,0,0
8588578,"Steffisburg, Schwäbis",,0.000045,43,2,1,3,5695,5855,11550,11,0.168224,0.240522,3747.983333,0,0
8588579,"Steffisburg, Sonnenfeld",,0.000049,43,1,1,2,5855,5855,11710,10,0.191011,0.269024,3458.983333,0,0
8589067,"Steffisburg, Burgergut",,0.000042,43,1,1,2,2846,2846,5692,8,0.240741,0.34185,0,0,0
8588583,Altdorf Steinmattstrasse,,0.000081,93,4,1,5,17151,17287,34438,3,0.5,0.583333,387.559524,0,0
8593572,Denis-de-Rougemont,,0.000038,48,2,1,3,21340,21141,42481,21,0.094488,0.162078,578.533333,0,0
8593575,Porte-des-Acacias,,0.000035,48,1,1,2,24544,28970,53514,21,0.094488,0.162078,10.666667,0,0
8588597,"Sorens, Malessert scierie",,0.000039,13,1,2,3,6179,6179,12358,9,0.203125,0.33373,2556,0,0
8588598,"Sorens, Camping",,0.000028,13,1,1,2,5896,5896,11792,9,0.190476,0.278208,0,0,0
8588599,"Sorens, Vers-les-Masson",,0.000051,13,2,1,3,6179,6179,12358,8,0.215686,0.303139,1300,0,0
8588600,"Sorens, La Croix",,0.000054,13,1,1,2,6179,6179,12358,7,0.25,0.337619,669,0,0
8588819,"Villaz-St-Pierre, Battiaz",,0.000079,13,2,1,3,6839,6245,13084,11,0.145098,0.168126,93.958333,0,0
8588824,"Rossens FR, In-Riaux",,0.000111,126,2,1,3,15924,16036,31960,10,0.167431,0.193928,73,0,0
8588604,"Cormérod, Partiers",,0.000028,126,2,1,3,6982,6968,13950,5,0.346154,0.42037,1829,0,0
8588606,"Faulensee, Dorf",,0.000085,43,1,1,2,6246,6246,12492,8,0.225,0.329762,445,0,0
8588610,"Spiez, Bürgstrasse",,0.000109,43,3,1,4,7882,7882,15764,6,0.304348,0.421429,978,0,0
8588619,"Faulensee, Am See",,0.000055,43,1,1,2,6246,6246,12492,4,0.4,0.520833,632,0,0
8594772,"Bussnang, Gemeindehaus",,0.000061,20,2,1,3,2147,1923,4070,1,1,1,152.666667,0,0
8588627,"Alchenstorf, Dorf",,0.000022,45,1,1,2,6487,6487,12974,3,0.444444,0.541667,130,0,0
8588628,"Dürrenroth, Dorf",,0.000039,45,1,1,2,8825,8825,17650,8,0.222222,0.339732,205,0,0
8588630,"Häusernmoos, Dorf",,0.000064,45,2,1,3,9206,8825,18031,6,0.285714,0.408333,360,0,0
8588633,"Neumühle, Dorf",,0.000043,123,1,2,3,9750,9750,19500,6,0.3,0.457407,450,0,0
8588635,"Ranflüh, Ranflühmatte",,0.000036,123,1,1,2,9017,9017,18034,6,0.259259,0.37381,7,0,0
8588634,"Ranflüh, Oberdorf",,0.000029,123,1,1,2,9389,9017,18406,7,0.228571,0.341964,76,0,0
8588636,"Ranflüh, Ranflühschachen",,0.000059,123,2,1,3,9378,9447,18825,5,0.3,0.413889,243,0,0
8588637,Schweinbrunnen,,0.000065,45,1,1,2,8825,8825,17650,5,0.333333,0.456667,305,0,0
8588641,"Zollbrück, Bahnhof",,0.000061,123,1,1,2,9447,9455,18902,4,0.357143,0.466667,170,0,0
8588642,"Zollbrück, Frittenbachstrasse",,0.000063,123,1,1,2,9455,9750,19205,3,0.444444,0.541667,95,0,0
8588643,"Zollbrück, Zentrum",,0.000064,123,1,1,2,9750,9750,19500,2,0.6,0.666667,18,0,0
8588932,"Langnau i.E., Bärenplatz",,0.00011,123,2,2,4,12150,9123,21273,2,0.75,0.833333,193.25,0,0
8588645,"Grenchen, Bucheggstrasse",,0.000069,127,5,1,6,11749,11837,23586,14,0.128617,0.19299,27799.8,0,0
8588648,"Härkingen, Pfannenstiel",,0.000049,94,2,1,3,14426,14426,28852,14,0.132231,0.200386,147,0,0
8588651,"Schönenwerd SO, Tannheim",,0.000061,94,2,2,4,27841,27841,55682,14,0.153153,0.299112,2170.333333,0,0
8588653,Silenen Dörfli,,0.000051,93,1,1,2,22368,22368,44736,3,0.5,0.566667,196,0,0
8588655,"Tannay, village",,0.000028,120,1,1,2,4700,4700,9400,1,1,1,56,0,0
8588656,"Nyon, plage",,0.000035,125,3,1,4,29296,29297,58593,13,0.135458,0.180533,161,0,0
8588658,"Nyon, Conservatoire",,0.000041,125,1,1,2,29297,29297,58594,12,0.152074,0.200014,161,0,0
8588659,"Nyon, route de Genève",,0.000046,125,1,1,2,29297,29296,58593,11,0.173913,0.229503,159,0,0
8588661,"Crans VD, Port",,0.000055,125,3,1,4,15295,15295,30590,9,0.167702,0.217402,220.333333,0,0
8588662,"Crans VD, La Versoix",,0.000058,125,1,1,2,15295,15294,30589,8,0.19403,0.249634,209.333333,0,0
8588669,"Coppet, route du Jura",,0.000042,125,1,1,2,15204,15018,30222,7,0.231884,0.301637,441,0,0
8588664,"Céligny, village",,0.000054,125,2,1,3,15287,15286,30573,12,0.134078,0.195112,813,0,0
8588665,"Céligny, gare",,0.000056,125,1,1,2,15286,15287,30573,11,0.148387,0.212389,771,0,0
8588666,"Founex, est",,0.000059,125,1,1,2,15287,15286,30573,10,0.166667,0.238546,727,0,0
8588668,"Founex, ouest",,0.000037,125,1,1,2,15184,15204,30388,8,0.197674,0.262535,494,0,0
8588676,"Prangins, temple",,0.000027,125,1,1,2,13932,13932,27864,6,0.254545,0.325,35,0,0
8588677,"Prangins, Vieux Pressoir",,0.00003,125,2,2,4,13579,13669,27248,6,0.297872,0.405952,264,0,0
8588679,"Prangins, La Tuilière",,0.000031,125,1,1,2,13490,13490,26980,8,0.2,0.28502,7,0,0
8588678,"Prangins, Sus-Gare",,0.000046,125,2,2,4,27511,27511,55022,5,0.317073,0.415385,156,0,0
8588683,"Prangins, Tour d'Eau",,0.000056,125,1,2,3,13580,13580,27160,5,0.333333,0.457407,50,0,0
8588680,"Prangins, La Bruyère",,0.00005,125,2,1,3,13580,13580,27160,7,0.229167,0.314502,112,0,0
8588681,"Prangins, Les Morettes",,0.000053,125,1,1,2,13580,13580,27160,6,0.27027,0.36,82,0,0
8595589,"Prangins, Les Abériaux",,0.000107,125,3,2,5,35276,21730,57006,1,1,1,75,0,0
8588685,"Prangins, hôpital",,0.000033,125,1,1,2,8240,8240,16480,4,0.347826,0.427083,240,0,0
8588688,"Gland, Domaine Impérial",,0.000039,125,1,2,3,8240,8240,16480,3,0.466667,0.571429,212,0,0
8593890,"Nyon, Mafroi",,0.000057,125,1,2,3,27511,27510,55021,3,0.5,0.595238,76,0,0
8593892,"Nyon, Petit Perdtemps",,0.000052,125,2,2,4,18016,18007,36023,3,0.5,0.611111,64,0,0
8590023,Sandrain,,0.000076,44,1,1,2,24939,23980,48919,1,1,1,28.25,0,0
8590038,"Bern, Unitobler",,0.000226,44,7,2,9,50233,43584,93817,1,1,1,1520.986508,0,0
8588703,Belp Bützacker,,0.000072,100,3,1,4,5407,5406,10813,4,0.363636,0.4375,2516,0,0
8588705,Konolfingen Dorf,,0.000074,100,3,1,4,7469,7438,14907,3,0.461538,0.527778,6218.5,0,0
8588904,Belp Aemmenmatt,,0.000102,100,4,2,6,20835,9259,30094,2,0.666667,0.75,1348.5,0,0
8588905,Rubigen Thunstrasse Süd,,0.000075,100,2,2,4,3086,3088,6174,1,1,1,675.5,0,0
8588716,"St. Niklaus b. Koppigen, Heim",,0.00003,45,1,1,2,6487,6487,12974,2,0.6,0.666667,68,0,0
8588722,"Cressier FR, bif.",,0.000095,126,1,1,2,4227,4227,8454,1,1,1,1216,0,0
8595537,"Rueyres-les-Prés, école",,0.000191,13,6,1,7,17278,3467,20745,1,1,1,153.12381,0,0
8588736,"Kloten, Ackerstrasse",,0.000063,107,3,1,4,8637,8863,17500,3,0.5,0.611111,591.366667,0.002368,0
8588737,"Kloten, Geissbergstrasse",,0.000038,107,2,1,3,7271,7274,14545,3,0.5,0.611111,11.433333,0.002289,0
8588739,"Kloten, Lägernstrasse",,0.000029,107,1,1,2,13623,13629,27252,2,0.666667,0.75,97,0.00223,0
8588744,"Wallisellen, Kaserne",,0.000015,107,1,1,2,5985,5985,11970,15,0.127798,0.137138,475.833333,0.000289,0
8588748,Horw Zentrum,,0.000076,90,4,4,8,99682,101440,201122,11,0.173755,0.219003,10942.302381,0,0
8589678,"St. Niklausen LU, Haslihorn",,0.000046,90,1,2,3,17044,16903,33947,12,0.15215,0.181433,414,0,0
8589676,Horw Ennethorw,,0.000027,90,1,1,2,17749,17754,35503,17,0.122374,0.158231,0,0,0
8589680,"Kastanienbaum, Schiffstation",,0.000049,90,2,1,3,16902,16791,33693,17,0.122374,0.158231,406.204762,0,0
8588761,Gartenhof,,0.000035,2,2,1,3,3247,3247,6494,12,0.154879,0.173762,167.054762,0,0
8588781,St.Johanns-Tor,,0.00002,2,1,1,2,319,319,638,11,0.178707,0.208947,0,0,0
8589291,Airolostrasse,,0.000048,2,4,2,6,11032,11032,22064,10,0.190341,0.222912,143.198836,0,0
8588776,MParc,,0.000062,2,5,3,8,11586,11666,23252,9,0.241429,0.283956,1245.90747,0,0
8588777,Mülhauserstrasse,,0.000052,2,2,2,4,319,319,638,9,0.240343,0.279693,158.758062,0,0
8588779,Rheingasse,,0.00008,2,5,1,6,57610,57628,115238,10,0.216428,0.25338,96.981394,0,0
8589300,Bruderholzstrasse,,0.000074,2,2,3,5,22444,22444,44888,10,0.196697,0.234654,689.012879,0,0
8589316,Gewerbeschule,,0.000123,2,6,6,12,28516,28518,57034,8,0.272941,0.335088,3728.171288,0,0
8589324,Hirzbrunnen/Claraspital,,0.000036,2,2,6,8,21123,21127,42250,8,0.278061,0.343764,263.69166,0,0
8589336,Kunstmuseum,,0.00002,2,1,4,5,7657,7658,15315,8,0.261307,0.313656,15.895079,0,0
8589340,Margarethen,,0.000066,2,5,3,8,23236,23236,46472,8,0.265464,0.310691,566.578133,0,0
8589352,Riehenring,,0.000118,2,3,8,11,32493,32493,64986,8,0.29878,0.380454,1145.609187,0,0
8589360,Schützenhaus,,0.000131,2,8,6,14,45505,45504,91009,8,0.282468,0.357102,5348.731261,0,0
8589367,Studio Basel,,0.000062,2,3,2,5,11032,11032,22064,8,0.259843,0.306331,233.328165,0,0
8589371,Tinguely Museum,,0.00022,2,14,5,19,30030,29981,60011,7,0.296154,0.36073,5068.6101,0,0
8589373,Wanderstrasse,,0.000073,2,3,2,5,12553,12347,24900,8,0.259843,0.306331,491.290643,0,0
8589375,Wettsteinallee,,0.00007,2,4,5,9,24163,23577,47740,8,0.283019,0.354016,804.701421,0,0
8589347,Neubad,,0.000054,2,2,2,4,23498,23498,46996,9,0.236318,0.281408,278.485196,0,0
8589353,Rankstrasse,,0.000101,2,8,8,16,16489,16926,33415,7,0.290909,0.363145,2418.779712,0,0
8589355,Rosengartenweg,,0.000048,2,3,6,9,21510,21513,43023,8,0.278638,0.349272,347.867001,0,0
8589365,St.Galler-Ring,,0.000036,2,2,2,4,12348,12348,24696,8,0.232143,0.270681,176.481061,0,0
8589323,Hegenheimerstrasse,,0.000048,2,3,5,8,12583,12583,25166,9,0.254989,0.313399,711.415798,0,0
8589333,Kirschgarten,,0.000055,2,4,5,9,15522,15521,31043,9,0.235955,0.294471,642.54328,0,0
8589334,Kleinhüningen,,0.000087,2,5,7,12,31946,31900,63846,9,0.240449,0.312721,2007.330591,0,0
8589339,Lerchenstrasse,,0.000052,2,1,3,4,11031,11032,22063,9,0.219089,0.261932,205.925397,0,0
8589344,Musical Theater,,0.000106,2,8,2,10,14778,14778,29556,9,0.236967,0.281694,376.244286,0,0
8588798,"Wädenswil, Campus Reidbach",,0.000013,63,1,2,3,6450,6450,12900,4,0.461538,0.597222,16,0,0
8590860,"Wädenswil, Giessen",,0.000034,63,2,1,3,7723,3716,11439,4,0.416667,0.516667,499.166667,0,0
8588799,"Emdthal, Dorf",,0.00012,43,3,1,4,1856,722,2578,1,1,1,332,0,0
8588801,"Troinex, Les Crêts",,0.000026,120,1,1,2,18865,18865,37730,12,0.13267,0.169797,898.355532,0,0
8592643,"Bardonnex, Route d'Annecy",,0.000041,120,1,2,3,39286,39286,78572,12,0.139183,0.184813,528.427794,0,0
8592652,"Bernex, Cottenets",,0.000034,120,1,1,2,23498,23502,47000,22,0.108518,0.125247,7,0,0
8591706,"Weggis, Dorfplatz",,0.000179,91,12,6,18,26344,20480,46824,10,0.259615,0.435994,8670.328571,0,0
8591759,"Goldau, Schützenhaus",,0.000078,91,2,1,3,5829,7087,12916,5,0.307692,0.389583,22.5,0,0
8588809,"Kandersteg, Talstat. Sunnbüel",,0.000022,43,1,1,2,4786,4786,9572,6,0.285714,0.408333,312,0,0
8588812,"Därligen, Dorf",,0.000058,43,1,1,2,6246,6232,12478,3,0.5,0.611111,477,0,0
8595607,"Les Masses, télésiège",,0.000094,39,1,1,2,1383,1254,2637,3,0.5,0.611111,18,0,0
8588815,"Minusio, Ignifera",,0.000085,101,2,2,4,41878,42054,83932,11,0.156028,0.249643,3276.366667,0,0
8591512,"Ascona, Baraggie",,0.000047,101,1,1,2,21265,20844,42109,11,0.15,0.213911,0,0,0
8588822,"Schwarzsee, Mösli",,0.000067,126,1,2,3,9087,8185,17272,5,0.3,0.377778,41.333333,0,0
8588823,"Schwarzenburg, Pöschen",,0.000061,126,2,2,4,3585,2746,6331,5,0.3,0.377778,867.480342,0,0
8589270,"Fribourg, Kessler",,0.000035,126,2,2,4,30401,33437,63838,5,0.3,0.377778,55.775,0,0
8589150,"Fribourg, Musy 4",,0.000047,126,1,3,4,49116,50275,99391,7,0.277419,0.337043,4683.957391,0,0
8588821,"Schwarzsee, Campus",,0.000066,126,2,1,3,9088,9087,18175,6,0.240506,0.296491,1850.333333,0,0
8588827,"Pont-la-Ville, Sur-Momont",,0.000024,126,1,1,2,3855,3855,7710,1,1,1,25,0,0
8588842,"Crissier, Bré",,0.000032,5,1,1,2,24785,68467,93252,18,0.114105,0.136143,583,0,0
8592173,"Prilly, centre",,0.000078,5,3,2,5,88421,88460,176881,11,0.185053,0.253732,2291.89899,0,0
8592103,"Lausanne, Prélaz-les-Roses",,0.000097,5,3,3,6,111344,109559,220903,10,0.216401,0.278601,5047.232517,0,0
8592109,"Lausanne, Recordon",,0.000105,5,3,8,11,75256,69745,145001,10,0.239583,0.340204,13539.809122,0,0
8592178,"Prilly, église",,0.000049,5,2,3,5,75573,75583,151156,10,0.204545,0.288192,1216,0,0
8592200,"Renens VD, 1er Août",,0.000097,5,6,4,10,37079,37081,74160,9,0.229508,0.327192,6228.13073,0,0
8592201,"Renens VD, 1er Mai",,0.000046,5,2,2,4,18049,18049,36098,10,0.199029,0.267528,72.666667,0,0
8588840,"Crissier, Noutes",,0.000016,5,1,1,2,24785,24785,49570,20,0.093458,0.107504,153,0,0
8588841,"Crissier, scierie",,0.000025,5,1,1,2,24785,24785,49570,19,0.102737,0.119777,369,0,0
8588843,"Crissier, centre",,0.000051,5,2,1,3,76835,76837,153672,17,0.128354,0.159587,1310.5,0,0
8591935,"Crissier, Arc-en-Ciel",,0.000036,5,1,1,2,34193,34193,68386,16,0.169326,0.201915,427.821429,0,0
8591936,"Crissier, Closalet",,0.000023,5,1,1,2,27465,27465,54930,16,0.169326,0.201915,596.545471,0,0
8591818,"Lausanne-Flon, pl. de l'Europe",,0.000062,5,4,2,6,112183,113871,226054,15,0.118736,0.14507,648.358333,0,0
8588847,"Villars-Ste-Croix, village",,0.000022,5,1,1,2,14646,14646,29292,20,0.109451,0.127596,79,0,0
8588850,"Mex VD, Les Esserts",,0.000035,5,1,1,2,5080,5080,10160,6,0.28,0.385714,211,0,0
8588853,"Mex VD, village",,0.00004,5,1,1,2,5080,5079,10159,5,0.333333,0.436111,114,0,0
8589397,Salinenstrasse,,0.00007,2,1,3,4,11851,11851,23702,3,0.625,0.766667,386.044322,0,0
8595445,Liestal Ringwald,,0.000088,2,1,2,3,16447,16129,32576,1,1,1,18.628571,0,0
8595601,Muttenz Untere Hard,,0.000125,2,2,1,3,14130,8046,22176,1,1,1,18.628571,0,0
8589142,"Fribourg, Capucins",,0.000077,126,2,2,4,57685,57685,115370,7,0.202765,0.25303,3315.231644,0,0
8589146,"Villars-sur-Glâne, Berra",,0.000069,126,2,2,4,28220,29165,57385,7,0.257143,0.303545,163.325,0,0
8589148,"Fribourg, Plateau-de-Pérolles",,0.000102,126,3,2,5,112295,112295,224590,8,0.222798,0.266694,2016.458333,0,0
8589149,"Fribourg, Pisciculture",,0.000054,126,1,1,2,55666,55666,111332,8,0.21875,0.249235,0,0,0
8589131,"Villars-sur-Glâne, Moncor",,0.000127,126,5,3,8,77985,77008,154993,8,0.231373,0.292595,11233.854687,0,0
8589135,"Villars-sur-Glâne, Nuithonie",,0.000069,126,3,3,6,39567,36675,76242,8,0.255319,0.32433,5970.659638,0,0
8593290,"Riaz, Centre",,0.000192,13,6,2,8,47917,14944,62861,5,0.380952,0.514583,4680.309524,0,0
8593281,"Bulle, Place des Alpes",,0.000059,13,2,2,4,70244,62959,133203,10,0.203791,0.276956,72.866667,0,0
8592251,"Lonay, Grassiaz",,0.000081,5,2,1,3,34622,34624,69246,7,0.225989,0.263571,1754.466667,0,0
8588898,"Préverenges, Capellan",,0.000019,5,1,3,4,16035,15824,31859,16,0.123163,0.15781,66,0,0
8591933,"Chavannes-R., Planta",,0.000031,5,1,2,3,57983,58381,116364,13,0.152574,0.194788,16493.007505,0,0
8591948,"Ecublens VD, Croset",,0.000031,5,1,1,2,30399,30665,61064,16,0.105034,0.121598,6389,0,0
8591961,"Ecublens VD, Villars",,0.000122,5,3,3,6,46939,47131,94070,12,0.170626,0.213681,10621.666667,0,0
8592242,"Denges, village",,0.000056,5,1,2,3,16035,16035,32070,8,0.215596,0.266793,2883.781818,0,0
8588877,Frenkendorf Bächliacker,,0.000027,2,1,1,2,22440,29847,52287,9,0.20438,0.254393,99,0,0
8589513,"Laupen ZH, Mürtschenstrasse",,0.00005,67,3,1,4,1000,1003,2003,1,1,1,443,0,0
8588884,Nordstrasse,,0.000049,66,2,3,5,25004,25004,50008,12,0.172524,0.252008,455.07619,0,0
8588886,Stahlgiesserei,,0.000066,66,3,1,4,10215,10215,20430,12,0.152778,0.216056,351,0,0
8588887,Bahnhof Nord,,0.000081,66,2,2,4,10615,10615,21230,11,0.174863,0.267623,518,0,0
8592568,Plattenweg,,0.00005,66,3,1,4,19579,19579,39158,4,0.428571,0.513889,137.5,0,0
8588885,Pilgerbrunnen,,0.000025,66,1,1,2,19579,19579,39158,7,0.22807,0.273443,231.07619,0,0
8588888,Logierhaus,,0.000045,66,1,1,2,10215,10215,20430,10,0.174825,0.239746,455,0,0
8588889,"Abtwil SG, Dorf",,0.000044,71,2,1,3,52068,51662,103730,14,0.139596,0.158746,2027,0,0
8588891,"Davos Dorf, Solaria",,0.000022,131,1,1,2,10670,10677,21347,5,0.333333,0.456667,7280,0,0
8588892,"Davos Dorf, Stäg",,0.00003,131,1,1,2,10677,10677,21354,4,0.4,0.520833,5828,0,0
8588893,"Davos Dorf, Duchli",,0.000036,131,1,1,2,10677,5918,16595,3,0.5,0.611111,4374,0,0
8588894,"Davos Dischma, Abzw. Büelen",,0.000042,131,1,1,2,5918,5908,11826,2,0.666667,0.75,2918,0,0
8588895,"Davos Dischma, Chaiseren",,0.000046,131,1,1,2,5908,5914,11822,1,1,1,1460,0,0
8591601,"Lugano, Casa Serena",,0.000051,102,1,1,2,42367,42367,84734,13,0.165468,0.207752,10.666667,0,0
8588900,"Davesco, Via Sonvico",,0.000028,102,1,1,2,2758,2758,5516,12,0.168129,0.189331,309,0,0
8588971,"Cassarate, Monte Brè",,0.000064,102,3,1,4,60580,60580,121160,12,0.156835,0.17982,4917.083333,0,0
8589265,Brunnhaldenstrasse,,0.000064,100,2,1,3,3728,1539,5267,1,1,1,619,0,0
8588909,"Burgdorf, Gyri Ost",,0.00002,45,1,1,2,9731,9731,19462,6,0.285714,0.342708,113,0,0
8588911,"Burgdorf, Blattnerweg",,0.000035,45,2,1,3,9736,9735,19471,6,0.264151,0.322619,85,0,0
8588923,"Burgdorf, Schützenhaus",,0.000044,45,1,2,3,18718,16344,35062,5,0.375,0.547222,61.461905,0,0
8588914,"Burgdorf, Nassi",,0.00003,45,1,1,2,8880,8687,17567,5,0.323529,0.389394,84.742857,0,0
8593263,"Burgdorf, Friedhofweg",,0.00006,45,2,3,5,10577,11379,21956,3,0.625,0.766667,101.228571,0,0
8588916,"Burgdorf, Gymnasium",,0.000054,45,2,1,3,11379,11379,22758,5,0.342857,0.405556,153.166667,0,0
8588920,"Burgdorf, Kronenplatz",,0.000044,45,1,1,2,13610,13610,27220,5,0.305556,0.366667,22,0,0
8588922,"Burgdorf, City",,0.000157,45,7,4,11,44284,43723,88007,3,0.6,0.703704,607.52381,0,0
8588918,"Burgdorf, Friedhof",,0.000033,45,1,1,2,13644,13644,27288,7,0.213115,0.284066,122,0,0
8588919,"Burgdorf, Musikschule",,0.000039,45,1,1,2,13644,13610,27254,6,0.25,0.316667,73,0,0
8593264,"Burgdorf, Nationalplatz",,0.000062,45,3,1,4,14291,5002,19293,4,0.4,0.520833,7,0,0
8588924,"Langnau i.E., Oberfeldstrasse",,0.00006,123,2,1,3,6032,6059,12091,7,0.229167,0.309957,150,0,0
8588925,"Langnau i.E., Knieplatz",,0.000062,123,1,1,2,6059,6059,12118,6,0.27027,0.348333,85,0,0
8588927,"Langnau i.E., Hasenknubel",,0.000107,123,3,2,5,12150,12150,24300,4,0.444444,0.552083,568.25,0,0
8588931,"Langnau i.E., Lindenstrasse",,0.000063,123,1,1,2,6091,6091,12182,3,0.5,0.583333,12,0,0
8588928,"Langnau i.E., Napfstrasse",,0.000056,123,1,1,2,6091,6091,12182,6,0.269231,0.378571,237,0,0
8588929,"Langnau i.E., unt. Beichlenstr",,0.000059,123,1,1,2,6091,6091,12182,5,0.315789,0.422222,164,0,0
8588930,"Langnau i.E., Fansrütistrasse",,0.000061,123,1,1,2,6091,6091,12182,4,0.384615,0.483333,89,0,0
8594263,"Chavannes-de-Bogis, poste",,0.000054,125,3,1,4,5047,5062,10109,4,0.4,0.520833,126,0,0
8588938,"Muntelier-Löwenberg, Station",,0.000044,126,2,2,4,3007,3007,6014,4,0.444444,0.552083,3675.666667,0,0
8589304,Buschweilerweg,,0.000032,2,1,1,2,11412,11412,22824,11,0.151596,0.170524,105.971212,0,0
8588948,Redingstrasse,,0.000044,2,2,2,4,14099,14093,28192,10,0.184211,0.214665,3006.567594,0,0
8589310,Falkensteinerstrasse,,0.000059,2,2,1,3,17467,11412,28879,10,0.177116,0.202216,570.334812,0,0
8588949,Ulmenweg,,0.00003,2,1,1,2,11387,11412,22799,11,0.165414,0.18815,308.737121,0,0
8589299,Bruderholz,,0.000045,2,2,1,3,11032,11032,22064,11,0.165414,0.18815,294.275758,0,0
8588957,"Oberriet SG, Hirschensprung",,0.000061,73,2,1,3,16239,16142,32381,4,0.384615,0.483333,2106,0,0
8588964,"Abtwil SG, Grund",,0.000052,71,2,1,3,31031,31015,62046,13,0.15752,0.176022,1475.875187,0,0
8588965,"Abtwil SG, Friedhof",,0.000055,71,1,1,2,31015,31015,62030,12,0.185766,0.212031,1008.875187,0,0
8588967,"Leissigen, Schulhaus",,0.00006,43,1,1,2,6232,6246,12478,2,0.666667,0.75,320,0,0
8588968,"Därligen, Bahnhof",,0.000062,43,1,1,2,6246,6232,12478,1,1,1,161,0,0
8588972,"Cassarate, Lanchetta",,0.000085,102,2,2,4,113327,113327,226654,11,0.1843,0.218952,6804,0,0
8588976,"Castagnola, Salita Olivi",,0.000051,102,1,1,2,24456,24456,48912,11,0.181818,0.208933,106,0,0
8588975,"Castagnola, S. Grato",,0.000047,102,1,1,2,24456,24456,48912,12,0.155072,0.175393,359,0,0
8588977,"Lugano, Palazzo Studi",,0.00009,102,2,4,6,113327,113327,226654,10,0.220126,0.268462,6045,0,0
8591589,"Breganzona, Medi",,0.00003,102,1,1,2,52747,52747,105494,12,0.153971,0.176441,0,0,0
8592187,"Prilly, Mont-Goulin",,0.000073,10,2,1,3,80243,30669,110912,7,0.257143,0.329762,532.071429,0,0
8592193,"Pully, Pierraz-Portay",,0.00011,5,1,3,4,71806,70582,142388,7,0.277778,0.396786,250.209585,0,0
8592202,"Renens VD, Avenir",,0.000096,5,6,3,9,76981,76985,153966,9,0.231214,0.318552,7850.92159,0,0
8588984,"Horgen, Gehren",,0.00004,63,2,1,3,3427,3427,6854,12,0.154206,0.214673,99,0,0
8588985,"Horgen, Heubach",,0.000045,63,1,1,2,3427,3427,6854,11,0.176796,0.256885,61,0,0
8590662,"Horgen, Waldhof",,0.000042,63,2,1,3,2657,2657,5314,2,0.666667,0.75,172,0,0
8590003,Bitziusstrasse,,0.000024,44,1,1,2,10353,10316,20669,9,0.2,0.31433,0,0,0
8588990,Bollwerk,,0.000085,44,5,3,8,25836,25901,51737,12,0.151394,0.243319,19795.5,0,0
8590004,Aeussere Enge,,0.000035,44,1,1,2,7584,7618,15202,9,0.210526,0.301025,0,0,0
8588991,Breitfeld,,0.000035,44,1,1,2,11211,11254,22465,11,0.142857,0.196352,4043,0,0
8588994,Gewerbeschule,,0.000041,44,1,1,2,11254,11189,22443,10,0.16,0.213872,2854,0,0
8588996,Lorraine,,0.000045,44,1,1,2,11189,11253,22442,9,0.18254,0.238544,1663,0,0
8588997,Luternauweg,,0.000034,44,2,1,3,6209,6324,12533,11,0.14359,0.176085,2393,0,0
8588998,Manuelstrasse,,0.00004,44,1,1,2,6324,6324,12648,10,0.164671,0.203874,1280,0,0
8589993,Wander,,0.000017,44,1,1,2,11530,11590,23120,9,0.183486,0.245873,20,0,0
8589005,Willadingweg,,0.000049,44,2,2,4,6324,6324,12648,7,0.25,0.362381,3662.685714,0,0
8590062,Tillierstrasse,,0.000051,44,1,1,2,6124,6124,12248,1,1,1,22,0,0
8589007,Wyler,,0.000059,44,2,2,4,14641,14612,29253,7,0.259259,0.354875,1705.5,0,0
8589043,Stettlen,,0.000067,44,2,1,3,194,111,305,5,0.333333,0.436111,2591.683333,0,0
8590019,Sonnenhof,,0.000065,44,3,2,5,31412,30660,62072,6,0.290323,0.380556,775.05,0,0
8589016,Stampachgasse,,0.000051,44,1,4,5,7053,7053,14106,8,0.28,0.479847,457.809524,0,0
8589017,Reckholtern,,0.000032,44,2,1,3,3747,120,3867,10,0.180556,0.269536,6.333333,0,0
8589013,Hallenbad,,0.000042,44,3,1,4,7053,7053,14106,10,0.197531,0.281498,2871.809524,0,0
8589015,Lutertal,,0.000047,44,1,1,2,7053,7053,14106,9,0.230769,0.337011,1665.809524,0,0
8589029,Linde,,0.000065,44,1,1,2,3750,550,4300,8,0.234043,0.337987,60.32619,0,0
8589031,Hausmattstrasse,,0.000043,44,1,1,2,2989,2989,5978,8,0.234043,0.337987,4595.864286,0,0
8589032,Ittigenstrasse,,0.000113,44,3,2,5,3650,3650,7300,7,0.277778,0.429286,3538.190476,0,0
8589018,Rüttelerweg,,0.000063,44,3,1,4,3750,3750,7500,9,0.20339,0.296263,1274.32619,0,0
8589019,Aeschebrunnmatt,,0.000026,44,1,1,2,4136,4136,8272,9,0.203704,0.298088,3570,0,0
8589020,Chutze,,0.000033,44,1,1,2,4136,4136,8272,8,0.232558,0.330119,2390,0,0
8589021,Friedhagweg,,0.000039,44,1,1,2,4136,4136,8272,7,0.272727,0.380688,1208,0,0
8589023,Ländli,,0.000045,44,2,1,3,2097,2036,4133,6,0.304348,0.421429,8330,0,0
8589024,Oeschenweg,,0.000068,44,2,2,4,4136,4136,8272,5,0.375,0.547222,7170,0,0
8589034,Talgut-Zentrum,,0.00004,44,1,1,2,2103,2103,4206,5,0.333333,0.456667,0,0,0
8589028,"Grafenried, Rest. Kreuz",,0.000042,87,1,1,2,56,56,112,3,0.5,0.611111,3525,0,0
8589030,Ittigen Bahnhof,,0.000038,44,2,1,3,5912,2989,8901,9,0.20339,0.296263,5779.864286,0,0
8589033,Mannenberg,,0.00007,44,2,1,3,7053,661,7714,7,0.257143,0.365873,60,0,0
8589037,Gümligenfeld,,0.000037,44,2,2,4,8250,8250,16500,7,0.24359,0.33609,1508.405714,0,0
8589038,Grubenweg,,0.000074,44,2,1,3,4136,4136,8272,4,0.4,0.520833,4788,0,0
8589039,Känelgasse,,0.000074,44,1,1,2,4136,4136,8272,3,0.5,0.611111,3594,0,0
8589042,"Schönbühl, Solothurnstrasse",,0.000047,87,1,1,2,56,56,112,2,0.666667,0.75,2352,0,0
8589044,Reichenbach,,0.000073,44,1,1,2,4136,4136,8272,2,0.666667,0.75,2398,0,0
8589045,"Urtenen, Schmiedgässli",,0.00005,87,1,1,2,56,56,112,1,1,1,1177,0,0
8589047,Erlachplatz,,0.00008,44,3,1,4,9096,9096,18192,3,0.428571,0.5,2360,0,0
8589050,Schulhaus Ost,,0.000035,44,1,1,2,3112,770,3882,1,1,1,0,0,0
8589051,Schulhaus West,,0.000045,44,1,1,2,5984,603,6587,1,1,1,1.5,0,0
8589053,Aarestrasse,,0.000073,44,1,1,2,4136,4136,8272,1,1,1,1200,0,0
8589066,"Neukirch-Egnach, Bahnhof",,0.000133,121,2,1,3,30923,16397,47320,1,1,1,810,0,0
8594535,"Thun, Arena Thun",,0.000089,43,3,1,4,5994,2039,8033,7,0.243243,0.343651,724.5,0,0
8589069,"Hasle b.B., Eisbahnweg",,0.000058,45,3,1,4,8341,8341,16682,6,0.30303,0.386667,85,0,0
8589074,"Altreu, Nord",,0.000058,127,2,1,3,5825,5825,11650,14,0.10089,0.146768,25284,0,0
8589085,"Weissenbach, Bahnhof",,0.000044,13,1,1,2,1952,1952,3904,7,0.25,0.370408,1120,0,0
8589108,"Oberrieden, Tannenbach",,0.00004,63,2,1,3,2457,2457,4914,11,0.157895,0.21155,150,0,0
8589109,"Horgen, Säntisstrasse",,0.000045,63,1,1,2,2457,2492,4949,10,0.18125,0.24543,104,0,0
8589112,"Herisau, obere Fabrik",,0.000024,71,1,1,2,15884,15884,31768,6,0.269231,0.378571,3409,0,0
8589113,"Herisau, Cilander",,0.000031,71,1,1,2,15884,15884,31768,5,0.315789,0.422222,2928,0,0
8589117,"Lenk, Erlebnisbad",,0.00005,23,2,1,3,1767,1965,3732,9,0.222222,0.308708,144.5,0,0
8589125,"Lenk, Badgässli",,0.000078,23,1,3,4,5487,2971,8458,8,0.25,0.445238,217.5,0,0
8589121,"Lenk, Gemeindehaus",,0.000079,23,4,1,5,5430,5487,10917,9,0.213115,0.328724,233.5,0,0
8589122,"Lenk, Gerbi",,0.000027,23,1,1,2,4271,4271,8542,2,0.666667,0.75,46,0,0
8591771,"Lenk, Hubelmatte",,0.000033,23,1,1,2,1273,1271,2544,2,0.666667,0.75,0,0,0
8589128,"Volketswil, Chammwisen",,0.000037,84,1,1,2,25574,6341,31915,1,1,1,107,0,0
8589140,"Fribourg, Champriond",,0.000111,126,4,3,7,61121,62172,123293,7,0.258242,0.314387,9639.202869,0,0
8589168,"Villars-sur-Glâne, Coulat",,0.000062,126,1,2,3,29165,29165,58330,6,0.284091,0.362,25,0,0
8589169,"Villars-sur-Glâne, Derrey",,0.000058,126,2,2,4,37694,38367,76061,6,0.282353,0.363194,1155.007937,0,0
8589138,"Fribourg, Cité-Jardins",,0.000047,126,3,1,4,54452,54452,108904,9,0.174603,0.202904,5718.383333,0,0
8589143,"Fribourg, Beaumont-Est",,0.000062,126,2,2,4,46426,44968,91394,7,0.254144,0.299482,306.872727,0,0
8589141,"Fribourg, Chaley",,0.00005,126,1,1,2,54452,54452,108904,8,0.206731,0.236351,3856.383333,0,0
8589144,"Fribourg, Arsent",,0.000054,126,1,1,2,54452,54452,108904,7,0.254545,0.290703,1992.383333,0,0
8589145,"Corminboeuf, Centre-sportif",,0.000063,126,2,1,3,4309,3957,8266,1,1,1,1852,0,0
8589147,"Fribourg, Ploetscha",,0.000042,126,3,1,4,32735,49116,81851,8,0.221106,0.256466,6490.957391,0,0
8589151,"Fribourg, Musy 24",,0.000024,126,1,1,2,32353,33437,65790,7,0.247059,0.279592,1852,0,0
8589172,"Villars-sur-Glâne, Fenetta",,0.000102,126,4,5,9,49606,48032,97638,5,0.365079,0.489855,6804.733899,0,0
8592368,"Fribourg, Butte",,0.000057,126,2,1,3,10106,10234,20340,5,0.304348,0.370238,0,0,0
8589162,"Fribourg, Stadtberg",,0.000047,126,2,4,6,87889,87889,175778,5,0.333333,0.445455,3954.083333,0,0
8589273,"Villars-sur-Glâne,Rte Préalpes",,0.000051,126,2,2,4,39866,38121,77987,7,0.213333,0.313244,1040.85119,0,0
8591687,"Villars-sur-Glâne, Cormanon",,0.000055,126,2,1,3,36715,38367,75082,7,0.202703,0.26746,8.5,0,0
8589269,"Fribourg, Chancellerie",,0.000033,126,2,2,4,43351,34673,78024,5,0.3125,0.39,2,0,0
8589163,"Fribourg, Stade-Patinoire",,0.000064,126,2,1,3,57685,57685,115370,8,0.172414,0.227738,7720,0,0
8589164,"Fribourg, Poya",,0.000065,126,1,1,2,57685,57685,115370,7,0.197917,0.251128,5809,0,0
8589165,"Villars-sur-Glâne, Blés-d'Or",,0.00006,126,2,1,3,28290,29165,57455,7,0.22807,0.279304,1930,0,0
8589272,"Villars-sur-Glâne, Chênes",,0.000053,126,2,2,4,36715,38367,75082,8,0.186813,0.289426,1200.867857,0,0
8589175,"Granges-Paccot, P. de-Fribourg",,0.000066,126,1,1,2,57685,57684,115369,6,0.233766,0.285185,3896,0,0
8589176,"Granges-Paccot, Forum-Fribourg",,0.000067,126,1,1,2,57684,57685,115369,5,0.288136,0.341176,1981,0,0
8589178,"Gretzenbach, Weid",,0.000037,94,1,1,2,11479,11479,22958,13,0.142857,0.244626,1846,0,0
8589179,"Gretzenbach, Grabacker",,0.000042,94,1,1,2,11479,11479,22958,12,0.153846,0.258601,1716,0,0
8589180,"Gretzenbach, Staldenacker",,0.000047,94,1,1,2,11479,11479,22958,11,0.166667,0.274534,1584,0,0
8589181,"Gretzenbach, Pfarrmatt",,0.000051,94,1,1,2,11479,11479,22958,10,0.181818,0.292897,1450,0,0
8589182,"Gretzenbach, Bielacker",,0.000054,94,1,1,2,11479,11479,22958,9,0.2,0.31433,1314,0,0
8589183,"Schönenwerd SO, Kreuzackerstr.",,0.000057,94,1,1,2,11479,11479,22958,8,0.222222,0.339732,1176,0,0
8589184,"Schönenwerd SO, Zentrum",,0.000059,94,1,1,2,11479,11479,22958,7,0.25,0.370408,1036,0,0
8589185,"Schönenwerd SO, Baumstrasse",,0.000061,94,1,1,2,11479,11479,22958,6,0.285714,0.408333,894,0,0
8589186,"Schönenwerd SO,Schachenstrasse",,0.000063,94,1,1,2,11479,11479,22958,5,0.333333,0.456667,750,0,0
8589187,"Schönenwerd SO, Lochmatt",,0.000064,94,1,1,2,11479,11479,22958,4,0.4,0.520833,604,0,0
8589188,Wöschnau,,0.000066,94,1,1,2,11479,11479,22958,3,0.5,0.611111,456,0,0
8589189,"Aarau, Roggenhausen",,0.000067,94,1,1,2,11479,11479,22958,2,0.666667,0.75,306,0,0
8589190,"Aarau, Schanz",,0.000068,94,1,1,2,11479,11479,22958,1,1,1,154,0,0
8589192,"Kirchberg-Alchenflüh, Bahnhof",,0.000064,45,3,1,4,28459,28441,56900,5,0.32,0.4,321,0,0
8589193,"Alchenflüh, Bernstrasse Ost",,0.000065,45,1,1,2,28441,28450,56891,4,0.411765,0.488095,248,0,0
8589194,"Dürrenroth, Fuchsloch",,0.000066,45,1,1,2,8825,8825,17650,4,0.4,0.520833,248,0,0
8589195,"Dürrenroth, Hulligen",,0.000067,45,1,1,2,8825,8825,17650,3,0.5,0.611111,189,0,0
8593265,"Burgdorf, Poststrasse",,0.000115,45,4,2,6,34639,13322,47961,2,0.75,0.833333,209.066667,0,0
8593494,"Lyssach, Dorfstrasse",,0.000036,45,1,1,2,4509,4508,9017,1,1,1,1,0,0
8589260,"Langenthal, Spital",,0.000031,88,2,3,5,27794,27794,55588,4,0.470588,0.614583,508,0,0
8589205,"Zofingen, Eisengrube",,0.000065,94,2,1,3,8209,8190,16399,2,0.666667,0.75,244,0,0
8589208,"Reiden, Kirche",,0.000046,94,1,1,2,15101,8298,23399,1,1,1,243,0,0
8589210,"Reuchenette-Pery, gare",,0.00002,87,1,1,2,7450,7451,14901,2,0.6,0.666667,58.757143,0,0
8589215,"Lengnau BE, Schulhaus Dorf",,0.00006,127,3,3,6,12716,10282,22998,9,0.25,0.400724,17752.647619,0,0
8593375,"Biel/Bienne, Stadtpark/Parc m.",,0.000062,87,1,2,3,43473,43474,86947,2,0.666667,0.75,1396,0,0
8593378,"Biel/Bienne, Südstrasse/Midi",,0.000041,87,1,1,2,48352,48350,96702,2,0.6,0.666667,2407.095238,0,0
8593388,"Nidau, Guglerstr./Rue Gugler",,0.000037,87,1,1,2,43259,43213,86472,2,0.6,0.666667,0,0,0
8593829,"Lengnau BE, Kreisel Badmatt",,0.000028,127,1,2,3,6207,3910,10117,8,0.280702,0.399033,15106,0,0
8589212,Wassen Dorf,,0.000053,93,2,1,3,7358,7518,14876,2,0.6,0.666667,202,0,0
8589213,"Grenchen, Flughafenstrasse",,0.000075,127,2,1,3,16598,16598,33196,8,0.204082,0.240744,320,0,0
8594131,"Grenchen, Mattenstrasse",,0.000098,127,4,2,6,7301,7301,14602,4,0.461538,0.597222,1448.3,0,0
8594133,"Grenchen, Obere Flurstrasse",,0.000028,127,2,1,3,12655,5580,18235,2,0.666667,0.75,4,0,0
8589223,Talberg,,0.000049,66,1,2,3,10215,10215,20430,9,0.20339,0.296495,438,0,0
8589948,Merishausen Eichwis,,0.000032,66,1,1,2,4907,4907,9814,9,0.196581,0.265908,0,0,0
8589225,Inwil Oberhofen,,0.000051,90,3,1,4,5200,2600,7800,14,0.130172,0.150825,5037.957143,0,0
8589251,"St-Prex, place d'Armes",,0.000047,5,2,1,3,6260,6260,12520,7,0.25,0.370408,435,0,0
8589252,"St-Prex, Penguey",,0.000051,5,1,1,2,6260,6260,12520,6,0.285714,0.408333,345,0,0
8589253,"St-Prex, gare nord",,0.000054,5,1,1,2,6260,6260,12520,5,0.333333,0.456667,253,0,0
8589257,"St-Prex, Scierie",,0.000057,5,1,1,2,6260,6259,12519,4,0.4,0.520833,159,0,0
8589933,"Langenthal, Gaswerkstrasse",,0.00004,88,1,1,2,13895,13897,27792,3,0.5,0.611111,9,0,0
8589934,"Langenthal, Hardau",,0.000029,88,2,1,3,13895,13399,27294,3,0.5,0.611111,1.5,0,0
8589283,Bettenacker,,0.000038,2,2,1,3,5727,5727,11454,10,0.180212,0.205832,203.263492,0,0
8589286,Kirche,,0.000047,2,3,2,5,17067,17068,34135,10,0.182519,0.215317,781.636441,0,0
8589288,Merkurstrasse,,0.000037,2,1,1,2,11007,11007,22014,10,0.180645,0.207679,140,0,0
8589287,Lindenplatz,,0.000031,2,1,1,2,11007,11007,22014,11,0.15393,0.17316,163,0,0
8589361,Schützenmattstrasse,,0.000075,2,4,9,13,25890,25890,51780,8,0.278689,0.371022,1985.295541,0,0
8589366,Strassburgerallee,,0.00006,2,5,3,8,20028,20027,40055,8,0.248428,0.300467,290.753574,0,0
8589380,Zeughaus,,0.000045,2,1,1,2,12152,306,12458,3,0.5,0.583333,5.571429,0,0
8592321,Badischer Bahnhof,,0.000236,2,13,4,17,66310,35768,102078,2,0.7,0.785714,1028.030851,0,0
8592322,Bahnhof St.Johann,,0.000097,2,3,2,5,14355,175,14530,3,0.555556,0.666667,119.472626,0,0
8589294,Belforterstrasse,,0.000032,2,3,2,5,8197,8196,16393,8,0.230942,0.268967,650.703039,0,0
8589326,Hoffmann-La Roche,,0.000083,2,7,4,11,14276,14277,28553,8,0.251256,0.304536,2121.460679,0,0
8589332,Käferholzstrasse,,0.000042,2,1,3,4,10019,10019,20038,8,0.248101,0.295445,98,0,0
8589337,Lange Erlen,,0.000037,2,2,3,5,11626,11626,23252,8,0.244131,0.288656,314.210385,0,0
8589350,Peter Rot-Strasse,,0.00004,2,2,3,5,9339,9339,18678,8,0.255263,0.305535,36.613543,0,0
8589311,Im Westfeld,,0.000024,2,1,3,4,11885,11886,23771,10,0.216667,0.265103,30.75,0,0
8589317,Grellingerstrasse,,0.00004,2,3,1,4,12150,12152,24302,10,0.192308,0.222884,73.720974,0,0
8589320,Hardstrasse,,0.000059,2,3,5,8,23951,23951,47902,9,0.235828,0.294899,725.0674,0,0
8589348,Novartis Campus,,0.000113,2,7,4,11,14674,14475,29149,9,0.24505,0.305824,1234.377415,0,0
8589354,Rigistrasse,,0.00009,2,5,5,10,23760,23760,47520,8,0.259669,0.32291,1678.238281,0,0
8589356,Rütimeyerplatz,,0.000027,2,2,1,3,8198,8198,16396,9,0.222222,0.257418,43.680463,0,0
8589295,Bernerring,,0.00002,2,1,1,2,12095,12086,24181,12,0.143969,0.164951,461.750875,0,0
8589302,Waldighoferstrasse,,0.000045,2,3,1,4,11886,11886,23772,10,0.189655,0.215617,293.017796,0,0
8589297,Blotzheimerstrasse,,0.000024,2,1,1,2,8141,8141,16282,10,0.169717,0.189963,176,0,0
8589301,Bundesplatz,,0.000028,2,1,1,2,12086,12086,24172,11,0.166667,0.194304,409.750875,0,0
8589309,Erasmusplatz,,0.000035,2,1,1,2,17714,17715,35429,11,0.160828,0.179617,312.937129,0,0
8589312,Forellenweg,,0.00008,2,2,4,6,14118,14118,28236,9,0.213333,0.257859,3167.165285,0,0
8589313,Frobenstrasse,,0.000028,2,1,1,2,5706,5706,11412,11,0.158798,0.179548,0,0,0
8589315,General Guisan-Strasse,,0.000051,2,2,2,4,11412,11412,22824,10,0.187075,0.217677,236.490476,0,0
8589327,Holbeinstrasse,,0.000054,2,5,3,8,11436,11436,22872,9,0.231982,0.283984,1238.414677,0,0
8589358,Erlenmatt,,0.000061,2,4,2,6,25952,25384,51336,8,0.241486,0.287988,451.447802,0,0
8589368,Surinam,,0.000051,2,1,3,4,11626,11626,23252,8,0.243827,0.297001,86.276299,0,0
8589376,Wettsteinplatz,,0.000202,2,11,9,20,42523,40416,82939,7,0.343915,0.43989,7783.740717,0,0
8589382,Zoo Dorenbach,,0.000068,2,4,3,7,31434,31434,62868,9,0.2,0.270544,1327.033333,0,0
8589383,Zwinglihaus,,0.00003,2,1,1,2,5706,5706,11412,3,0.444444,0.5,0,0,0
8589392,Hohle Gasse,,0.00003,2,1,3,4,20022,19934,39956,8,0.233051,0.30329,853,0,0
8589475,Pfaffenloh,,0.000055,2,1,2,3,14014,14014,28028,3,0.473684,0.555556,502,0,0
8589485,Weilstrasse,,0.000034,2,1,1,2,11040,11040,22080,3,0.444444,0.5,0,0,0
8589319,Hammerstrasse,,0.00004,2,1,1,2,17715,17715,35430,10,0.189753,0.213266,260.937129,0,0
8589321,Hauensteinstrasse,,0.000044,2,2,1,3,11032,11032,22064,11,0.154655,0.174288,363.925397,0,0
8589322,Hechtliacker,,0.000049,2,1,1,2,11032,11031,22063,10,0.181172,0.206524,285.925397,0,0
8589363,Sportzentrum Rankhof,,0.000029,2,2,6,8,12726,12726,25452,7,0.30303,0.371071,227.826215,0,0
8589364,St.Alban-Tor,,0.000054,2,3,2,5,11799,11799,23598,9,0.210526,0.251076,248.597642,0,0
8589443,Bahnübergang,,0.000135,2,8,5,13,10323,13789,24112,6,0.303571,0.386275,2772.493708,0,0
8589346,Nasenweg,,0.000057,2,3,3,6,14118,14118,28236,8,0.248082,0.292059,2462.646941,0,0
8589369,Synagoge,,0.000018,2,1,2,3,4052,4052,8104,8,0.241486,0.28402,10.890476,0,0
8589370,Thiersteinerschule,,0.000041,2,2,1,3,5706,5706,11412,8,0.230769,0.262134,0,0,0
8589351,Pilgerstrasse,,0.000042,2,1,2,3,11493,11493,22986,9,0.224543,0.272374,86,0,0
8589335,Kunsteisbahn,,0.000037,2,2,2,4,5706,5706,11412,9,0.221053,0.255355,41.051477,0,0
8589329,Im Heimatland,,0.000037,2,2,1,3,10019,10019,20038,9,0.200405,0.226579,170,0,0
8589338,Laupenring,,0.000031,2,2,1,3,12081,12086,24167,10,0.192771,0.219548,62.368627,0,0
8589341,Mattenstrasse,,0.000045,2,1,1,2,17715,17715,35430,9,0.23185,0.268042,206.937129,0,0
8589345,Musik-Akademie,,0.000036,2,2,1,3,11493,11493,22986,10,0.185106,0.214122,191,0,0
8589387,Bückenweg,,0.000071,2,2,4,6,6456,6456,12912,7,0.251101,0.322598,1364,0,0
8589390,Mennweg,,0.000054,2,2,2,4,3401,3401,6802,7,0.239819,0.290341,359,0,0
8589391,St.Chrischona,,0.000034,2,1,1,2,3343,3343,6686,7,0.236364,0.276694,0,0,0
8589398,Blauenstrasse,,0.000034,2,1,2,3,8198,8046,16244,7,0.246445,0.297207,128.5,0,0
8589442,Auf dem Rücken,,0.000011,2,0,1,1,0,1784,1784,7,0.236364,0.276694,0,0,0
8589441,Am Hang,,0.000026,2,1,2,3,1661,1661,3322,7,0.236994,0.296051,16.307143,0,0
8589445,Bluttrainweg,,0.000034,2,1,2,3,3506,3506,7012,7,0.237838,0.293669,804,0,0
8589449,Dominikushaus,,0.000038,2,1,1,2,1784,1784,3568,7,0.22905,0.270441,82,0,0
8589359,Schorenweg,,0.000047,2,3,1,4,11626,11626,23252,9,0.19802,0.228085,240.276299,0,0
8589374,Kleinhüningeranlage,,0.00004,2,2,2,4,8407,8276,16683,9,0.204082,0.265175,307.067444,0,0
8589378,Winkelriedplatz,,0.000023,2,1,1,2,5706,5706,11412,10,0.169096,0.211303,0,0,0
8589362,Sevogelplatz,,0.000041,2,3,1,4,12152,12152,24304,4,0.384615,0.483333,240.571429,0,0
8589452,Friedhof am Hörnli,,0.00014,2,8,3,11,14152,14151,28303,6,0.289855,0.363333,1524.812317,0,0
8589454,Gotenstrasse,,0.000122,2,4,4,8,10050,10050,20100,6,0.295455,0.383333,2069.578062,0,0
8589456,Habermatten,,0.000141,2,5,7,12,20078,20078,40156,5,0.358491,0.466228,3817.687368,0,0
8589385,Bettingen Dorf,,0.000064,2,3,2,5,1661,6456,8117,8,0.206294,0.254923,1750,0,0
8589386,Altes Zollhaus,,0.000038,2,1,1,2,3401,3401,6802,8,0.203509,0.242077,0,0,0
8589389,Diakonissenhaus,,0.000033,2,1,1,2,3343,3343,6686,8,0.196364,0.229145,54,0,0
8589388,Chrischonaklinik,,0.000026,2,1,1,2,3343,3343,6686,9,0.166667,0.194401,253,0,0
8589393,Spiegelfeld,,0.000019,2,1,1,2,8198,8198,16396,9,0.169811,0.197626,536.5,0,0
8589394,Zeigerweg,,0.000027,2,1,1,2,8198,8198,16396,8,0.200758,0.233603,333.5,0,0
8589395,Bären,,0.000069,2,3,1,4,11851,11851,23702,5,0.333333,0.421429,900.044322,0,0
8589396,Birsfelden Hard,,0.00007,2,1,1,2,11851,11851,23702,4,0.428571,0.513889,644.044322,0,0
8592442,Morgartenring,,0.000215,2,8,2,10,24570,11722,36292,2,0.75,0.833333,422.660223,0,0
8589422,Liestal Heidenloch,,0.000059,2,1,2,3,23903,23903,47806,5,0.375,0.503704,45,0,0
8589423,Liestal Industriestrasse,,0.000051,2,3,2,5,24583,24583,49166,5,0.363636,0.504167,217.833333,0,0
8589407,Füllinsdorf Niederschönthal,,0.000132,2,6,2,8,48599,26219,74818,6,0.310345,0.461111,677.278571,0,0
8589408,Obere Hofackerstrasse,,0.00008,2,2,1,3,9308,9135,18443,1,1,1,136,0,0
8589411,Lausen Bahnhof Nord,,0.000043,2,3,1,4,23903,23903,47806,10,0.166667,0.249461,520,0,0
8589412,Lausen Bettleten,,0.000032,2,1,1,2,17174,17174,34348,3,0.5,0.611111,489,0,0
8589413,Lausen Furlen,,0.000039,2,1,1,2,17174,17174,34348,2,0.666667,0.75,328,0,0
8589414,Lausen Furlenboden,,0.000044,2,1,1,2,17174,17174,34348,1,1,1,165,0,0
8589415,Lausen Gemeindeverwaltung,,0.000047,2,1,1,2,23903,23903,47806,9,0.185714,0.268254,429,0,0
8589416,Lausen Kirchstrasse,,0.000051,2,1,1,2,23903,23903,47806,8,0.210526,0.29256,336,0,0
8589418,Lausen Stutz,,0.000054,2,1,1,2,23903,23903,47806,7,0.244444,0.326623,241,0,0
8589419,Liestal Elektra,,0.000067,2,1,1,2,17084,17084,34168,5,0.315789,0.422222,318,0,0
8589420,Liestal Fraumatt,,0.000068,2,1,1,2,17084,17084,34168,4,0.384615,0.483333,187,0,0
8589421,Liestal Hallenbad,,0.000057,2,1,1,2,23903,23903,47806,6,0.294118,0.381667,144,0,0
8589425,Liestal Kessel,,0.000069,2,1,1,2,17084,11922,29006,3,0.5,0.583333,54,0,0
8594336,Liestal Schildareal,,0.000131,2,5,1,6,40377,16447,56824,3,0.5,0.583333,430.257143,0,0
8589429,"Rheinfelden, Alte Saline",,0.000037,2,2,2,4,7329,7343,14672,4,0.454545,0.616667,35,0,0
8589434,"Rheinfelden, Parkresort",,0.000026,2,1,1,2,7221,7221,14442,4,0.4,0.520833,0,0,0
8589435,"Rheinfelden, Reha",,0.000049,2,2,1,3,7343,7343,14686,3,0.5,0.611111,27,0,0
8589436,"Rheinfelden, Spitalhalde",,0.000052,2,1,1,2,7343,7315,14658,2,0.666667,0.75,20,0,0
8589437,"Rheinfelden, Spitaltreppe",,0.000055,2,1,1,2,7315,7221,14536,1,1,1,11,0,0
8589451,Fondation Beyeler,,0.000041,2,1,2,3,13986,14012,27998,6,0.273973,0.332917,425.480952,0,0
8589455,Riehen Grenze,,0.000029,2,1,1,2,11038,11040,22078,6,0.268966,0.315812,0,0,0
8589444,Bettingerstrasse,,0.000099,2,7,3,10,19329,19327,38656,8,0.226804,0.301272,2302.308404,0,0
8589446,Burgstrasse,,0.000039,2,1,1,2,14013,14014,28027,8,0.199074,0.23541,0,0,0
8589462,Hungerbachhalde,,0.000024,2,1,1,2,3519,3519,7038,4,0.333333,0.393939,28,0,0
8589447,Chrischonaweg,,0.000025,2,1,1,2,1784,1784,3568,9,0.162879,0.194278,538,0,0
8589448,Dinkelbergstrasse,,0.000032,2,1,1,2,1784,1784,3568,8,0.190045,0.223583,311,0,0
8589450,Riehen Dorf,,0.000072,2,2,2,4,18052,18024,36076,7,0.242775,0.296315,1042.618315,0,0
8589453,Gänshaldenweg,,0.000041,2,1,1,2,4038,4557,8595,9,0.230769,0.311326,111.137363,0,0
8589457,Haidweg,,0.000028,2,1,1,2,892,892,1784,5,0.275862,0.333333,0,0,0
8589460,Hörnli Grenze,,0.000117,2,5,4,9,12725,624,13349,4,0.470588,0.567708,2937.146455,0,0
8589465,Inzlinger Zoll,,0.000043,2,1,1,2,1722,1722,3444,5,0.275862,0.333333,62,0,0
8589471,Mühlestieg,,0.00013,2,2,3,5,8475,8475,16950,3,0.461538,0.555556,128.405144,0,0
8589467,Lörracherstrasse,,0.000028,2,1,1,2,11040,11040,22080,5,0.275,0.342424,0,0,0
8589458,Hinter Gärten,,0.000063,2,2,4,6,6279,6279,12558,8,0.2875,0.442184,1915.515207,0,0
8589474,Otto Wenk-Platz,,0.000171,2,3,4,7,15020,9831,24851,3,0.588235,0.683333,1264.899555,0,0
8589476,Rotengraben,,0.000036,2,1,2,3,3519,3519,7038,3,0.5,0.574074,194.927365,0,0
8589477,Morystrasse,,0.000047,2,1,1,2,3506,3506,7012,4,0.391304,0.453704,0,0,0
8589479,Schmiedgasse,,0.000116,2,4,3,7,7735,7735,15470,3,0.571429,0.666667,395.518895,0,0
8589459,Hohlweg,,0.000024,2,1,1,2,1722,1722,3444,8,0.169643,0.228759,872,0,0
8589473,Bahnhof Niederholz,,0.000116,2,4,1,5,14843,14812,29655,4,0.392857,0.44697,101.071402,0,0
8589468,Martinsrain,,0.00006,2,2,2,4,4795,4795,9590,3,0.454545,0.533333,553.690089,0,0
8589480,Steingrubenweg,,0.000073,2,3,3,6,4557,4557,9114,3,0.625,0.766667,271.523366,0,0
8589461,Hinterengeli,,0.000032,2,1,1,2,1722,1722,3444,7,0.193548,0.250794,604,0,0
8589464,In der Au,,0.000038,2,1,1,2,1722,1722,3444,6,0.226667,0.282353,334,0,0
8589466,Lachenweg,,0.000139,2,5,2,7,8475,8475,16950,4,0.357143,0.438889,968.405144,0,0
8589470,Moosrain,,0.00007,2,1,1,2,1784,1784,3568,4,0.333333,0.391026,13,0,0
8589469,Mohrhaldenstrasse,,0.00007,2,1,1,2,1784,1784,3568,5,0.264151,0.321429,293,0,0
8589472,Niederholzboden,,0.000052,2,2,1,3,14014,14014,28028,4,0.344828,0.408333,778,0,0
8589481,Talmattstrasse,,0.000118,2,4,2,6,6456,6456,12912,3,0.571429,0.708333,748.419395,0,0
8589483,Wasserstelzen,,0.000044,2,1,1,2,3506,3506,7012,1,1,1,15.868402,0,0
8589487,Rudolf Wackernagel-Str.,,0.000221,2,2,1,3,6630,4450,11080,1,1,1,42.070137,0,0
8589484,Webergässchen,,0.000082,2,2,1,3,4038,3519,7557,3,0.5,0.611111,4.166667,0,0
8589482,Tiefweg,,0.000117,2,3,1,4,4969,4969,9938,2,0.666667,0.75,186.355504,0,0
8589486,Wenkenhof,,0.00013,2,2,1,3,6456,1661,8117,2,0.666667,0.75,159.714633,0,0
8589491,"Balerna, Prada",,0.000052,99,1,1,2,6164,6776,12940,3,0.5,0.611111,453,0,0
8589492,"Balerna, S. Antonio",,0.000055,99,1,1,2,6776,6776,13552,2,0.666667,0.75,304,0,0
8589493,"Balerna, Via Motta",,0.000058,99,1,1,2,6776,6776,13552,1,1,1,153,0,0
8589502,"Morbio Inferiore, Pascuritt",,0.000039,99,2,2,4,14730,14730,29460,3,0.571429,0.708333,99.969481,0,0
8589505,"Vacallo, Cimitero",,0.000062,99,1,1,2,6632,3423,10055,3,0.5,0.583333,16,0,0
8591489,"Chiasso, Via Guisan",,0.000073,99,2,1,3,13654,6827,20481,3,0.5,0.583333,16,0,0
8591495,"Mendrisio, S. Giovanni",,0.000145,99,1,4,5,57884,50126,108010,3,0.615385,0.729167,844,0,0
8591505,"Seseglio, Villette",,0.000102,99,1,1,2,8601,3921,12522,3,0.5,0.583333,8,0,0
8589499,"Morbio Inferiore, Campo Sport.",,0.000072,99,3,1,4,6135,6632,12767,11,0.163636,0.233335,235.2,0,0
8589501,"Morbio Inferiore, Ghitello",,0.000129,99,4,1,5,33098,33457,66555,9,0.213333,0.294072,801.666667,0,0
8594180,"Chiasso, Via Franscini",,0.000297,99,7,2,9,43728,16102,59830,2,0.75,0.833333,474.530519,0,0
8589506,"Vacallo, Letra",,0.000039,99,2,1,3,6816,7393,14209,5,0.321429,0.401852,376.5,0,0
8591729,"Jona, Grüt",,0.000022,67,1,1,2,14049,14019,28068,6,0.259259,0.37381,36,0,0
8591734,"Jona, Lenggiserstrasse",,0.000045,67,1,1,2,14203,14202,28405,4,0.357143,0.466667,30,0,0
8589516,"Kandersteg, Gemmi",,0.00003,43,1,1,2,4786,4786,9572,5,0.333333,0.456667,265,0,0
8589517,"Kandersteg, Pfadizentrum",,0.000036,43,1,1,2,4786,4786,9572,4,0.4,0.520833,216,0,0
8589518,"Kandersteg, Simplon",,0.000042,43,1,1,2,4786,4786,9572,3,0.5,0.611111,165,0,0
8589519,"Kandersteg, Ruedi Hus",,0.000046,43,1,1,2,4786,4786,9572,2,0.666667,0.75,112,0,0
8589520,"Kandersteg, Hüttentürli",,0.00005,43,1,1,2,4786,4786,9572,1,1,1,57,0,0
8589533,"Gossau SG, Kühlhausstrasse",,0.000026,71,1,1,2,48140,48136,96276,15,0.119302,0.141558,1860,0,0
8589535,"Gossau SG, Coop BZ",,0.000025,71,1,1,2,39527,39527,79054,13,0.15125,0.177824,848,0,0
8589538,"St. Margrethen SG, Central",,0.000032,73,1,1,2,11402,11402,22804,3,0.5,0.611111,306,0,0
8589539,"St. Margrethen SG, Äueli",,0.000038,73,1,1,2,11402,11402,22804,2,0.666667,0.75,206,0,0
8589540,"Rheineck, Brüggershofstrasse",,0.000043,73,1,1,2,11402,11402,22804,1,1,1,104,0,0
8589544,"Schwanden GL, Schulhausstrasse",,0.000051,128,1,1,2,5419,1933,7352,2,0.666667,0.75,282,0,0
8589546,"Schwändi b. Schwanden GL, Lassigen",,0.000054,128,1,1,2,1933,2002,3935,1,1,1,142,0,0
8589562,"St. Gallen, Boppartshof",,0.000044,71,2,3,5,41744,41744,83488,13,0.19186,0.244757,3425.558206,0,0
8589571,"St. Gallen, Flurhof",,0.000029,71,1,1,2,24535,24535,49070,14,0.160389,0.191505,132,0,0
8589572,"St. Gallen, Friedberg",,0.000098,71,5,3,8,50003,50002,100005,13,0.18958,0.242242,1964.590554,0,0
8589555,"St. Gallen, Bachstrasse",,0.000055,71,5,2,7,77449,84746,162195,13,0.174545,0.207873,2775.855729,0,0
8589559,"St. Gallen, Berneggstrasse",,0.000042,71,2,1,3,44810,44814,89624,15,0.131336,0.154492,784.414286,0,0
8589576,"St. Gallen, Geltenwilenstrasse",,0.000074,71,3,4,7,49935,50002,99937,13,0.193496,0.256906,2205.225859,0,0
8589580,"St. Gallen, Guggeien",,0.000038,71,1,2,3,41261,41261,82522,13,0.183706,0.231373,922.256908,0,0
8589581,"St. Gallen, Hagenbuch",,0.000035,71,2,2,4,24535,24535,49070,13,0.184295,0.231808,66.125397,0,0
8589592,"St. Gallen,Klinik Stephanshorn",,0.000048,71,2,2,4,40302,40302,80604,13,0.184692,0.234821,54,0,0
8589582,"St. Gallen, Haggen",,0.000063,71,4,5,9,66480,66470,132950,12,0.217143,0.287358,2701.911333,0,0
8589590,"St. Gallen, Industriestrasse",,0.000051,71,3,3,6,15886,15920,31806,11,0.19395,0.239206,4296.929504,0,0
8589593,"St. Gallen, Kräzern",,0.000044,71,2,2,4,40270,40347,80617,13,0.184255,0.234683,429.106274,0,0
8589567,"St. Gallen, Bruggwiesen",,0.000021,71,1,1,2,24495,24535,49030,15,0.139121,0.161858,634,0,0
8589569,"St. Gallen, Dietlistrasse",,0.000039,71,4,3,7,41843,41802,83645,12,0.19062,0.235246,1793.092096,0,0
8589574,"St. Gallen, Gallusmarkt",,0.000065,71,4,2,6,68806,68749,137555,13,0.180636,0.226334,2056.290343,0,0
8589598,"St. Gallen, Melonenstrasse",,0.000025,71,2,2,4,46979,46979,93958,13,0.175768,0.221918,5720.384314,0,0
8589575,"St. Gallen, Uni/Gatterstrasse",,0.000058,71,3,3,6,38584,38597,77181,12,0.188034,0.238453,2950.071089,0,0
8589584,"St. Gallen, Harzbüchelstrasse",,0.000034,71,1,2,3,19989,19989,39978,12,0.183362,0.221433,108,0,0
8589603,"St. Gallen, Obere Leimat",,0.000029,71,2,2,4,46361,46361,92722,12,0.194286,0.243986,1714.541109,0,0
8589611,"St. Gallen, Rosenbergstrasse",,0.000173,71,12,9,21,145132,145147,290279,10,0.261494,0.364046,33513.182389,0,0
8589583,"St. Gallen, Halden",,0.000052,71,3,3,6,48817,48817,97634,12,0.206767,0.269373,435.022344,0,0
8589601,"St. Gallen, Mühlegg",,0.000054,71,1,1,2,44814,44814,89628,13,0.174359,0.214289,152.090476,0,0
8589577,"St. Gallen, Goethestrasse",,0.000027,71,1,1,2,19989,19989,39978,13,0.15616,0.181717,644,0,0
8589579,"St. Gallen, Grütlistrasse",,0.000094,71,5,3,8,81797,81808,163605,13,0.191104,0.250766,6190.998966,0,0
8589588,"St. Gallen, Hüttenwies",,0.000037,71,2,3,5,41251,41325,82576,12,0.201439,0.261739,314.464857,0,0
8589616,"St. Gallen, Ruhsitz",,0.00007,71,1,4,5,50002,50002,100004,11,0.217949,0.286905,1333.178305,0,0
8589617,"St. Gallen, Saturn",,0.000064,71,3,3,6,41261,41261,82522,12,0.184579,0.249106,3309.946915,0,0
8589618,"St. Gallen, Schachenbüel",,0.000026,71,1,3,4,48817,48817,97634,11,0.215938,0.27972,4,0,0
8589620,"St. Gallen, Schibenertor",,0.00011,71,6,8,14,68983,68869,137852,10,0.256966,0.357253,10046.517396,0,0
8589589,"St. Gallen, Iddastrasse",,0.000048,71,2,1,3,19989,19989,39978,13,0.172638,0.208337,627.590061,0,0
8589591,"St. Gallen, Kirche St. Georgen",,0.000051,71,2,1,3,44810,44814,89624,14,0.149709,0.177563,693.090476,0,0
8589610,"St. Gallen, Riederenholz",,0.000075,71,3,3,6,8217,128,8345,11,0.211443,0.273619,2683.381661,0,0
8589621,"St. Gallen, Schlössli",,0.00009,71,6,4,10,66472,66406,132878,12,0.202073,0.276964,4245.191296,0,0
8589622,"St. Gallen, Schönenwegen",,0.000081,71,4,4,8,82517,82446,164963,11,0.21875,0.295713,3636.54241,0,0
8589625,"St. Gallen, Singenberg",,0.000118,71,7,1,8,129139,129139,258278,12,0.179931,0.231213,354.849507,0,0
8589595,"St. Gallen, Lachen",,0.000108,71,6,1,7,82449,82451,164900,12,0.191489,0.230225,1930.736751,0,0
8589602,"St. Gallen, Nussbaumstrasse",,0.000019,71,1,1,2,11420,11420,22840,6,0.289474,0.369697,1651.703388,0,0
8589613,"St. Gallen, Rotmonten",,0.000086,71,5,4,9,84959,84958,169917,11,0.210784,0.276638,3772.387083,0,0
8589626,"St. Gallen, Sonne",,0.000089,71,3,3,6,75637,75637,151274,12,0.197708,0.271607,2164.202273,0,0
8589628,"St. Gallen, Sporthalle",,0.000059,71,3,2,5,66298,66298,132596,12,0.188732,0.248141,3813.955837,0,0
8589615,"St. Gallen, Ruhbergstrasse",,0.000049,71,2,2,4,46979,45729,92708,11,0.208333,0.262246,586.555763,0,0
8589619,"St. Gallen, Scheidweg",,0.000027,71,1,1,2,40269,40347,80616,12,0.181395,0.223489,0,0,0
8589641,"St. Gallen, Waldacker",,0.000056,71,1,2,3,66298,66298,132596,10,0.212389,0.302298,52.666667,0,0
8589898,"St. Gallen, Bernhardswies",,0.000079,71,1,2,3,25276,25276,50552,10,0.225806,0.31566,3874.833333,0,0
8589634,"St. Gallen, Talstrasse",,0.000029,71,1,2,3,19989,19989,39978,6,0.333333,0.475926,579.418881,0,0
8589614,"St. Gallen, Ruckhalde",,0.00007,71,3,1,4,50002,50002,100004,12,0.180672,0.218744,2165.178305,0,0
8589645,"St. Gallen, Wilen",,0.000046,71,1,2,3,48817,48817,97634,12,0.174603,0.250795,53.1,0,0
8589623,"St. Gallen, Schoren",,0.000057,71,3,2,5,41843,37887,79730,13,0.171569,0.230748,2361.02435,0,0
8589624,"St. Gallen, Seeblick",,0.00005,71,2,1,3,23353,23353,46706,13,0.167064,0.210646,216.53393,0,0
8589635,"St. Gallen, Tigerberg",,0.000067,71,3,2,5,30704,30704,61408,5,0.380952,0.514583,559.392707,0,0
8589631,"St. Gallen, Stephanshorn",,0.000041,71,1,2,3,40300,40238,80538,13,0.155709,0.217495,138.831746,0,0
8589629,"St. Gallen, St. Fiden Zentrum",,0.000142,71,3,4,7,130609,129307,259916,11,0.21519,0.307019,4051.934921,0,0
8589638,"St. Gallen, Untere Kräzern",,0.00005,71,1,1,2,40347,40347,80694,11,0.196347,0.250961,78,0,0
8589627,"St. Gallen, Sonnenhalde",,0.000036,71,1,1,2,46361,46361,92722,1,1,1,929,0,0
8589632,"St. Gallen, Stocken",,0.000046,71,2,1,3,40270,40347,80617,12,0.1673,0.208857,968,0,0
8589643,"St. Gallen, Waldgutstrasse",,0.000088,71,4,2,6,38584,29276,67860,5,0.388889,0.540476,2510.525012,0,0
8589639,"St. Gallen, Vogelherd",,0.000041,71,1,1,2,48817,48817,97634,13,0.152466,0.207317,952.1,0,0
8589640,"St. Gallen, Vonwil",,0.000054,71,2,1,3,66298,66298,132596,11,0.181159,0.244557,963.666667,0,0
8589647,"St. Gallen, Winkelriedstrasse",,0.000077,71,2,2,4,30704,20705,51409,4,0.461538,0.597222,242.558988,0,0
8589903,"St. Gallen, Solitüdenstrasse",,0.000033,71,2,1,3,10334,10334,20668,4,0.4,0.520833,3553.228571,0,0
8589650,Adligenswil Dorf,,0.000028,90,2,1,3,17883,17935,35818,18,0.118078,0.147565,1177,0,0
8589652,Adligenswil Luegisland,,0.000035,90,1,1,2,17935,17935,35870,17,0.132964,0.172901,1236,0,0
8589655,Buchrain Dorf,,0.000045,90,4,1,5,39062,38945,78007,16,0.101429,0.116882,777,0,0
8589656,Buchrain Kirchbreite,,0.000049,90,1,1,2,38945,39064,78009,15,0.112083,0.129268,659,0,0
8589657,Buchrain Ronstrasse,,0.000053,90,1,1,2,39064,39063,78127,14,0.125336,0.146058,539,0,0
8589659,Ebikon Gerbe,,0.000071,90,3,1,4,15629,15629,31258,16,0.101284,0.116295,441,0,0
8589661,Ebikon Hartenfels,,0.000071,90,1,1,2,15629,15628,31257,15,0.111905,0.128322,494,0,0
8589662,Ebikon Höchweid,,0.000071,90,1,1,2,15628,15575,31203,14,0.125112,0.144273,545,0,0
8589666,Ebikon Mühlegg,,0.000039,90,1,1,2,15629,15629,31258,11,0.169388,0.189817,2418.456349,0,0
8589667,Ebikon Ottigenbühl,,0.000044,90,1,1,2,15629,15629,31258,10,0.201474,0.226762,2225.456349,0,0
8589670,Emmenbrücke Viscosistadt,,0.000032,90,1,1,2,63362,63356,126718,11,0.1625,0.185593,5692.333333,0,0
8589673,Horw Biregghof,,0.000019,90,2,1,3,60509,61983,122492,10,0.2,0.22879,69,0,0
8589674,Horw Buholz,,0.000027,90,1,2,3,16692,17044,33736,14,0.118787,0.140886,867,0,0
8589675,Kastanienbaum Dorni,,0.000022,90,1,1,2,13678,13537,27215,14,0.118044,0.13475,0,0,0
8589677,Horw Felmis,,0.000041,90,2,1,3,16903,17044,33947,13,0.132887,0.153158,567,0,0
8589679,Horw Bahnhof,,0.000066,90,3,3,6,62716,49181,111897,12,0.160047,0.198581,2954.625,0,0
8589681,Horw Kirchweg,,0.000092,90,3,3,6,61427,60662,122089,16,0.138398,0.193487,8480.257143,0,0
8589688,Horw Spier,,0.000042,90,1,2,3,34980,34979,69959,10,0.192575,0.226783,380,0,0
8589693,Horw Technikumstrasse,,0.000029,90,1,1,2,17452,19059,36511,10,0.190698,0.217354,0,0,0
8589682,"Kastanienbaum, Krämerstein",,0.000037,90,1,1,2,16904,17043,33947,16,0.092954,0.107319,2424,0,0
8589683,Kastanienbaum Kreuzmatt,,0.000042,90,1,1,2,17043,16901,33944,15,0.101653,0.116045,2250,0,0
8589684,"St. Niklausen LU, Langensand",,0.000047,90,1,1,2,16901,16901,33802,14,0.112236,0.126886,2074,0,0
8589685,St. Niklausen LU Mättiwil,,0.000051,90,1,1,2,16901,16903,33804,13,0.125389,0.140737,1896,0,0
8589687,Horw Rank,,0.000037,90,1,1,2,34978,34980,69958,11,0.163107,0.186872,594,0,0
8589689,"St. Niklausen LU, Unterwil",,0.000054,90,1,1,2,16903,16903,33806,12,0.14218,0.159111,1716,0,0
8589690,Horw Stegen/Kirchfeld,,0.000057,90,1,1,2,16903,16904,33807,11,0.164365,0.184814,1534,0,0
8589691,Horw Steinen,,0.00003,90,1,1,2,10240,11339,21579,13,0.135934,0.157996,294,0,0
8589692,"St. Niklausen LU, Stutz",,0.000059,90,1,1,2,16904,16788,33692,10,0.195041,0.223931,1350,0,0
8589725,"Kriens, Zentrum Pilatus",,0.000143,90,5,5,10,140090,138464,278554,9,0.243961,0.304813,9206.439683,0,0
8589731,Kriens Oberkuonimatt,,0.000061,90,2,1,3,38092,38298,76390,10,0.196388,0.227016,372.777778,0,0
8589698,Kriens Bachstrasse,,0.000023,90,1,1,2,3481,3481,6962,6,0.285714,0.408333,506,0,0
8589699,Kriens Bergstrasse,,0.000049,90,1,1,2,7139,7139,14278,18,0.081678,0.105594,2760,0,0
8589700,Kriens Dattenberg,,0.000021,90,2,1,3,18410,18757,37167,9,0.235915,0.269231,170.166667,0,0
8589701,Kriens Dattenbergrain,,0.000053,90,1,1,2,7139,7139,14278,17,0.08774,0.111309,2557,0,0
8589703,Kriens Ehrendingen,,0.000056,90,1,1,2,7139,7139,14278,16,0.094862,0.118111,2352,0,0
8589704,Kriens Eichenspes,,0.000058,90,1,1,2,7139,7139,14278,15,0.103348,0.126367,2145,0,0
8589711,Kriens Grossfeldstrasse,,0.00006,90,4,2,6,17146,17138,34284,11,0.180937,0.21751,1585.961905,0,0
8589706,Kriens Gabeldingen,,0.00006,90,1,1,2,7139,7139,14278,14,0.113636,0.136647,1936,0,0
8589707,Kriens Gabeldingen Schulhaus,,0.000062,90,1,1,2,7139,7139,14278,13,0.126374,0.149909,1725,0,0
8589709,Kriens Gemeindehaus,,0.000064,90,1,1,2,7139,7139,14278,12,0.142558,0.16805,1512,0,0
8589712,Kriens Grosshofstrasse,,0.000072,90,4,3,7,136568,136485,273053,10,0.207547,0.248153,5378.344841,0,0
8589714,Kriens Himmelrichstrasse,,0.00005,90,1,2,3,7315,7316,14631,11,0.179153,0.213889,208.166667,0,0
8589721,Kriens Kriens Mattenhof,,0.000069,90,3,2,5,11396,11329,22725,10,0.196629,0.225389,450,0,0
8589713,Kriens Guetrüti,,0.000046,90,2,1,3,7316,7315,14631,12,0.153103,0.176119,408.166667,0,0
8589716,Kriens Johanneskirche,,0.000038,90,2,1,3,10645,10648,21293,11,0.175698,0.201195,497.813095,0,0
8589718,Kriens Kirchbühl,,0.000024,90,1,1,2,3481,3481,6962,11,0.175698,0.201195,168.708333,0,0
8589722,Kriens Kuonimatt,,0.00004,90,1,1,2,11275,11337,22612,11,0.166397,0.188612,15,0,0
8589717,Kriens Josef Schryberstrasse,,0.00003,90,1,1,2,3481,3481,6962,5,0.333333,0.456667,258,0,0
8589719,Kriens Klösterli,,0.000037,90,1,1,2,3481,3481,6962,4,0.4,0.520833,8,0,0
8589726,Kriens Nidfeld,,0.00006,90,2,2,4,29498,29487,58985,9,0.238482,0.273949,2250.68254,0,0
8589745,Kriens Wiggenhof,,0.000046,90,1,2,3,38259,38240,76499,9,0.240469,0.277618,201.25,0,0
8589727,Kriens Obere Dattenbergstrasse,,0.000065,90,1,2,3,7139,7139,14278,11,0.163814,0.196844,1297,0,0
8589728,Kriens Obere Weinhalde,,0.000039,90,1,1,2,3483,3483,6966,11,0.161765,0.184675,0,0,0
8589729,Kriens Oberhusrain,,0.000071,90,2,1,3,7139,7139,14278,10,0.190058,0.21583,861,0,0
8589730,Kriens Oberhusweg,,0.000072,90,1,1,2,7139,7139,14278,9,0.231047,0.265334,640,0,0
8589732,Kriens Pilatus-Bahnen,,0.000066,90,2,1,3,6961,3481,10442,3,0.5,0.611111,1044,0,0
8589735,Kriens Rosenstrasse,,0.000032,90,1,1,2,11259,11337,22596,12,0.146299,0.166471,0,0,0
8589740,Kriens Sportweg,,0.000059,90,2,1,3,20647,20657,41304,11,0.169355,0.192834,84,0,0
8589734,Kriens Roggernhalde,,0.000035,90,1,1,2,7316,7112,14428,1,1,1,345,0,0
8589809,Luzern Lützelmattstrasse,,0.000047,90,1,3,4,31067,31073,62140,7,0.272059,0.340154,104.5,0,0
8589810,Luzern Maihofmatte-Rotsee,,0.000101,90,4,3,7,101446,101498,202944,7,0.27907,0.376091,2642.38489,0,0
8589746,Kriens Zumhof,,0.000033,90,1,1,2,3651,3656,7307,1,1,1,0,0,0
8589738,Kriens Senti,,0.000067,90,1,1,2,3481,3481,6962,2,0.666667,0.75,698,0,0
8589741,Kriens St. Niklausengasse,,0.000068,90,1,1,2,3481,3481,6962,1,1,1,350,0,0
8589742,Kriens Sternmatt,,0.000083,90,2,2,4,49342,49600,98942,10,0.201456,0.235289,944,0,0
8589823,Luzern Paulusplatz,,0.000124,90,2,6,8,193555,190782,384337,5,0.446809,0.573016,4582.587729,0,0
8589749,Littau Bahnhof,,0.000046,90,1,1,2,28379,28857,57236,17,0.088485,0.111837,1964,0,0
8589757,Littau Blattenmoos,,0.000057,90,2,1,3,89956,89884,179840,15,0.104412,0.127037,1970,0,0
8589758,Littau Gasshof,,0.000059,90,1,1,2,89884,90009,179893,14,0.114943,0.13735,1767,0,0
8589759,Littau Grenzhof,,0.000061,90,1,1,2,90009,90012,180021,13,0.128015,0.15049,1562,0,0
8589760,Littau Längweiher,,0.000063,90,1,1,2,90012,90012,180024,12,0.144681,0.167869,1355,0,0
8589761,Littau Michaelshof,,0.000064,90,1,1,2,90012,90011,180023,11,0.166667,0.1921,1146,0,0
8589763,Littau Rönnimoosrain,,0.000066,90,1,1,2,90011,90012,180023,10,0.197015,0.22883,935,0,0
8589785,Luzern Friedental,,0.00002,90,1,1,2,57669,57439,115108,10,0.195652,0.22597,223.986905,0,0
8589791,Luzern Urnerhof,,0.000047,90,2,2,4,85817,86125,171942,9,0.239382,0.286258,240.236905,0,0
8589842,Luzern Tiefe,,0.000056,90,1,1,2,48648,162,48810,3,0.5,0.611111,6,0,0
8589768,Luzern Berglistrasse,,0.000026,90,2,2,4,36885,37013,73898,9,0.232975,0.274072,244.666667,0,0
8589789,Luzern Gigeliwald,,0.000022,90,1,1,2,18502,18503,37005,9,0.230216,0.262729,0,0,0
8589773,Luzern Brüggligasse,,0.00002,90,2,2,4,18827,18849,37676,10,0.193452,0.229017,121.083333,0,0
8589771,Luzern Breitenlachen,,0.000049,90,3,1,4,47288,48648,95936,10,0.19898,0.226012,1029.52381,0,0
8589777,Luzern Büttenenhalde,,0.000048,90,1,1,2,39960,39963,79923,9,0.205714,0.236249,150.5,0,0
8589784,Luzern Friedbergstrasse,,0.000025,90,2,1,3,15455,14279,29734,10,0.191045,0.21697,32,0,0
8589776,Luzern Büttenen,,0.000044,90,2,1,3,39953,39960,79913,10,0.172577,0.196314,470.5,0,0
8589782,Luzern Felsberg,,0.000044,90,2,1,3,61969,61972,123941,9,0.229091,0.261609,398,0,0
8589820,Luzern Schulhaus Unterlöchli,,0.000047,90,1,3,4,61930,61967,123897,3,0.529412,0.62963,26.5,0,0
8589788,Luzern Geissmatthöhe,,0.000041,90,2,1,3,17799,18845,36644,9,0.232472,0.2669,191.083333,0,0
8589793,Luzern Gütsch,,0.000074,90,4,1,5,166144,166118,332262,9,0.232472,0.2669,5949.583333,0,0
8589811,Luzern Matthof,,0.000053,90,2,2,4,38479,38485,76964,7,0.276923,0.372751,77.404167,0,0
8589822,Luzern Oberseeburghöhe,,0.000077,90,1,6,7,58292,58290,116582,5,0.457143,0.616667,2362,0,0
8589841,Luzern Sternmatt,,0.000067,90,1,1,2,61976,61978,123954,5,0.333333,0.433333,10.5,0,0
8589802,Luzern Kantonsspital,,0.000074,90,3,3,6,95471,95545,191016,8,0.259615,0.365829,887.810714,0,0
8589797,Luzern Hochhüsliweid,,0.000031,90,1,1,2,17935,17935,35870,4,0.4,0.520833,575.3,0,0
8589813,Luzern Moosegg,,0.000111,90,5,1,6,150308,150301,300609,6,0.318841,0.374242,1547.241667,0,0
8589845,Luzern Wartegg,,0.00015,90,5,2,7,139908,138326,278234,4,0.428571,0.569444,260.375595,0,0
8589846,Luzern Weinbergli,,0.000118,90,4,1,5,153460,152852,306312,3,0.5,0.566667,13,0,0
8589831,Luzern Schlossberg,,0.000114,90,3,2,5,158905,158955,317860,2,0.666667,0.75,597.989286,0,0
8589803,Luzern Kapuzinerweg,,0.000062,90,3,2,5,93008,93042,186050,10,0.174419,0.228325,2742,0,0
8589804,Luzern Kloster,,0.000037,90,1,1,2,61969,61972,123941,5,0.289474,0.354545,924.5,0,0
8589806,Luzern Konservatorium,,0.000037,90,1,1,2,31073,31070,62143,9,0.183099,0.217786,946.5,0,0
8589808,Luzern Leumatt,,0.000042,90,1,1,2,31070,31067,62137,8,0.218391,0.259273,526.5,0,0
8589824,Luzern Reussport,,0.000032,90,1,1,2,57749,57741,115490,4,0.352941,0.444444,8.733333,0,0
8589828,Luzern Rosenberg,,0.000067,90,2,1,3,86120,85802,171922,3,0.454545,0.533333,5.9,0,0
8589812,Luzern Mönchweg,,0.000049,90,2,1,3,48645,48647,97292,5,0.333333,0.456667,914,0,0
8589814,Luzern Morgenweg,,0.000042,90,1,1,2,61972,61930,123902,4,0.37037,0.433333,476.5,0,0
8589816,Luzern Obergütsch,,0.00003,90,1,1,2,34601,34538,69139,6,0.28,0.385714,1371,0,0
8589817,Luzern Obergütschhalde,,0.000036,90,1,1,2,34538,36544,71082,5,0.333333,0.436111,920,0,0
8589818,Luzern Obergütschrain,,0.000042,90,1,1,2,36544,37004,73548,4,0.416667,0.516667,467,0,0
8589819,Luzern Obergütschstrasse,,0.000046,90,1,2,3,37004,34364,71368,3,0.571429,0.708333,12,0,0
8589835,Luzern Sonnenbergstrasse,,0.000056,90,3,2,5,16350,16350,32700,4,0.454545,0.616667,2330,0,0
8589838,Luzern Steinhof,,0.000035,90,1,1,2,13942,13937,27879,4,0.4,0.520833,0,0,0
8589839,Luzern Steinhofrain,,0.000084,90,3,1,4,18507,4816,23323,3,0.5,0.611111,1404,0,0
8589821,Luzern Oberseeburg,,0.000077,90,4,1,5,58287,58292,116579,6,0.326923,0.396078,2808,0,0
8589847,Luzern Werkhofstrasse,,0.000154,90,4,3,7,172515,101521,274036,2,0.8,0.875,1620.624405,0,0
8589826,Luzern Rigistrasse,,0.000053,90,3,1,4,31095,31070,62165,3,0.5,0.611111,1213.7,0,0
8589830,Luzern Schädrütihalde,,0.000037,90,1,1,2,17935,17935,35870,3,0.5,0.611111,196.3,0,0
8589827,Luzern Rodtegg,,0.000066,90,3,1,4,61966,61976,123942,6,0.275862,0.372917,464.5,0,0
8589836,Luzern St. Karli,,0.00008,90,2,1,3,95252,57672,152924,2,0.6,0.666667,116.444048,0,0
8589832,Luzern Schlösslihalde,,0.000087,90,2,1,3,49005,31044,80049,2,0.666667,0.75,944,0,0
8589833,Luzern Schlösslirain,,0.000085,90,1,1,2,31044,31072,62116,1,1,1,473,0,0
8589834,Luzern Seeburg-Schifflände,,0.000059,90,2,1,3,31730,135,31865,2,0.666667,0.75,798,0,0
8589837,Luzern Steghof,,0.000053,90,1,1,2,48647,48648,97295,4,0.4,0.520833,461,0,0
8589840,Luzern Steinhofstrasse,,0.000102,90,2,1,3,37018,37014,74032,2,0.666667,0.75,946,0,0
8589843,Luzern Untergütsch,,0.000097,90,1,1,2,37014,37017,74031,1,1,1,474,0,0
8589850,Luzern Würzenbachmatte,,0.000067,90,1,1,2,38711,36903,75614,1,1,1,1,0,0
8589849,Luzern Würzenbach,,0.000065,90,2,1,3,38676,38711,77387,2,0.666667,0.75,472,0,0
8589852,Luzern Zihlmattweg,,0.000096,90,3,1,4,43757,81,43838,2,0.666667,0.75,938,0,0
8589855,Meggen Buchmatt,,0.000022,90,1,1,2,18383,18383,36766,4,0.4,0.520833,1856,0,0
8589856,Meggen Englischer Friedhof,,0.000029,90,1,1,2,18383,18383,36766,3,0.5,0.611111,1395,0,0
8589857,Meggen Hochrüti,,0.000036,90,1,1,2,18383,18383,36766,2,0.666667,0.75,932,0,0
8589858,Meggen Klösterli,,0.000041,90,1,1,2,18383,18383,36766,1,1,1,467,0,0
8589861,Reussbühl Fluhmühle,,0.00006,90,2,1,3,104991,104991,209982,2,0.666667,0.75,932,0,0
8589862,Reussbühl Schiff,,0.000062,90,1,1,2,104991,104991,209982,1,1,1,467,0,0
8589868,"Brissago, Cò di Campo",,0.000029,101,1,1,2,13747,13747,27494,9,0.188889,0.271055,1264.633333,0,0
8591527,"Ascona, Parco dei Poeti",,0.000046,101,1,1,2,20789,20655,41444,9,0.188889,0.271055,395.2,0,0
8589871,"Goldau, Waage",,0.000064,91,2,1,3,6125,8989,15114,4,0.4,0.520833,1384.5,0,0
8589872,"Goldau, Buosingen Camping",,0.000065,91,1,1,2,8989,8989,17978,3,0.5,0.611111,1026.5,0,0
8589873,"Goldau, Bernerhöhe",,0.000066,91,1,1,2,8989,8989,17978,2,0.666667,0.75,666.5,0,0
8589875,"Altreu, Info Zentrum Witi",,0.00006,127,1,1,2,5825,5825,11650,13,0.108911,0.154117,24042,0,0
8589876,"Altreu, Mitte",,0.000062,127,1,1,2,5825,5825,11650,12,0.118519,0.162877,22798,0,0
8589877,"Selzach, Hexengässli",,0.000064,127,1,1,2,5825,5825,11650,11,0.130252,0.173581,21552,0,0
8589878,"Selzach, Passionsplatz",,0.000065,127,1,1,2,5825,5825,11650,10,0.144928,0.187077,20304,0,0
8589879,"Selzach, Pfarreizentrum",,0.000066,127,1,1,2,5825,5825,11650,9,0.163842,0.204789,19054,0,0
8589880,"Selzach, Bäriswil",,0.000067,127,1,1,2,5825,5825,11650,8,0.189189,0.229337,17802,0,0
8589881,"Lommiswil, Bahnhofstrasse",,0.000068,127,1,1,2,5825,5825,11650,7,0.225,0.266138,16548,0,0
8589882,"Lommiswil, Kirche",,0.000069,127,1,1,2,5825,5630,11455,6,0.27957,0.328846,15292,0,0
8594106,"Grenchen, Sunnepark Nord",,0.000056,127,1,2,3,12655,12655,25310,5,0.345238,0.403448,264.833333,0,0
8594117,"Grenchen, Girardstrasse",,0.00013,127,7,7,14,49994,44413,94407,4,0.424242,0.535714,986.244228,0,0
8594119,"Grenchen, Gummenweg",,0.000027,127,1,2,3,25076,25076,50152,5,0.3375,0.39321,0,0,0
8589886,"Härkingen, Briefzentrum",,0.000039,94,1,2,3,14387,14387,28774,1,1,1,160,0,0
8589887,"Härkingen, Lischmatte",,0.000027,94,1,1,2,8437,8437,16874,1,1,1,0,0,0
8589888,"Schöftland Nordweg, Bahnhof",,0.00005,94,1,1,2,6256,6026,12282,1,1,1,244,0,0
8589891,"Sargans, Stadterwingert",,0.000044,73,1,1,2,6849,6849,13698,1,1,1,548,0,0
8589894,"Weite, Weitegartenweg",,0.00013,73,2,3,5,22929,22929,45858,8,0.285714,0.430283,22094.795331,0,0
8591775,"Räfis, Weidweg",,0.000055,73,1,1,2,17239,17239,34478,8,0.244898,0.337599,24,0,0
8589897,"St. Gallen, Hechtacker",,0.00008,71,4,1,5,25266,25276,50542,11,0.189542,0.249331,4790.833333,0,0
8589899,"St. Gallen, Walserstrasse",,0.000045,71,1,1,2,25148,25148,50296,4,0.4,0.520833,2838,0,0
8589900,"St. Gallen, Rickenweg",,0.000049,71,1,1,2,25148,25148,50296,3,0.5,0.611111,1895,0,0
8589901,"St. Gallen, Hinterbergstrasse",,0.000052,71,1,1,2,25148,25148,50296,2,0.666667,0.75,950,0,0
8589902,"St. Gallen, Hinterberg",,0.000055,71,1,1,2,25148,25148,50296,1,1,1,3,0,0
8594387,"St. Gallen, Kirche Bruggen",,0.000148,71,3,1,4,91152,128,91280,1,1,1,956,0,0
8589904,"St. Gallen, Fähnernstrasse",,0.000072,71,2,1,3,21042,21042,42084,3,0.5,0.611111,2826,0,0
8589905,"St. Gallen, Hafnerwaldstrasse",,0.000072,71,1,1,2,21042,21042,42084,2,0.666667,0.75,1886,0,0
8589906,"St. Gallen, Oberhofstettenweg",,0.000072,71,1,1,2,21042,21042,42084,1,1,1,944,0,0
8594355,"St. Gallen, Wendeplatz Stocken",,0.000056,71,1,1,2,24726,24726,49452,2,0.666667,0.75,9,0,0
8594356,"St. Gallen, Moos",,0.000067,71,2,1,3,66298,66298,132596,2,0.666667,0.75,5.666667,0,0
8589923,"Bronschhofen, Im Mösli",,0.000059,20,2,1,3,13975,13975,27950,4,0.4,0.520833,680,0,0
8589924,"Bronschhofen, Bildfeld Süd",,0.000061,20,1,1,2,13975,13975,27950,3,0.5,0.611111,513,0,0
8589925,"Bronschhofen, Bildfeld Mitte",,0.000063,20,1,1,2,13975,13975,27950,2,0.666667,0.75,344,0,0
8589926,"Bronschhofen, Bildfeld Nord",,0.000064,20,1,1,2,13975,13975,27950,1,1,1,173,0,0
8589929,"Langenthal, Bäregg",,0.00002,88,1,1,2,13897,13897,27794,6,0.285714,0.408333,207,0,0
8589931,"Langenthal, Elzmatte",,0.000028,88,1,1,2,13897,13897,27794,5,0.333333,0.456667,143,0,0
8589932,"Langenthal, Elzweg",,0.000034,88,1,1,2,13897,13895,27792,4,0.4,0.520833,77,0,0
8589937,"Langenthal, Passhöchi",,0.000079,88,3,1,4,27794,13897,41691,2,0.666667,0.75,148,0,0
8589940,"Langenthal, Schulen Hard",,0.000078,88,1,1,2,13897,13897,27794,1,1,1,75,0,0
8589941,"Langenthal, Schwimmbad",,0.000058,88,1,1,2,13648,13648,27296,5,0.333333,0.456667,370,0,0
8589962,"Biel/Bienne, Räblus Vingelz",,0.000028,87,1,1,2,16317,16319,32636,5,0.315789,0.422222,2490,0,0
8589969,"Vauffelin, Champs-Verlets",,0.000076,87,3,1,4,4243,4243,8486,2,0.666667,0.75,2524,0,0
8589999,Blinzern,,0.000051,44,1,1,2,7577,7577,15154,1,1,1,5,0,0
8589994,Zieglerspital,,0.000025,44,2,1,3,7577,7567,15144,6,0.285714,0.408333,6375,0,0
8589995,Hohliebe,,0.000032,44,1,1,2,7567,7577,15144,5,0.333333,0.456667,5105,0,0
8589996,Spiegel,,0.000038,44,1,1,2,7577,7576,15153,4,0.4,0.520833,3833,0,0
8589997,Steingrubenweg,,0.000043,44,1,1,2,7576,7577,15153,3,0.5,0.611111,2559,0,0
8589998,Weidli,,0.000048,44,1,1,2,7577,7577,15154,2,0.666667,0.75,1283,0,0
8590010,Brunnhof,,0.000071,44,5,2,7,22939,22903,45842,12,0.168776,0.252581,4359.075,0,0
8590013,Munzinger,,0.00005,44,1,1,2,19489,19488,38977,12,0.160173,0.223511,74,0,0
8590011,Cäcilienstrasse,,0.000041,44,1,1,2,19489,19489,38978,14,0.126623,0.172273,2568,0,0
8590012,Pestalozzi,,0.000046,44,1,1,2,19489,19489,38978,13,0.141264,0.192199,1322,0,0
8590022,Schönegg,,0.000077,44,3,1,4,25140,24939,50079,2,0.666667,0.75,1324.25,0,0
8590027,Henkerbrünnli,,0.000065,44,2,1,3,14724,14702,29426,8,0.244444,0.345563,12162.5,0,0
8590028,Bierhübeli,,0.000066,44,1,2,3,14702,14710,29412,7,0.294118,0.442619,10958.5,0,0
8590029,Engeried,,0.000039,44,1,1,2,7107,7107,14214,2,0.666667,0.75,1240.5,0,0
8590030,Brückfeld,,0.000044,44,1,1,2,7107,7107,14214,1,1,1,25.5,0,0
8590032,Rathaus,,0.000044,44,2,1,3,10373,10411,20784,8,0.222222,0.339732,7748,0,0
8590033,Nydegg,,0.000048,44,1,1,2,10411,10411,20822,7,0.25,0.370408,6482,0,0
8590034,Bärenpark,,0.000052,44,1,1,2,10411,10411,20822,6,0.285714,0.408333,5214,0,0
8590035,Liebegg,,0.000055,44,1,1,2,10411,10354,20765,5,0.333333,0.456667,3944,0,0
8590036,Seminar,,0.000058,44,1,1,2,10354,10354,20708,4,0.4,0.520833,2672,0,0
8590037,Tavelweg,,0.00006,44,1,1,2,10354,10287,20641,3,0.5,0.611111,1398,0,0
8590041,Loryplatz,,0.000112,44,4,2,6,54639,54596,109235,5,0.34375,0.460606,14212,0,0
8590042,Schlossmatte,,0.000058,44,1,2,3,47596,47631,95227,4,0.454545,0.616667,6465,0,0
8590043,Stöckacker,,0.000036,44,1,1,2,23788,23813,47601,3,0.5,0.611111,3882,0,0
8590045,Gäbelbach,,0.000041,44,1,1,2,23813,23792,47605,2,0.666667,0.75,2590,0,0
8590046,Tscharnergut,,0.000046,44,1,1,2,23792,23717,47509,1,1,1,1296,0,0
8590048,Bundesplatz,,0.000076,44,2,2,4,21615,21613,43228,6,0.285714,0.391667,9249,0,0
8590049,Galgenfeld,,0.000043,44,1,1,2,15489,15491,30980,5,0.310345,0.396296,4047,0,0
8590051,Oberfeld,,0.000031,44,1,1,2,11686,11684,23370,5,0.291667,0.390476,1301,0,0
8590053,Weissensteinstrasse,,0.000085,44,4,1,5,14339,14342,28681,3,0.454545,0.533333,6199.571429,0,0
8590058,Eichmatt,,0.00006,44,1,2,3,11387,11386,22773,1,1,1,136.428571,0,0
8590056,Neuhausplatz,,0.000058,44,1,1,2,7000,7002,14002,4,0.4,0.520833,5172,0,0
8590057,Sandwürfi Friedhof,,0.000058,44,2,1,3,11388,11387,22775,2,0.6,0.666667,1439.428571,0,0
8590059,Liebefeld Park,,0.000072,44,2,1,3,14341,11272,25613,1,1,1,1215,0,0
8590060,Ka-We-De,,0.000043,44,1,1,2,6124,6124,12248,3,0.5,0.611111,2618,0,0
8590061,Tierpark,,0.000047,44,1,1,2,6124,6124,12248,2,0.666667,0.75,1321,0,0
8590064,Innere Enge,,0.000039,44,1,1,2,7603,7618,15221,6,0.285714,0.408333,7296,0,0
8590065,Rossfeld,,0.000044,44,1,1,2,7618,7618,15236,5,0.333333,0.456667,6085,0,0
8590066,Felsenaustrasse,,0.000048,44,1,1,2,7618,7616,15234,4,0.4,0.520833,4872,0,0
8590067,Bremgarten Post,,0.000052,44,1,1,2,7616,7618,15234,3,0.5,0.611111,3657,0,0
8590068,Kunoweg,,0.000055,44,1,1,2,7618,7618,15236,2,0.666667,0.75,2440,0,0
8590069,Bremgarten,,0.000058,44,1,1,2,7618,7618,15236,1,1,1,1221,0,0
8590073,Hardegg Vidmar,,0.000061,44,1,1,2,7002,7002,14004,3,0.5,0.611111,3882,0,0
8590098,Köniz Weiermatt,,0.000062,44,1,1,2,7002,7002,14004,2,0.666667,0.75,2590,0,0
8590118,Sägestrasse,,0.000064,44,1,1,2,7002,7002,14004,1,1,1,1296,0,0
8590134,"Aarau, Berufsschule",,0.000062,57,5,1,6,16503,16503,33006,7,0.27027,0.367619,792,0,0
8590135,"Aarau, Binzenhofstrasse",,0.000016,57,1,1,2,5418,5829,11247,13,0.142857,0.250898,180,0,0
8590136,"Aarau, Buchenhof",,0.000024,57,1,2,3,5829,5829,11658,12,0.155556,0.29958,174,0,0
8590139,"Aarau, Dossenstrasse",,0.000021,57,1,1,2,3268,3268,6536,12,0.146067,0.245702,0,0,0
8590146,"Aarau, Herzogplatz",,0.000034,57,1,3,4,6452,6452,12904,8,0.243243,0.380688,292.2,0,0
8590147,"Aarau, Hirslanden Klinik",,0.000021,57,1,1,2,3183,3183,6366,9,0.197674,0.280299,0,0,0
8590138,"Aarau, Delfterstrasse",,0.000064,57,1,2,3,16503,16506,33009,6,0.333333,0.475926,718,0,0
8590151,"Aarau, Neumattstrasse",,0.000038,57,1,1,2,16417,16414,32831,6,0.307692,0.410417,0,0,0
8590140,"Aarau, Dufourstrasse",,0.000039,57,2,1,3,5829,5829,11658,11,0.157895,0.25999,156,0,0
8590141,"Aarau, Friedhof",,0.000044,57,1,1,2,5829,5829,11658,10,0.171875,0.276371,144,0,0
8590142,"Aarau, Gais",,0.000082,57,5,3,8,32211,32211,64422,9,0.228346,0.340736,2213.123077,0,0
8590143,"Aarau, General Guisanstrasse",,0.000048,57,1,1,2,5829,5829,11658,9,0.188679,0.295397,130,0,0
8590144,"Aarau, Hans Hässigstrasse",,0.000052,57,1,1,2,5829,5829,11658,8,0.209302,0.317857,114,0,0
8590145,"Aarau, Heinerich-Wirri-Strasse",,0.000055,57,1,1,2,5829,5829,11658,7,0.235294,0.34494,96,0,0
8590148,"Aarau, Ifang",,0.000052,57,3,2,5,6452,6452,12904,8,0.231884,0.350149,124.573077,0,0
8590154,"Aarau, Spital",,0.000043,57,2,2,4,6452,6452,12904,7,0.267857,0.387937,78.311538,0,0
8590149,"Aarau, Käfergrund",,0.000058,57,1,1,2,5829,5829,11658,6,0.269231,0.378571,76,0,0
8590152,"Aarau, Obere Vorstadt",,0.000067,57,2,1,3,12069,5418,17487,4,0.384615,0.483333,150,0,0
8590153,"Aarau, Pestalozzistrasse",,0.000067,57,1,1,2,5418,5829,11247,3,0.5,0.583333,124,0,0
8590209,"Buchs AG, Brummelstrasse",,0.000034,57,1,1,2,10616,10616,21232,8,0.212121,0.302551,981.923077,0,0
8590155,"Aarau, Tannerstrasse",,0.000068,57,1,2,3,5829,5829,11658,2,0.75,0.833333,96,0,0
8590158,"Aarau, Wasserfluhweg",,0.000045,57,1,1,2,2561,2561,5122,1,1,1,1,0,0
8590157,"Aarau, Wallerplatz",,0.00004,57,1,1,2,2561,2561,5122,2,0.666667,0.75,33,0,0
8590164,"Baden, Alterszentrum",,0.000019,22,2,1,3,4603,4603,9206,22,0.071717,0.089033,289.311905,0.000382,0
8590167,"Baden, Belvédère",,0.000048,22,2,1,3,9995,9995,19990,25,0.059829,0.070165,1255,0.000131,0
8590168,"Baden, Birkenweg",,0.000051,22,1,1,2,9995,9995,19990,24,0.063506,0.075657,1488,0,0
8590170,"Baden, Eichtal",,0.000055,22,1,1,2,9995,9995,19990,23,0.067674,0.082681,1719,0,0
8590172,"Baden, Freihof",,0.000085,22,5,1,6,27486,27928,55414,21,0.077835,0.102133,3150.444872,0.000525,0
8590234,"Ennetbaden, Rebhalde",,0.000076,22,1,1,2,10171,10171,20342,20,0.078789,0.092693,3664,0,0.000022
8590188,"Baden, Rüteli",,0.000046,22,2,1,3,16396,11770,28166,21,0.076812,0.097945,427.377778,0.000036,0.000007
8590177,"Baden, Kreuzliberg",,0.000041,22,2,1,3,11860,11860,23720,20,0.082616,0.103934,986.564286,0.000058,0
8590180,"Baden, Lindeli",,0.000045,22,2,2,4,9995,9995,19990,21,0.07717,0.099452,1446.166667,0.000058,0
8590182,"Baden, Münzlishausen",,0.000037,22,1,1,2,9817,9817,19634,21,0.076886,0.096736,479,0,0
8590181,"Baden, Müntzbergstrasse",,0.00003,22,1,1,2,9817,9817,19634,22,0.071535,0.086597,272,0,0
8590238,"Fislisbach, Sommerhalde",,0.000068,22,4,2,6,13273,11770,25043,20,0.075101,0.085033,897.869574,0.000076,0.000008
8590250,"Neuenhof, Webermühle",,0.000025,22,1,2,3,11860,11860,23720,18,0.088109,0.100981,480.5,0.000003,0.000007
8590195,"Baden, St. Ursus",,0.000038,22,2,1,3,4953,4688,9641,28,0.048986,0.054973,4,0.000071,0.000008
8590295,"Wettingen, Busgarage",,0.000081,22,4,4,8,15134,15134,30268,12,0.23622,0.38344,3413.59505,0.000358,0.000025
8590297,"Wettingen, Hardstrasse",,0.000077,22,2,2,4,15126,15126,30252,12,0.214286,0.322341,771.34263,0,0.000014
8590298,"Wettingen, Jurastrasse",,0.000044,22,1,2,3,13542,13542,27084,12,0.213115,0.328329,51.140909,0,0.000014
8590299,"Wettingen, Kreuzkapelle",,0.000028,22,1,1,2,10539,10539,21078,12,0.203125,0.283457,0,0.000001,0.000014
8590252,"Nussbaumen AG, Markthof",,0.000118,22,1,4,5,23015,22311,45326,18,0.087886,0.10332,2947.275923,0,0.000004
8590312,"Wettingen, Winkelried",,0.000137,22,5,2,7,23491,22432,45923,10,0.209677,0.35351,892.2,0,0.000015
8590202,"Bergdietikon, Bernold",,0.00004,22,3,4,7,16719,16757,33476,6,0.313725,0.473958,1912,0.000011,0
8590203,"Bergdietikon, Dünni",,0.000019,22,1,2,3,8260,8339,16599,7,0.238095,0.345079,0,0,0
8590204,"Bergdietikon, Rietwies",,0.000028,22,2,2,4,16698,16670,33368,6,0.285714,0.39881,6.5,0,0
8590205,"Bergdietikon, Vorbühl",,0.000039,22,3,1,4,16720,16670,33390,6,0.270833,0.352564,6.5,0,0
8590207,"Buchs AG, Alterszentrum",,0.000034,57,1,1,2,15143,15143,30286,10,0.181818,0.292897,704,0,0
8590208,"Buchs AG, Brauerei",,0.00004,57,1,1,2,15143,15143,30286,9,0.2,0.31433,625,0,0
8590210,"Buchs AG, Fabrikweg",,0.000045,57,1,1,2,15143,15143,30286,8,0.222222,0.339732,544,0,0
8590211,"Buchs AG, Gysistrasse",,0.000049,57,1,1,2,15143,15143,30286,7,0.25,0.370408,461,0,0
8590212,"Buchs AG, Heuweg",,0.000052,57,1,1,2,15143,15143,30286,6,0.285714,0.408333,376,0,0
8590213,"Buchs AG, Industrie",,0.000056,57,1,1,2,15143,15143,30286,5,0.333333,0.456667,289,0,0
8590214,"Buchs AG, Torfeld",,0.000058,57,1,1,2,15143,15143,30286,4,0.4,0.520833,200,0,0
8590215,"Buchs AG, Trieschweg",,0.00006,57,1,1,2,15143,15143,30286,3,0.5,0.611111,109,0,0
8590239,"Killwangen, Bahnhof",,0.000111,22,8,5,13,50611,60863,111474,18,0.092386,0.11642,44853.851871,0.00014,0.000002
8590268,"Spreitenbach, Asp",,0.000035,22,2,2,4,30900,30915,61815,17,0.096349,0.110486,6990.60071,0.000004,0.000001
8590269,"Spreitenbach, Breiti",,0.000045,22,2,3,5,32437,32369,64806,17,0.096249,0.111778,15226.398555,0,0.000001
8590227,"Ennetbaden, Aeusserer Berg",,0.000083,22,3,1,4,10171,10171,20342,27,0.051398,0.057562,3363,0.00005,0
8590228,"Ennetbaden, Friedhof",,0.000081,22,1,1,2,10171,10171,20342,26,0.054067,0.060478,3412,0,0
8590229,"Ennetbaden, Gärtnerweg",,0.00008,22,1,1,2,10171,10171,20342,25,0.057034,0.063795,3459,0,0
8590230,"Ennetbaden, Geissbergstrasse",,0.000079,22,1,1,2,10171,10171,20342,24,0.060353,0.067613,3504,0,0
8590231,"Ennetbaden, Gemeindehaus",,0.000078,22,1,1,2,10171,10171,20342,23,0.06409,0.072079,3547,0,0
8590232,"Ennetbaden, Kirche",,0.000077,22,1,1,2,10171,10171,20342,22,0.06833,0.077419,3588,0,0
8590233,"Ennetbaden, Neuacker",,0.000076,22,1,1,2,10171,10171,20342,21,0.073182,0.084025,3627,0,0
8590245,"Neuenhof, Kirchfeld",,0.000052,22,2,4,6,28504,31160,59664,18,0.090504,0.107788,8365.49958,0.000001,0.000001
8590313,"Würenlos, Bahnhof",,0.000069,22,1,1,2,12123,12123,24246,9,0.22449,0.348088,286,0,0
8590244,"Neuenhof, Eich",,0.000034,22,2,1,3,28415,28415,56830,19,0.083163,0.094767,1955.821009,0.000035,0
8590246,"Neuenhof, Klosterrüti",,0.000022,22,1,1,2,11860,11860,23720,21,0.072379,0.081613,0,0,0
8590306,"Wettingen, Sonne",,0.00007,22,1,4,5,17878,17878,35756,11,0.228916,0.422099,43.154762,0,0.000001
8590247,"Neuenhof, Kreuzstein",,0.000041,22,2,1,3,28415,28415,56830,20,0.077852,0.088936,6160,0,0
8590248,"Neuenhof, Landhaus",,0.000045,22,1,1,2,28415,28415,56830,19,0.084234,0.09857,6025,0,0
8590251,"Rieden AG, Boldi",,0.000126,22,5,1,6,23015,23015,46030,19,0.080968,0.09125,3125.275923,0.00004,0
8590395,"Rieden AG, Oederlin",,0.000059,22,2,2,4,5930,5930,11860,1,1,1,435.704762,0.000007,0.000007
8590396,"Spreitenbach, Spreiti West",,0.000087,22,3,1,4,23103,10276,33379,1,1,1,137.1,0.000006,0.000001
8590257,"Aarau Rohr, Gemeindehaus",,0.000041,57,1,1,2,15712,15712,31424,6,0.285714,0.408333,348,0,0
8590258,"Aarau Rohr, Quellhölzli",,0.000046,57,1,1,2,15712,15715,31427,5,0.333333,0.456667,266,0,0
8590259,"Aarau Rohr, Rigistrasse",,0.00005,57,1,1,2,15715,15712,31427,4,0.4,0.520833,182,0,0
8590260,"Aarau Rohr, Salamatt",,0.000053,57,1,1,2,15712,15712,31424,3,0.5,0.611111,96,0,0
8590270,"Spreitenbach, Brüel",,0.000044,22,3,3,6,30990,31057,62047,16,0.105661,0.122168,16242.952464,0.000004,0.000001
8590271,"Spreitenbach, Dorf",,0.000091,22,5,2,7,23103,23103,46206,17,0.095677,0.108079,13829.811443,0.000005,0
8590274,"Spreitenbach, Härdlistrasse",,0.000031,22,1,1,2,4612,4612,9224,16,0.104851,0.115202,402,0,0
8590275,"Spreitenbach, IKEA",,0.000074,22,3,3,6,45649,45645,91294,16,0.105483,0.121645,19859.101412,0,0.000001
8590278,"Spreitenbach, Rotzenbühl",,0.000071,22,1,1,2,23103,23103,46206,16,0.104809,0.116321,401,0,0.000001
8590272,"Spreitenbach, Fegistrasse",,0.000024,22,1,1,2,4612,4612,9224,17,0.095114,0.103405,577,0,0
8590277,"Spreitenbach, Langäcker",,0.00007,22,2,1,3,23103,23103,46206,17,0.09508,0.103911,592,0,0
8590304,"Wettingen, Bahnhof",,0.000034,22,1,1,2,10889,10889,21778,2,0.666667,0.75,0,0.000006,0.000006
8590839,"Urdorf, Herweg",,0.000081,85,3,3,6,41765,41695,83460,13,0.128593,0.143175,3747.112874,0.005436,0.005694
8590840,"Urdorf, Luberzen",,0.000052,85,2,2,4,32480,31784,64264,1,1,1,120.936996,0.005285,0.003653
8590281,"Suhr, Bahnhof",,0.00008,57,3,2,5,17068,17068,34136,7,0.25,0.37967,999.846154,0,0
8590282,"Suhr, Bühlstrasse",,0.000045,57,1,1,2,10616,10616,21232,6,0.263158,0.356667,532.730769,0,0
8590284,"Suhr, Fliederweg",,0.000049,57,1,2,3,6452,6452,12904,5,0.333333,0.456667,205.115385,0,0
8590283,"Suhr, Feld",,0.000045,57,1,1,2,6452,6452,12904,6,0.268293,0.354545,290.115385,0,0
8590285,"Suhr, Grillenweg",,0.00007,57,2,2,4,11849,11849,23698,5,0.321429,0.451852,447.730769,0,0
8590286,"Suhr, Lindenfeld",,0.000061,57,2,2,4,6452,6452,12904,4,0.4,0.520833,317.230769,0,0
8590287,"Suhr, Mattenweg",,0.000067,57,2,1,3,11849,11849,23698,4,0.368421,0.452381,154.615385,0,0
8594391,"Rombach, Widler",,0.000075,57,1,2,3,11849,11321,23170,3,0.571429,0.708333,44.5,0,0
8590300,"Wettingen, Langenstein",,0.000117,22,5,3,8,23491,23491,46982,11,0.245098,0.384128,1787.300671,0.000014,0.00001
8590301,"Wettingen, Märzengasse",,0.00004,22,1,1,2,12890,12890,25780,13,0.18797,0.283872,25,0,0.00001
8590293,"Wettingen, Bahnhofstrasse",,0.00005,22,5,1,6,13542,13542,27084,13,0.181818,0.252862,946.54263,0.000429,0
8590296,"Wettingen, Halbartenstrasse",,0.000028,22,1,1,2,1584,1584,3168,13,0.181818,0.252862,356.8,0.000001,0
8590294,"Wettingen, Brunnenwiese",,0.000034,22,1,1,2,12890,12890,25780,14,0.163522,0.236049,583,0.000009,0
8590302,"Wettingen, Rathaus",,0.000118,22,4,4,8,29621,29621,59242,12,0.222222,0.395967,5285.78526,0.00001,0.000001
8590309,"Wettingen, Staffelstrasse",,0.000051,22,2,2,4,11772,11772,23544,11,0.209877,0.35411,208.684127,0,0.000001
8590310,"Wettingen, Tägi",,0.000091,22,4,3,7,15126,15126,30252,11,0.205128,0.376242,1411.684127,0,0
8590311,"Wettingen, Tägipark",,0.000037,22,1,1,2,8848,8848,17696,11,0.184211,0.287134,0,0,0
8590303,"Wettingen, Rebstock",,0.000069,22,2,1,3,17878,17878,35756,12,0.194175,0.300161,619.154762,0,0
8590305,"Wettingen, Schönenbühlstrasse",,0.000036,22,1,1,2,12890,12890,25780,2,0.666667,0.75,1190,0,0
8590307,"Wettingen, St. Sebastian",,0.000041,22,1,1,2,12890,11829,24719,1,1,1,596,0,0
8590314,"Würenlos, Büntenstrasse",,0.000089,22,2,3,5,17437,17437,34874,8,0.263158,0.471786,6020,0,0
8590315,"Würenlos, Flüefeld",,0.000036,22,1,1,2,10539,10539,21078,9,0.2,0.31433,0,0,0
8590316,"Würenlos, Post",,0.000067,22,2,1,3,12123,12123,24246,8,0.222222,0.339732,8,0,0
8590317,"Würenlos, Raiffeisenbank",,0.000093,22,2,1,3,17437,5314,22751,7,0.25,0.370408,4235,0,0
8590319,"Gossau SG, Multstrasse",,0.000039,71,2,1,3,14825,14693,29518,15,0.114537,0.171797,592,0,0
8590321,"Gossau SG, Geissberg",,0.000266,71,5,1,6,16898,16898,33796,13,0.136364,0.193303,3900,0,0
8590322,"Gossau SG, Fennhof",,0.000237,71,1,1,2,16898,16898,33796,12,0.151316,0.208387,2973,0,0
8590323,"Herisau, Tüfi",,0.000212,71,1,1,2,16898,16898,33796,11,0.170543,0.228663,2044,0,0
8590324,"Herisau, Stelz",,0.000191,71,1,1,2,16898,16898,33796,10,0.196262,0.258182,1113,0,0
8590340,"Herisau, Ebnet",,0.000047,71,1,1,2,13832,13832,27664,5,0.35,0.445238,28,0,0
8590327,"Gossau SG, Eichen",,0.000057,71,1,2,3,12137,11512,23649,2,0.75,0.833333,1824,0,0
8590328,"Niederwil SG, Büelen",,0.000035,71,1,1,2,11429,10198,21627,2,0.666667,0.75,0,0,0
8590329,"Niederwil SG, Oberhus",,0.000065,71,2,1,3,10281,10657,20938,1,1,1,610,0,0
8590332,"Gossau SG, Hofegg",,0.000049,71,2,1,3,5931,5931,11862,2,0.666667,0.75,398,0,0
8590333,"Gossau SG, Friedhof",,0.000052,71,1,1,2,5931,5683,11614,1,1,1,200,0,0
8590336,"Herisau, Rütihalde",,0.000024,71,1,1,2,13832,13832,27664,9,0.189655,0.285317,1948,0,0
8590337,"Herisau, Nordhalde",,0.000031,71,1,1,2,13832,13832,27664,8,0.212766,0.308452,1471,0,0
8590338,"Herisau, Talweg",,0.000037,71,1,1,2,13832,13832,27664,7,0.243243,0.338095,992,0,0
8590339,"Herisau, Friedhof",,0.000043,71,1,1,2,13832,13832,27664,6,0.285714,0.379167,511,0,0
8590341,"Herisau, Migros/Spital",,0.000114,71,2,2,4,47484,37606,85090,4,0.461538,0.597222,5808,0,0
8590342,"Herisau, Sportzentrum",,0.000059,71,1,2,3,33652,32285,65937,3,0.571429,0.708333,3876,0,0
8590343,"Herisau, Obermoosberg",,0.000036,71,1,1,2,16301,16301,32602,2,0.666667,0.75,1940,0,0
8590344,"Herisau, Saum",,0.000042,71,1,1,2,16301,8385,24686,1,1,1,971,0,0
8590346,"Herisau, Post/Casino",,0.000138,71,3,1,4,40485,29569,70054,3,0.5,0.611111,2892,0,0
8590347,"Herisau, Sonnenberg",,0.000129,71,1,1,2,29569,29569,59138,2,0.666667,0.75,1930,0,0
8590348,"Herisau, Wilen",,0.00012,71,1,1,2,29569,29569,59138,1,1,1,966,0,0
8590350,"Herisau, Huebstrasse",,0.000037,71,1,1,2,15884,15884,31768,4,0.384615,0.483333,2445,0,0
8590351,"Herisau, Psych. Zentrum",,0.000043,71,1,1,2,15884,15884,31768,3,0.5,0.583333,1960,0,0
8590352,"Herisau, Tüfenau",,0.000047,71,1,2,3,15884,15884,31768,2,0.75,0.833333,1473,0,0
8590353,"Herisau, Ramsenhof",,0.000031,71,1,1,2,7943,7943,15886,2,0.666667,0.75,0,0,0
8590354,"Herisau, Ramsen",,0.000057,71,2,1,3,15884,15884,31768,1,1,1,493,0,0
8590356,"Herisau, Gemeindehaus",,0.000074,71,1,1,2,15336,15336,30672,7,0.25,0.370408,6741,0,0
8590357,"Herisau, Bergstrasse",,0.000074,71,1,1,2,15336,15336,30672,6,0.285714,0.408333,5784,0,0
8590358,"Herisau, Steinegg",,0.000074,71,1,1,2,15336,15336,30672,5,0.333333,0.456667,4825,0,0
8590359,"Herisau, Dreilinden",,0.000074,71,1,1,2,15336,15336,30672,4,0.4,0.520833,3864,0,0
8590360,"Herisau, Scheibe",,0.000073,71,1,1,2,15336,15336,30672,3,0.5,0.611111,2901,0,0
8590361,"Herisau, Egg",,0.000073,71,1,1,2,15336,15336,30672,2,0.666667,0.75,1936,0,0
8590362,"Herisau, Witenschwendi",,0.000073,71,1,1,2,15336,15336,30672,1,1,1,969,0,0
8595478,"Hünibach, Höheweg",,0.000061,43,2,1,3,474,358,832,1,1,1,3,0,0
8590400,"Hilterfingen, Weingartenstr.",,0.000048,43,3,1,4,480,480,960,3,0.5,0.583333,387,0,0
8590401,"Oberhofen, Tannackerstrasse",,0.000051,43,1,2,3,480,468,948,2,0.75,0.833333,261,0,0
8595477,"Hilterfingen, Friedhof",,0.000033,43,1,1,2,234,240,474,2,0.666667,0.75,0,0,0
8590405,"Dulliken, Brüggli Park",,0.000048,94,2,1,3,32063,32945,65008,11,0.151515,0.208986,995.566667,0,0
8590406,"Dulliken, Bahnhof",,0.000041,94,3,1,4,10609,10608,21217,11,0.153374,0.218986,234.433333,0,0
8590407,"Dulliken, Bodenacker",,0.000046,94,1,2,3,10608,10608,21216,10,0.173913,0.263228,199.433333,0,0
8590410,"Dulliken, Schäfer",,0.000052,94,1,1,2,32945,32943,65888,10,0.171429,0.23545,900.566667,0,0
8590411,"Dulliken, Zentrum",,0.000074,94,2,2,4,43215,43217,86432,9,0.198276,0.286922,988.666667,0,0
8590414,"Obergösgen, Fähre",,0.000062,94,2,1,3,10608,10608,21216,1,1,1,124,0,0
8590416,"Olten, Sälipark",,0.000029,94,2,2,4,30534,30516,61050,8,0.242105,0.337422,1002.083333,0,0
8590418,"Olten, Dreitannenstrasse",,0.000023,94,1,1,2,7513,7513,15026,8,0.234043,0.307305,0,0,0
8590417,"Olten, Bifang",,0.000042,94,1,1,2,32945,32941,65886,8,0.217391,0.279702,676,0,0
8590422,"Olten, Hausmattrain",,0.000071,94,4,2,6,30281,30295,60576,6,0.320755,0.415686,1609,0,0
8590423,"Olten, Käppeli",,0.000035,94,1,1,2,32944,32944,65888,7,0.253731,0.32507,51.333333,0,0
8590424,"Olten, Knoblauch",,0.00008,94,3,3,6,40924,40925,81849,6,0.32,0.441667,480.033333,0,0
8590425,"Olten, Kunsteisbahn",,0.000064,94,2,4,6,30295,30295,60590,5,0.4,0.538095,1556.55,0,0
8590426,"Olten, Maienstrasse",,0.000047,94,2,1,3,7980,7980,15960,8,0.216667,0.294963,39.15,0,0
8590428,"Olten, Meisenhardweg",,0.000066,94,1,2,3,15674,15493,31167,6,0.314286,0.434848,156,0,0
8590430,"Olten, Reiserstrasse",,0.000039,94,1,1,2,7513,7513,15026,6,0.294118,0.378333,0,0,0
8590431,"Olten, Riggenbachstrasse",,0.000085,94,3,2,5,30530,30516,61046,5,0.375,0.494444,269.533333,0,0
8590427,"Olten, Meierhof",,0.000064,94,2,1,3,15493,15674,31167,7,0.255319,0.339683,280,0,0
8594292,"Olten, Bornfeld",,0.000078,94,2,2,4,30239,30295,60534,2,0.75,0.833333,15,0,0
8590432,"Olten, Schützenmatt",,0.000061,94,2,1,3,30281,30295,60576,4,0.363636,0.4375,695,0,0
8590433,"Olten, Stadthalle",,0.000063,94,1,2,3,30295,30295,60590,3,0.5,0.595238,563,0,0
8594176,"Starrkirch-Wil,Gemeindezentrum",,0.000047,94,1,1,2,15023,14981,30004,3,0.5,0.583333,8,0,0
8591978,"Lausanne, Allières/CHUV",,0.000015,10,1,1,2,40548,40655,81203,16,0.144863,0.176228,0,0,0
8591980,"Lausanne, Aubépines",,0.000011,10,0,1,1,0,24775,24775,16,0.144863,0.176228,0,0,0
8591982,"Lausanne, Barre",,0.000015,10,1,1,2,14680,14596,29276,16,0.144863,0.176228,0,0,0
8591987,"Lausanne, Beau-Site",,0.000029,10,2,3,5,35737,35676,71413,16,0.146051,0.185448,5635.172956,0,0
8590444,"Hombrechtikon, Dörfli",,0.00005,67,2,1,3,5622,5689,11311,4,0.4,0.520833,1344,0,0
8590445,"Hombrechtikon, Niderfeld",,0.000054,67,1,1,2,5689,5691,11380,3,0.5,0.611111,899,0,0
8590446,"Hombrechtikon, Wisental",,0.000056,67,1,1,2,5691,5681,11372,2,0.666667,0.75,452,0,0
8590448,"Wolfhausen, Oberwolfhausen",,0.000037,8,1,1,2,6035,6009,12044,2,0.666667,0.75,162,0,0
8590464,"Adliswil, Bahnhof",,0.000039,130,3,8,11,22280,73635,95915,14,0.134901,0.163459,8493.954545,0,0
8590465,"Adliswil, Baumgartenweg",,0.000015,130,1,1,2,10480,10480,20960,3,0.5,0.611111,0,0,0
8590470,"Adliswil, Friedhof",,0.000015,130,1,1,2,9051,10480,19531,22,0.070267,0.07948,0,0,0
8590480,"Adliswil, Rifertstrasse",,0.000028,130,2,2,4,11529,11524,23053,21,0.075334,0.086947,358,0,0
8590481,"Adliswil, Rütistrasse/Wacht",,0.000023,130,1,1,2,10475,10480,20955,21,0.075109,0.083992,0,0,0
8590466,"Adliswil, Bodenacker",,0.000015,130,1,1,2,21342,21342,42684,13,0.110085,0.122044,239,0,0
8590467,"Adliswil, Büchel",,0.000028,130,2,1,3,20962,20962,41924,2,0.666667,0.75,98,0,0
8590469,"Adliswil, Feldblumenstrasse",,0.000024,130,1,1,2,21342,21341,42683,12,0.122837,0.135078,333,0,0
8590471,"Adliswil, Baldernstrasse",,0.000031,130,1,1,2,21341,21342,42683,11,0.139053,0.152095,425,0,0
8590472,"Adliswil, Grüt",,0.000015,130,1,1,2,10199,10214,20413,13,0.146307,0.156383,6614.954545,0,0
8590473,"Adliswil, Hofackerstrasse",,0.000015,130,1,1,2,9984,17037,27021,17,0.125708,0.137046,1189.333333,0,0
8590474,"Adliswil, Krone",,0.000024,130,1,1,2,10214,10197,20411,12,0.170838,0.184949,6880.954545,0,0
8590475,"Adliswil, Landolt-Junker-Str.",,0.000035,130,1,1,2,20962,20963,41925,1,1,1,50,0,0
8590477,"Adliswil, Moos",,0.000028,130,2,1,3,10053,10059,20112,15,0.165164,0.183668,1730,0,0.000092
8590678,"Kilchberg ZH, Kirche",,0.000047,130,2,2,4,29651,29786,59437,14,0.167873,0.189272,2557.516667,0.000092,0.0039
8590478,"Adliswil, Poststrasse",,0.000037,130,1,1,2,21342,21338,42680,10,0.160367,0.175329,515,0,0
8590479,"Adliswil, Zopf",,0.000043,130,1,1,2,21338,21342,42680,9,0.189632,0.209253,603,0,0
8591270,"Zürich, Marbachweg",,0.000045,130,2,1,3,58572,58571,117143,9,0.189632,0.209253,1557,0,0
8590482,"Adliswil, Schulhaus Kopfholz",,0.000046,130,3,2,5,12577,12577,25154,20,0.080946,0.092106,1219.666667,0,0
8590773,"Rüschlikon, Bodengasse",,0.000042,130,1,1,2,22309,22306,44615,20,0.080705,0.089149,1146,0,0
8590484,"Adliswil, Tiefacker",,0.000031,130,1,2,3,10197,10214,20411,11,0.205381,0.229469,7144.954545,0,0.149327
8590679,"Kilchberg ZH, Spital",,0.000055,130,2,3,5,17114,17113,34227,14,0.197271,0.229443,4816.016667,0.000092,0.153135
8591061,"Zürich, Bahnhof Leimbach",,0.000014,130,1,3,4,56765,58572,115337,11,0.206057,0.232291,313,0,0.027388
8591081,"Zch, Bhf.Wollishofen/Staubstr.",,0.000105,130,8,2,10,90945,91008,181953,10,0.211096,0.234392,7246.641712,0.119862,0.004583
8590487,"Aesch bei Maur, Im Brünneli",,0.000011,129,0,1,1,0,5960,5960,20,0.097116,0.108234,0,0,0
8590489,"Au ZH, Alte Landstrasse",,0.000038,63,2,2,4,7410,7410,14820,11,0.157895,0.216567,971.54329,0,0
8590491,"Au ZH, Aubrücke",,0.000027,63,1,2,3,7304,7305,14609,11,0.155763,0.210898,100,0,0
8590492,"Au ZH, Austrasse",,0.000022,63,1,1,2,105,105,210,11,0.153125,0.194794,0,0,0
8590496,"Au ZH, Moosacher",,0.000054,63,2,2,4,8188,8186,16374,10,0.173745,0.228801,412.454978,0,0
8590494,"Au ZH, Grundstein",,0.000064,63,4,2,6,14858,14858,29716,11,0.153595,0.208022,840.45671,0,0
8590495,"Au ZH, Gwad",,0.000038,63,1,2,3,14753,14753,29506,10,0.176245,0.234696,266.001732,0,0
8590497,"Au ZH, Naglikonerweg",,0.000058,63,2,2,4,7411,7212,14623,9,0.199095,0.256349,844.663203,0,0
8590498,"Au ZH, Schützenhaus",,0.000075,63,3,2,5,14856,14858,29714,9,0.200935,0.259598,588.336797,0,0
8590499,"Au ZH, Seeguet",,0.000068,63,2,3,5,7212,7411,14623,8,0.237288,0.309977,934.90303,0,0
8590500,"Au ZH, Stoffelstrasse",,0.000062,63,2,2,4,14858,14858,29716,8,0.235294,0.29756,346.09697,0,0
8590501,"Au ZH, Strandbad",,0.00003,63,1,1,2,7200,7200,14400,8,0.212766,0.257619,0,0,0
8590659,"Horgen, Schärbächli/Fähre",,0.000078,63,1,3,4,9422,9419,18841,3,0.6,0.722222,427.666667,0,0
8590539,"Dietlikon, Bahnhof/Bad",,0.000077,107,3,3,6,81560,81221,162781,14,0.108722,0.123255,10606.179608,0.00217,0.000982
8590753,"Pfaffhausen, Sängglen",,0.000023,129,1,2,3,22575,22576,45151,10,0.163761,0.181133,67.778846,0.000003,0.00499
8590806,"Schwerzenbach ZH, Dorf",,0.000053,129,4,3,7,42405,40546,82951,9,0.184767,0.207066,3315.756571,0.000124,0.011956
8591072,"Zürich, Berghaldenstrasse",,0.000042,129,4,1,5,56929,57026,113955,10,0.16243,0.175654,7439.848535,0.106339,0.000739
8591102,"Zürich, Buchholz",,0.000033,129,1,1,2,13097,13100,26197,10,0.16243,0.175654,1542,0,0.000739
8591825,"Benglen, Bodenacher",,0.000034,85,2,2,4,40940,40942,81882,2,0.666667,0.75,192.430376,0.002572,0.013302
8591828,"Ebmatingen, Dorf",,0.000101,85,3,2,5,29161,27846,57007,2,0.666667,0.75,1425.581606,0.012134,0.013302
8591832,"Pfaffhausen, Müseren",,0.000139,85,5,3,8,73414,31130,104544,1,1,1,2759.362077,0.012476,0.003332
8590510,"D'dorf, Sportanl Heerenschürli",,0.000015,129,1,1,2,31223,31282,62505,20,0.095849,0.104868,17801.685227,0.000289,0
8590512,"Dietikon, Birmensdorferstrasse",,0.000072,85,4,2,6,41747,41743,83490,14,0.130277,0.143917,43336.315162,0.00002,0
8590513,"Dietikon, Dörfli",,0.000042,85,1,2,3,41671,41739,83410,14,0.130076,0.143436,599,0,0
8590517,"Dietikon, Hofacker",,0.000059,85,2,3,5,41741,41750,83491,13,0.149033,0.167626,42319.248495,0,0.000013
8590514,"Dietikon, Rapidplatz",,0.000014,22,1,1,2,36697,36695,73392,5,0.333333,0.456667,2350,0.00001,0
8590515,"Dietikon, Hagackerstrasse",,0.000023,22,1,1,2,36695,36696,73391,4,0.4,0.520833,1884,0,0
8590529,"Dietikon, Sommerau",,0.000045,85,2,2,4,41748,41697,83445,14,0.129801,0.143263,607.066667,0,0.000001
8590790,"Schlieren, Feldstrasse",,0.000063,22,3,3,6,34830,34813,69643,13,0.148864,0.167396,1417.661905,0.000035,0.000012
8590619,"Glanzenberg, Bahnhof",,0.00002,85,1,2,3,17240,17241,34481,13,0.147965,0.163352,389,0,0.000012
8590797,"Schlieren, Reitmen",,0.000038,85,1,1,2,32466,32484,64950,13,0.147372,0.16032,17.05,0,0.000012
8590800,"Schlieren, Spital Limmattal",,0.000077,85,3,3,6,43121,43124,86245,12,0.171833,0.192289,2350.706349,0,0.000482
8590519,"Dietikon, Lerzen",,0.00003,22,1,1,2,36696,36697,73393,3,0.5,0.611111,1416,0,0
8590520,"Dietikon, Moosmatt",,0.000037,22,1,1,2,36697,36695,73392,2,0.666667,0.75,946,0,0
8590521,"Dietikon, Oberdorf",,0.00005,22,3,5,8,35877,36129,72006,2,0.857143,0.916667,2880,0.00001,0
8590531,"Dietikon, Stadthalle Ost",,0.000019,22,1,2,3,17544,17219,34763,1,1,1,0,0,0
8590532,"Dietikon, Staffelackerstrasse",,0.000028,22,2,1,3,9884,9679,19563,1,1,1,0,0,0
8590536,"Dietikon, Weidstrasse",,0.000019,22,1,1,2,15519,15384,30903,2,0.666667,0.75,0,0,0
8590523,"Dietikon, Pestalozzi",,0.000042,22,1,1,2,36695,36697,73392,1,1,1,474,0,0
8590526,"Dietikon, Schönenwerd",,0.000011,85,0,1,1,0,17240,17240,14,0.129182,0.139565,0,0,0
8590537,"Dietikon, Weinberg",,0.000036,22,2,1,3,15564,15626,31190,1,1,1,482,0,0
8590540,"Dietlikon, Brandbachstrasse",,0.000033,107,1,1,2,32902,32983,65885,13,0.118975,0.1261,5926.922332,0.000023,0
8590543,"Dietlikon, Hofwiesen",,0.000045,129,3,3,6,25450,25988,51438,19,0.103328,0.118631,1788,0,0
8590594,"Dübendorf, Zwinggarten",,0.000043,129,1,1,2,19866,19867,39733,2,0.6,0.666667,1446,0,0
8595080,"Dietlikon, Riedenerstrasse",,0.000044,129,2,1,3,5886,5886,11772,2,0.6,0.666667,12,0,0
8590544,"Dietlikon, Hörnligraben",,0.000039,107,1,1,2,32983,32996,65979,12,0.13466,0.143145,5674.922332,0,0
8590545,"Dietlikon, Industriestrasse",,0.000044,107,1,1,2,32996,32997,65993,11,0.155172,0.166332,5420.922332,0,0
8590548,"Dübendorf, Bahnhof Nord",,0.000024,129,1,1,2,31282,31292,62574,19,0.105774,0.117353,17788.685227,0,0
8590552,"Dübendorf, Breitibach",,0.000052,129,5,3,8,88234,104318,192552,18,0.118519,0.137353,1890.059028,0,0
8590554,"Dübendorf, City Center",,0.000046,129,2,3,5,83793,83793,167586,18,0.118021,0.135316,17797.685227,0,0
8590555,"Dübendorf, Claridenstrasse",,0.000024,129,1,1,2,19843,19842,39685,18,0.117351,0.130589,0,0,0
8590563,"Dübendorf, Grüzenstrasse",,0.000032,129,2,2,4,14474,14474,28948,18,0.128704,0.147192,1376.375496,0,0
8590553,"Dübendorf, Chriesmatt",,0.000024,129,1,1,2,19868,18673,38541,18,0.112983,0.122585,2166,0,0
8590556,"Dübendorf, Innovationspark",,0.000024,129,1,1,2,31293,31291,62584,18,0.112983,0.122585,471,0,0
8590557,"Dübendorf, EMPA",,0.000012,129,1,1,2,25576,25576,51152,12,0.151313,0.164082,336,0,0
8590575,"Dübendorf, Lindenplatz",,0.000102,129,4,2,6,103553,103630,207183,16,0.145248,0.164418,10887.168716,0,0
8590558,"Dübendorf, Flugplatz",,0.000031,129,1,1,2,31291,31290,62581,17,0.127082,0.139779,435,0,0
8590566,"Dübendorf, Hoffnung",,0.000073,129,4,4,8,104316,123131,227447,17,0.132653,0.153611,18767.539039,0,0
8590568,"Dübendorf, Im Grund",,0.000031,129,1,1,2,18673,19764,38437,17,0.127082,0.139779,2595,0,0
8590573,"Dübendorf, Kunsteisbahn",,0.000026,129,1,1,2,19841,19843,39684,17,0.127082,0.139779,0,0,0
8590559,"Dübendorf, Gfenn",,0.000018,129,1,1,2,19878,19836,39714,3,0.5,0.583333,24,0,0
8590561,"Dübendorf, Am Ring",,0.000037,107,2,1,3,35252,35278,70530,13,0.117176,0.125591,2288.691667,0.000366,0
8590562,"Dübendorf, Glärnischstrasse",,0.000026,129,1,2,3,19836,19879,39715,2,0.75,0.833333,21,0,0
8590565,"Dübendorf, Heidenrietstrasse",,0.000022,129,1,1,2,9931,9931,19862,2,0.666667,0.75,0,0,0
8590567,"Dübendorf, Högler",,0.000026,129,1,1,2,51793,51820,103613,14,0.133495,0.145382,1860,0,0
8590569,"Dübendorf, Kämmaten",,0.000026,129,1,2,3,18841,18855,37696,13,0.156276,0.173835,8891.370323,0,0.001523
8590570,"Dübendorf, Kirche Wil",,0.000047,129,2,2,4,52020,52326,104346,13,0.153661,0.172037,3451.146189,0,0.00004
8590576,"Dübendorf, Meiershofstrasse",,0.000054,129,1,3,4,83769,83791,167560,15,0.14878,0.169597,3526.188889,0,0.000041
8590586,"Dübendorf, Schwimmbad",,0.000044,129,2,2,4,14474,14474,28948,13,0.152889,0.169892,766.633333,0,0.000059
8590587,"Dübendorf, Sonnenberg",,0.000033,129,1,1,2,19841,19843,39684,13,0.152767,0.168143,381,0,0.000039
8590588,"Dübendorf, Sonnental",,0.000104,129,5,5,10,113846,113836,227682,12,0.179839,0.207409,11397.6429,0.000039,0.062742
8590571,"Dübendorf, Kreuzbühl",,0.000031,129,1,2,3,14787,14474,29261,14,0.133217,0.146359,956.633333,0.000001,0
8590580,"Dübendorf, Post",,0.000024,129,1,1,2,12476,12476,24952,14,0.132916,0.144125,0,0,0
8590574,"Dübendorf, Lindenbühl",,0.000041,129,2,1,3,19879,19658,39537,1,1,1,9,0,0
8590577,"Dübendorf, Memphis",,0.000065,129,2,2,4,45437,44882,90319,11,0.177766,0.198415,7499.979827,0,0.058222
8590590,"Dübendorf, Sunnhalde",,0.000029,129,1,1,2,19842,19839,39681,11,0.17644,0.194399,0,0.001449,0.056878
8590593,"Dübendorf, Zelglistrasse",,0.000045,129,2,1,3,14474,14274,28748,11,0.17644,0.194399,1129.174797,0.00002,0.056878
8590612,"Fällanden, Zil",,0.000084,129,2,3,5,37515,37541,75056,12,0.176324,0.199076,12835.149287,0.000003,0.059666
8590635,"Gockhausen, Ursprungstrasse",,0.00004,85,2,3,5,18855,19237,38092,11,0.182314,0.204474,1758.478517,0.001484,0.071232
8590785,"Scheuren, Station",,0.00009,129,2,1,3,6028,5962,11990,11,0.17644,0.194399,6712.960195,0.00141,0.056878
8590578,"Wallisellen, Neugut",,0.000042,107,1,1,2,35278,35282,70560,12,0.132392,0.143355,2082.691667,0,0
8590579,"Dübendorf, Neugut Süd",,0.000026,107,1,1,2,31290,31290,62580,14,0.098331,0.105246,1578.25,0.000001,0
8590581,"Dübendorf, Raubbühl",,0.000026,129,1,1,2,19843,19841,39684,14,0.132823,0.14347,486,0.000001,0
8590582,"Dübendorf, Ringstrasse",,0.000033,107,1,1,2,31290,31287,62577,13,0.108765,0.116878,1468.25,0,0
8590632,"Opfikon, Zil",,0.000029,107,1,1,2,5985,5984,11969,13,0.108765,0.116878,2674.5,0,0
8590748,"Opfikon, Neuwiesen",,0.00007,107,2,2,4,37256,37262,74518,11,0.137842,0.150322,3729.75,0,0.001187
8590589,"Dübendorf, Stadthaus",,0.000029,129,1,1,2,10061,10061,20122,13,0.135954,0.14911,0,0.001449,0.001483
8590591,"Dübendorf, Unterdorf",,0.000038,129,1,1,2,19307,19866,39173,3,0.444444,0.541667,1930,0.001344,0
8590712,"Maur, Aschbach",,0.000035,129,1,1,2,12689,12688,25377,14,0.125492,0.134341,523.654511,0.001378,0.000001
8590713,"Maur, Dorf",,0.000072,129,3,2,5,34551,34607,69158,13,0.143091,0.155355,1563.362682,0.000001,0.000001
8590714,"Maur, Kirche",,0.000041,129,1,2,3,34582,34573,69155,12,0.166428,0.183031,606.356341,0,0.000001
8590603,"Fahrweid, Limmatbrücke",,0.00002,22,2,2,4,58513,58518,117031,16,0.16082,0.182224,10775.293798,0.00001,0.000534
8590614,"Geroldswil, Dorfstrasse",,0.000026,22,2,2,4,58555,55363,113918,16,0.178744,0.210481,4542.573327,0.000013,0.022019
8590606,"Fällanden, Gemeindehaus",,0.000053,129,3,5,8,68930,68924,137854,13,0.146194,0.166897,8995.233457,0.000008,0.000012
8590609,"Fällanden, Neuhus",,0.000037,129,2,1,3,14866,14868,29734,14,0.130948,0.140797,355,0,0.000007
8590610,"Fällanden, Schützenhaus",,0.000051,129,3,4,7,46631,46673,93304,12,0.16926,0.192139,12081.790763,0.000003,0.000138
8590607,"Fällanden, Industrie",,0.00002,129,1,2,3,42498,42464,84962,13,0.158103,0.175739,391.912379,0,0.000128
8590608,"Fällanden, Jugendherberge",,0.00002,129,1,1,2,12682,12677,25359,15,0.116074,0.124063,0,0,0
8590752,"Pfaffhausen, Pfaffenstein",,0.000029,129,1,2,3,22602,22600,45202,10,0.156956,0.173029,864,0,0.000127
8590611,"Fällanden, Wigarten",,0.000073,129,4,1,5,34542,34533,69075,13,0.150255,0.163852,5230.150166,0.000007,0.000003
8590722,"Neuhaus bei Hinteregg, Station",,0.000065,129,1,1,2,62,63,125,12,0.150359,0.162103,6423.310195,0,0.00141
8590878,"Regensdorf-Watt, Bahnhof",,0.000237,107,8,4,12,104787,36552,141339,9,0.222297,0.249023,13273.757324,0.00002,0.051584
8591121,"Zürich, Eschergutweg",,0.000025,85,2,1,3,31484,31499,62983,9,0.214228,0.234028,2086.664032,0.035052,0.021498
8591134,"Zürich, Flurstrasse",,0.000039,85,3,3,6,80346,80423,160769,8,0.252141,0.28376,1747.932027,0.016535,0.091755
8590615,"Geroldswil, Grindlen",,0.00003,22,2,4,6,55326,58605,113931,15,0.146359,0.168903,8461.883325,0.000521,0.001036
8590616,"Geroldswil, Schweizäcker",,0.000017,22,1,2,3,11990,12000,23990,15,0.145428,0.162933,711,0.000024,0.000055
8590617,"Geroldswil, Welbrig",,0.000017,22,1,4,5,34431,34443,68874,14,0.149077,0.169699,1434.583983,0.000024,0.000264
8590911,"Weiningen ZH, Ausserdorf",,0.000121,85,5,2,7,34379,34329,68708,11,0.168718,0.185289,1632.616433,0.001781,0.00098
8590914,"Weiningen ZH, Schulhaus",,0.000041,85,2,2,4,34418,34442,68860,10,0.201231,0.222711,2022.427028,0.000678,0.028662
8591434,"Zürich, Winzerhalde",,0.000144,85,4,4,8,99455,99342,198797,5,0.380952,0.519792,2777.091106,0.002755,0.000742
8591436,"Zürich, Winzerstrasse Süd",,0.000095,85,2,3,5,97973,72493,170466,2,0.636364,0.714286,124.42878,0.000115,0.000737
8590618,"Geroldswil, Zentrum",,0.000028,22,3,6,9,58378,58410,116788,14,0.16947,0.197107,5811.816801,0.000031,0.000968
8590725,"Oberengstringen, Eggbühl",,0.000019,22,2,3,5,16731,38608,55339,15,0.144985,0.161453,547.299206,0.000028,0.000035
8590727,"Oberengstringen, Paradies",,0.000026,22,2,2,4,39352,39393,78745,14,0.147748,0.163321,58.083333,0.000001,0.00018
8590728,"Oberengstringen, Zentrum",,0.000037,22,3,3,6,39286,39323,78609,14,0.168296,0.189261,1187.412231,0.000005,0.00615
8590788,"Schlieren, Brunngasse",,0.000072,22,2,2,4,19903,19926,39829,12,0.172959,0.193168,2561.444875,0.000001,0.000493
8590913,"Weiningen ZH, Lindenplatz",,0.000062,85,1,2,3,34293,34311,68604,10,0.201104,0.221524,1040.973576,0.000023,0.028382
8590794,"Schlieren, Kesslerstrasse",,0.000065,85,3,2,5,49625,49656,99281,13,0.147281,0.161547,2068.923016,0.000001,0
8590796,"Schlieren, Nassacker",,0.000035,22,1,1,2,17318,17322,34640,13,0.146959,0.159391,389,0,0
8590622,"Glattbrugg, Giebeleichstrasse",,0.000037,107,2,3,5,55655,55654,111309,13,0.147421,0.163072,4574.871429,0.020053,0.000522
8590629,"Glattbrugg, Post",,0.000023,107,1,1,2,51247,51247,102494,10,0.171852,0.186255,2721.318681,0,0.000497
8590621,"Glattbrugg, Frohbühlstrasse",,0.000014,107,1,1,2,51247,51247,102494,11,0.147009,0.156973,2757.318681,0.019567,0
8590623,"Glattbrugg, Halden",,0.000021,107,1,1,2,5985,5985,11970,14,0.098331,0.105246,2905.5,0.000012,0
8590740,"Opfikon, Aublick",,0.000026,107,1,1,2,13346,13344,26690,5,0.333333,0.436111,0,0.001126,0.001152
8590633,"Glattpark, Chavez-Allee",,0.000051,85,3,1,4,50502,50504,101006,10,0.170585,0.183627,949,0.020637,0
8591211,"Zürich, Im Klösterli",,0.000026,85,1,2,3,5185,5286,10471,10,0.163654,0.181409,8,0.000001,0.001767
8591443,"Zürich, Zoo/Forrenweid",,0.000032,85,1,1,2,19061,19063,38124,2,0.666667,0.75,1807.314773,0,0.000262
8590636,"Greifensee, Im Langacher",,0.00003,84,1,1,2,11610,11610,23220,5,0.35,0.445238,742,0.000004,0
8590637,"Greifensee, Pfisterhölzli",,0.000037,84,1,2,3,11610,11610,23220,4,0.461538,0.597222,642,0,0
8590638,"Greifensee, Städtli",,0.000026,84,1,1,2,3157,3157,6314,4,0.4,0.520833,108,0,0
8590639,"Greifensee, Tumigerstrasse",,0.000026,84,1,1,2,8453,8453,16906,3,0.5,0.611111,324,0,0
8590640,"Greifensee, Im Hof",,0.000033,84,1,1,2,3157,3157,6314,3,0.5,0.611111,3,0,0
8590641,"Herrliberg, Busenhardstrasse",,0.000077,8,1,1,2,5419,5418,10837,5,0.333333,0.456667,82,0,0
8590642,"Herrliberg, Kirche Wetzwil",,0.000047,8,2,1,3,10461,10461,20922,3,0.5,0.611111,38,0,0
8590643,"Herrliberg, Oberdorfweg",,0.000077,8,1,1,2,5418,5419,10837,4,0.4,0.520833,68,0,0
8590644,"Herrliberg, Rain",,0.000076,8,1,1,2,5419,5418,10837,3,0.5,0.611111,52,0,0
8590653,"Horgen, Käpfnach",,0.000088,63,4,2,6,12082,12073,24155,6,0.309524,0.421795,1237.666667,0,0
8590654,"Horgen, Meilibach",,0.000048,63,1,2,3,7293,7303,14596,5,0.346154,0.466667,443.833333,0,0
8590656,"Horgen, Rietli",,0.000031,63,1,1,2,4867,4830,9697,5,0.32,0.4,0,0,0
8590657,"Horgen, Risi/Dow",,0.000048,63,1,2,3,4780,4782,9562,5,0.357143,0.47,564.833333,0,0
8590658,"Horgen, Rotweg",,0.000079,63,3,1,4,9394,9422,18816,4,0.411765,0.488095,545.666667,0,0
8594182,"Horgen, Wannerstrasse",,0.000076,63,4,1,5,9565,7295,16860,1,1,1,55,0,0
8590661,"Horgen, Teufenbach",,0.000031,63,1,1,2,2654,2654,5308,1,1,1,122,0,0
8590668,"Itschnach, Rebweg",,0.000072,86,4,1,5,42160,42143,84303,2,0.6,0.666667,933,0,0
8590703,"Küsnacht ZH, Oberfeld",,0.00002,86,1,1,2,6455,6455,12910,1,1,1,166,0,0
8590704,"Küsnacht ZH, Reform. Kirche",,0.000028,86,1,1,2,6452,6347,12799,1,1,1,1,0,0
8590670,"Kilchberg ZH, Altersheim",,0.000021,130,1,1,2,7055,7055,14110,15,0.11541,0.127193,707.333333,0,0
8590672,"Kilchberg ZH, Bächlerstrasse",,0.000011,130,0,1,1,0,3290,3290,15,0.11541,0.127193,0,0,0
8590674,"Kilchberg ZH, Bendlikon",,0.000025,130,2,2,4,25780,25650,51430,14,0.130015,0.145622,199.333333,0.000095,0.000097
8590675,"Kilchberg ZH, Gottlieb-Binder",,0.000032,130,2,2,4,10346,10345,20691,14,0.146147,0.163477,1302.35,0.000095,0.0039
8590680,"Kilchberg ZH, Kreuzstrasse",,0.000071,130,4,3,7,36364,36170,72534,16,0.117562,0.135931,1061.483333,0.003808,0.000002
8590677,"Kilchberg ZH, Hornhaldenstr.",,0.000026,130,2,1,3,22552,22596,45148,15,0.144096,0.157889,669.5,0.000002,0.000092
8590688,"Kilchberg ZH, Schoorenstrasse",,0.000049,130,2,1,3,6578,6578,13156,16,0.115936,0.12495,897,0,0
8590681,"Kilchberg ZH, Lindt & Sprüngli",,0.000041,130,2,3,5,28938,28885,57823,18,0.096454,0.110726,644,0.000002,0
8590682,"Kilchberg ZH, Mythenstrasse",,0.000023,130,1,1,2,3290,3290,6580,17,0.104203,0.112115,181,0,0
8590686,"Kilchberg ZH, Schlimbergstr.",,0.000023,130,1,1,2,3287,3288,6575,17,0.104203,0.112115,181,0,0
8590683,"Kilchberg ZH, Paradiessteig",,0.000031,130,1,1,2,22537,22530,45067,16,0.115936,0.12495,62,0,0
8590684,"Kilchberg ZH, Paradiesstrasse",,0.000023,130,1,1,2,22308,22398,44706,23,0.065525,0.072762,414,0,0
8590685,"Kilchberg ZH, Sanatorium",,0.000037,130,1,1,2,22530,22575,45105,15,0.130702,0.141961,298,0,0
8590689,"Kilchberg ZH,Schulhaus Dorfstr",,0.000073,130,2,1,3,13633,13631,27264,15,0.130702,0.141961,1901.316667,0,0
8590690,"Kilchberg ZH, Schwelle",,0.000104,130,2,3,5,36206,29074,65280,14,0.149849,0.166914,2726.316667,0,0
8590691,"Kilchberg ZH, Stockengut",,0.00004,130,1,1,2,3290,3290,6580,1,1,1,70,0,0
8594253,"Kilchberg ZH, Emilienheim",,0.000045,130,1,1,2,3288,3288,6576,1,1,1,1,0,0
8590692,"Kilchberg ZH, Weinbergstrasse",,0.00004,85,1,1,2,22496,22585,45081,13,0.1735,0.18818,2673.316667,0,0
8590784,"Rüschlikon, Weidstrasse",,0.000052,130,1,1,2,22157,22201,44358,13,0.1735,0.18818,5057.712121,0,0
8590693,"Kloten, Breitistrasse/Bahnhof",,0.000033,107,1,1,2,15229,15228,30457,5,0.333333,0.456667,1800,0.000078,0
8590694,"Kloten, Buchhalden",,0.000039,107,1,1,2,15228,15231,30459,4,0.4,0.520833,1204,0,0
8590697,"Kloten, Schluefweg",,0.000044,107,1,1,2,15231,15222,30453,3,0.5,0.611111,606,0,0
8590699,"Kloten, Stadthaus",,0.000156,107,3,1,4,37277,15229,52506,1,1,1,607,0.000081,0
8590701,"Küsnacht ZH, Gartenstrasse",,0.000022,86,1,2,3,12906,12907,25813,2,0.666667,0.75,1254,0,0
8590702,"Küsnacht ZH, Hallenbad",,0.00002,86,1,1,2,6452,6452,12904,2,0.666667,0.75,364,0,0
8590706,"Langnau am Albis, Altersheim",,0.000016,63,1,1,2,1328,1328,2656,2,0.666667,0.75,86,0,0
8590708,"Langnau am Albis, Langmoos",,0.000025,63,1,1,2,1328,1328,2656,1,1,1,44,0,0
8595267,"Nürensdorf, Zentrum",,0.000145,84,5,1,6,14138,6520,20658,1,1,1,239.666667,0.000002,0
8590711,"Maiacher, Station",,0.000064,86,3,1,4,936,62,998,13,0.131045,0.139973,6456.310195,0,0
8590715,"Maur, Platten",,0.000077,129,3,1,4,21908,21905,43813,12,0.166031,0.180683,5895.562977,0.000001,0
8591107,"Zürich, Zentrum Witikon",,0.00013,129,7,4,11,137275,143076,280351,9,0.19319,0.216034,27491.554881,0.004866,0.000803
8591115,"Zürich, Drusbergstrasse",,0.000038,129,1,2,3,57028,57055,114083,9,0.206026,0.226728,5691.085893,0.000122,0.000888
8590720,"Nänikon, Grossriet",,0.000062,84,2,1,3,11610,11610,23220,2,0.666667,0.75,222,0,0
8590721,"Nänikon, Heuwinkelstrasse",,0.000063,84,1,1,2,11610,11610,23220,1,1,1,112,0,0
8590726,"Oberengstringen, Lanzrain",,0.000024,22,3,2,5,38680,39316,77996,15,0.144675,0.159346,547.299206,0.000029,0.000006
8590802,"Schlieren, Talacker-Windegg",,0.00005,85,2,3,5,34780,34781,69561,12,0.172168,0.193501,582.35873,0.000011,0.011625
8590831,"Unterengstringen, Aegelsee",,0.000054,85,3,3,6,17002,16972,33974,11,0.171571,0.191308,1364.301104,0.005564,0.007794
8590832,"Unterengstringen, Eckstein",,0.000059,85,3,4,7,34806,34812,69618,11,0.172189,0.194587,2721.652691,0.005602,0.003847
8590729,"Oberhasli, Dorf",,0.000016,107,1,2,3,14983,14983,29966,4,0.461538,0.597222,270,0,0
8590733,"Oberhasli, Spielplatz",,0.000039,107,1,1,2,7493,7494,14987,2,0.666667,0.75,6,0,0
8590730,"Oberhasli, Hasliberg",,0.000018,107,1,1,2,7494,7494,14988,5,0.333333,0.456667,138,0,0
8590731,"Oberhasli, Moosacker",,0.000026,107,1,1,2,7494,7494,14988,4,0.4,0.520833,96,0,0
8590732,"Oberhasli, Post",,0.000033,107,1,1,2,7494,7493,14987,3,0.5,0.611111,52,0,0
8590734,"Oberrieden Dorf, Bahnhof",,0.000049,130,2,1,3,2386,2387,4773,8,0.192771,0.258482,1112,0,0
8590735,"Oberrieden, Hubstrasse",,0.000052,130,1,1,2,2387,2387,4774,7,0.223881,0.289048,1019,0,0
8590736,"Oberrieden, Wattenbühlweg",,0.000055,130,1,1,2,2387,2387,4774,6,0.269231,0.338095,924,0,0
8590737,"Oetwil an der Limmat, Halde",,0.000022,85,2,2,4,24082,24122,48204,3,0.466667,0.571429,958,0.000024,0
8590738,"Oetwil an der Limmat, Oberdorf",,0.00002,85,1,1,2,12074,12073,24147,3,0.428571,0.5,0,0,0
8590741,"Opfikon, Austrasse",,0.000064,107,2,2,4,37271,37256,74527,12,0.121714,0.132642,4257.75,0,0
8590742,"Opfikon, Bahnhof",,0.000038,107,1,1,2,5985,5985,11970,12,0.121429,0.130323,0,0,0
8590743,"Opfikon, Bubenholz",,0.000048,107,2,1,3,20850,20853,41703,4,0.416667,0.516667,3050,0.001152,0
8590744,"Opfikon, Dorf",,0.000052,107,1,2,3,20853,20853,41706,3,0.571429,0.708333,2444,0,0
8590745,"Opfikon, Fernsicht",,0.000033,107,1,1,2,13347,13345,26692,3,0.5,0.611111,0,0,0
8590746,"Opfikon, Grätzli",,0.000061,107,2,1,3,20851,20852,41703,2,0.666667,0.75,1226,0,0
8590747,"Opfikon, Grossacker",,0.000063,107,1,1,2,20852,20852,41704,1,1,1,614,0,0
8590896,"Wallisellen, Schäfligraben",,0.00004,107,1,1,2,24512,24617,49129,1,1,1,141.5,0,0.000028
8590751,"Pfaffhausen, Feldhof",,0.000022,129,1,1,2,22602,22602,45204,11,0.136107,0.147172,1200,0.000003,0
8590754,"Regensdorf, Altersheim",,0.000035,107,2,1,3,11418,11418,22836,13,0.118904,0.126114,740,0,0
8590755,"Regensdorf, Moosächer",,0.000041,107,1,1,2,11418,11418,22836,12,0.134545,0.143189,1047,0,0
8590766,"Rümlang, Oberdorf",,0.00003,107,2,1,3,21595,21582,43177,11,0.149085,0.160467,1217.890886,0,0
8590767,"Rümlang, Gemeindehaus",,0.000037,107,1,2,3,21582,21594,43176,10,0.174693,0.192449,1512.890886,0,0.002387
8591207,"Zürich, Im Ebnet",,0.000014,85,1,2,3,18785,18785,37570,8,0.219941,0.259984,416.777128,0.003133,0.02325
8590768,"Rümlang, Riedmattstrasse",,0.000051,107,2,1,3,14983,14981,29964,1,1,1,50,0,0
8590771,"Rüschlikon, Bahnhof",,0.00003,130,1,1,2,22398,22198,44596,22,0.069894,0.077297,660,0,0
8590772,"Rüschlikon, Belvoir",,0.000037,130,1,1,2,22198,22309,44507,21,0.074903,0.082641,904,0,0
8590775,"Rüschlikon, Eggrain",,0.000066,130,2,2,4,24403,24514,48917,19,0.087504,0.097917,2857.666667,0,0
8590776,"Rüschlikon, Langhaldenstrasse",,0.000039,130,1,1,2,22417,22278,44695,19,0.087243,0.09496,0,0,0
8590777,"Rüschlikon, Loorain",,0.000072,130,2,1,3,24375,24420,48795,18,0.095268,0.103718,3323.666667,0,0
8590780,"Rüschlikon, Park im Grüene",,0.000077,130,2,2,4,25027,25113,50140,16,0.116873,0.130331,4724.712121,0,0
8590782,"Rüschlikon, Säumerstrasse",,0.000044,130,1,1,2,22485,22331,44816,15,0.129515,0.138224,4625.712121,0,0
8590783,"Rüschlikon, Schlossstrasse",,0.000048,130,1,1,2,22331,22157,44488,14,0.148279,0.158954,4842.712121,0,0
8590787,"Schlieren, Bahnhof Nord",,0.000011,85,0,1,1,0,4821,4821,14,0.1119,0.118317,0,0,0
8590801,"Schlieren, Steinacker",,0.000091,85,4,3,7,49761,49752,99513,12,0.172398,0.193846,40141.211194,0.000012,0.006789
8590803,"Schlieren, Wagonsfabrik",,0.000032,85,1,1,2,47927,47925,95852,12,0.170948,0.187456,4953.430282,0,0.000458
8590789,"Schlieren, Am Rietpark",,0.00002,85,1,1,2,4821,4821,9642,13,0.125619,0.13272,330,0,0
8590791,"Schlieren, Gasometerbrücke",,0.000016,85,1,1,2,47923,47926,95849,14,0.127926,0.136287,5185.430282,0.004794,0
8590792,"Schlieren, Heimeliweg",,0.000029,22,1,1,2,17323,17318,34641,14,0.128416,0.137511,487,0,0
8590793,"Schlieren, Industrie Gaswerk",,0.000028,85,1,1,2,4821,4821,9642,12,0.14323,0.151665,658,0,0
8590795,"Schlieren, Mülligen",,0.000024,85,1,1,2,47926,47927,95853,13,0.146314,0.157287,5070.430282,0,0
8590798,"Schlieren, Goldschlägistrasse",,0.000035,85,1,1,2,4821,4821,9642,11,0.166667,0.177825,984,0,0
8590799,"Schlieren, Rütistrasse",,0.00004,85,1,1,2,4821,4821,9642,10,0.19939,0.216748,1308,0,0.027704
8590833,"Unterengstringen, Langacher",,0.000049,85,3,4,7,39379,39387,78766,10,0.204545,0.230097,2192.333719,0.000411,0.03194
8590848,"Urdorf, Spitzacker",,0.000109,85,4,4,8,61437,52142,113579,10,0.202686,0.227389,4334,0,0.031779
8590849,"Urdorf, Uitikonerstrasse",,0.000034,85,1,1,2,34923,17220,52143,10,0.19939,0.216748,0,0.000734,0.027704
8590838,"Urdorf, Heinrich-Stutz-Strasse",,0.00003,85,1,1,2,9297,9294,18591,14,0.114238,0.124037,15.066667,0,0.005436
8591261,"Zürich, Loorenstrasse",,0.000064,85,3,7,10,130214,130182,260396,9,0.248819,0.303431,4657.300718,0.021202,0.09945
8590811,"Thalwil, Aegertli",,0.000044,130,1,2,3,2628,2628,5256,3,0.5,0.611111,249,0,0
8590824,"Thalwil, Post",,0.000107,130,5,2,7,4297,3406,7703,3,0.571429,0.708333,498.5,0,0
8590820,"Thalwil, Oeggisbüelplatz",,0.000045,130,1,1,2,2387,2387,4774,5,0.352941,0.463889,40,0,0
8590818,"Thalwil, In Reben",,0.000022,130,1,1,2,1293,1293,2586,2,0.666667,0.75,230,0,0
8590819,"Thalwil, Mettli",,0.00004,130,1,1,2,2387,2387,4774,6,0.291667,0.397619,147,0,0
8590825,"Thalwil, Rainstrasse",,0.000029,130,1,1,2,1293,1293,2586,1,1,1,116,0,0
8590826,"Thalwil, Rudishaldenstrasse",,0.000075,130,2,1,3,2623,2627,5250,2,0.666667,0.75,308,0,0
8590828,"Thalwil, Seehaldenstrasse",,0.000075,130,1,1,2,2627,2628,5255,1,1,1,155,0,0
8590910,"Weiningen ZH, Aegelsee",,0.000057,85,3,1,4,17380,17379,34759,12,0.144737,0.155534,0,0.00156,0.001781
8590834,"Urdorf Weihermatt, Bahnhof",,0.000047,85,2,2,4,34489,34956,69445,13,0.129118,0.143611,3450.951828,0.000894,0.000282
8590837,"Urdorf, Feldegg",,0.000043,85,2,3,5,51752,51749,103501,13,0.129081,0.145994,1763.468254,0.000095,0.002124
8591402,"Zürich, Tüffenwies",,0.000201,85,11,8,19,164026,154697,318723,4,0.473684,0.560185,15225.109883,0.050994,0.010305
8591274,"Zürich, Micafil",,0.000061,85,3,5,8,105018,105043,210061,7,0.276062,0.320579,1495.262539,0.006822,0.135969
8591448,"Zürich, Zypressenstrasse",,0.000068,85,4,2,6,91916,47423,139339,2,0.75,0.833333,733.7062,0.012823,0.000845
8591891,"Spreitenbach, Altersheim",,0.000079,85,3,1,4,30983,14853,45836,1,1,1,294.606929,0.000222,0.003431
8590841,"Urdorf, Neumatt",,0.000066,85,3,2,5,44114,44199,88313,12,0.145887,0.159228,5320.944444,0.000187,0
8590843,"Urdorf, Niederurdorf",,0.000039,85,1,3,4,44163,44181,88344,11,0.170127,0.188621,3218.444444,0,0
8590842,"Urdorf, Neumattstrasse",,0.000023,85,1,1,2,17241,17241,34482,12,0.144902,0.15467,863.055556,0.000049,0
8590844,"Urdorf, Oberurdorf",,0.00005,85,2,2,4,26463,26441,52904,12,0.145273,0.157193,1046,0,0
8590845,"Urdorf, Rainweg",,0.000031,85,1,1,2,17241,17241,34482,11,0.16895,0.182813,502.055556,0,0
8590846,"Urdorf, Schlierenstrasse",,0.000043,85,2,2,4,34456,34445,68901,11,0.169371,0.185259,167,0,0
8590847,"Urdorf, Sonne",,0.000051,85,2,1,3,26467,26479,52946,11,0.16895,0.182813,166.5,0,0
8590857,"Wädenswil, Eichweid",,0.000057,63,2,1,3,12233,12239,24472,6,0.333333,0.4125,186.166667,0,0
8590869,"Wädenswil, Sonnenrainstrasse",,0.000083,63,5,2,7,11631,11631,23262,3,0.555556,0.666667,421.916667,0,0
8590875,"Wädenswil, Tobelrain",,0.000061,63,1,1,2,11712,4439,16151,1,1,1,63.833333,0,0
8590862,"Wädenswil, Lätten",,0.000037,63,1,1,2,3186,3281,6467,3,0.5,0.611111,372,0,0
8590863,"Wädenswil, Meierhof",,0.000056,63,3,2,5,6891,6991,13882,3,0.571429,0.708333,488,0,0
8590864,"Wädenswil, Meierhof-Rain",,0.000035,63,1,1,2,3920,3920,7840,3,0.5,0.611111,0,0,0
8590866,"Wädenswil, Neudorf",,0.000042,63,1,1,2,3281,3281,6562,2,0.666667,0.75,250,0,0
8590867,"Wädenswil, Reidbach",,0.000064,63,2,1,3,6991,3920,10911,2,0.666667,0.75,248,0,0
8590868,"Wädenswil, Schlossbergstrasse",,0.000066,63,1,1,2,3920,3814,7734,1,1,1,125,0,0
8590871,"Wädenswil, Tiefenhof",,0.000047,63,1,1,2,3281,3281,6562,1,1,1,126,0,0
8590872,"Wädenswil, Tiefenhofstrasse",,0.000069,63,3,1,4,21941,21953,43894,3,0.5,0.583333,235.666667,0,0
8590874,"Wädenswil, Töbelibach",,0.000059,63,2,1,3,11711,11712,23423,2,0.666667,0.75,199.833333,0,0
8590879,"Waldburg, Station",,0.000043,129,2,1,3,2075,2075,4150,14,0.101247,0.113052,3165.9,0.00002,0
8590880,"Wallisellen, Alterszentrum",,0.000015,107,1,1,2,24617,24617,49234,10,0.190476,0.286359,3014.294881,0.000289,0
8590881,"Wallisellen, Belair",,0.000083,107,3,2,5,66518,66536,133054,10,0.159042,0.174902,12601.34725,0.001159,0
8590882,"Wallisellen, Blumenweg",,0.000015,107,1,1,2,15044,15049,30093,11,0.138033,0.148756,982.35262,0.000289,0
8590884,"Wallisellen, Florastrasse",,0.000059,107,2,2,4,46302,46308,92610,10,0.159707,0.176088,7947.338452,0,0
8590883,"Wallisellen, Bützacker",,0.000024,107,1,2,3,24617,25948,50565,9,0.220588,0.362011,2569.294881,0,0
8590887,"Wallisellen, Guyer-Weg",,0.000026,107,1,1,2,1332,1332,2664,9,0.2,0.30232,400.933333,0,0
8590888,"Wallisellen, Hallenbad",,0.000029,107,1,1,2,24617,24617,49234,9,0.2,0.30232,13,0,0
8590885,"Wallisellen, Furtbach",,0.000036,107,1,2,3,15049,15049,30098,8,0.237288,0.365051,6885.205119,0,0
8590892,"Wallisellen, Lindenplatz",,0.000068,107,3,2,5,27373,25844,53217,8,0.230769,0.377282,1449.228215,0,0
8590886,"Wallisellen, Gemeindehaus",,0.000021,107,1,1,2,24524,24617,49141,10,0.177215,0.267744,462,0,0
8590906,"Wangen, Dürrbach",,0.000039,107,1,1,2,31062,31061,62123,1,1,1,81.833333,0,0.000883
8590894,"Wallisellen, Riedenerstrasse",,0.000055,107,2,1,3,15049,15049,30098,7,0.230769,0.328836,5868,0,0
8590895,"Wallisellen, Rosenberg",,0.000058,107,1,1,2,15049,15049,30098,6,0.266667,0.3625,5224,0,0
8590897,"Wallisellen, Spitzacker",,0.00006,107,1,1,2,15049,15049,30098,5,0.318182,0.409524,4578,0,0
8590898,"Wallisellen, Sportzentrum",,0.000062,107,1,1,2,15049,15049,30098,4,0.4,0.486111,3930,0,0
8590900,"Wallisellen, Zielacker",,0.000063,107,1,2,3,15049,13716,28765,3,0.555556,0.666667,3280,0,0
8594187,"Wallisellen, Friedhof",,0.000043,107,1,1,2,6859,6858,13717,3,0.5,0.611111,3,0,0
8590901,"Wangen, Dorfplatz",,0.000053,107,2,3,5,45829,47200,93029,4,0.470588,0.614583,4627.833333,0.000885,0
8590902,"Wangen, Hätzelwisen",,0.000026,107,1,1,2,14797,14800,29597,5,0.318182,0.409524,0,0,0
8590903,"Wangen, Oberdorf",,0.000048,107,2,1,3,31669,30328,61997,4,0.4,0.486111,6,0,0
8590904,"Wangen, Stierwisen",,0.000067,107,2,2,4,45862,45861,91723,3,0.555556,0.666667,2692.833333,0,0
8590905,"Wangen, Weidli",,0.000039,107,1,1,2,14799,14800,29599,2,0.666667,0.75,1308,0,0
8590907,"Wangen, Flugsicherung",,0.000044,107,1,1,2,14800,14800,29600,1,1,1,655,0,0
8590923,"Winterthur, Bezirksgebäude",,0.000066,68,2,2,4,19320,19321,38641,11,0.187919,0.271076,3340,0,0
8590925,"Winterthur, Breite",,0.000026,68,1,1,2,4452,4491,8943,9,0.190476,0.278208,240,0,0
8590945,"Winterthur, Gaswerk",,0.000076,68,3,2,5,16981,16582,33563,10,0.210526,0.315258,3183.333333,0.000002,0
8590935,"Winterthur, Eishalle",,0.000061,68,2,2,4,11889,11884,23773,6,0.297872,0.405952,2232.1,0,0
8590947,"Winterthur, Grüntal",,0.000042,68,1,1,2,11627,11631,23258,6,0.272727,0.348611,12,0,0
8590937,"Winterthur, Etzberg",,0.000037,68,1,1,2,11633,11627,23260,7,0.22807,0.300733,196,0,0
8590939,"Winterthur, Feldtal",,0.000102,68,2,2,4,14718,14712,29430,5,0.35,0.504762,1356.4,0,0
8590951,"Winterthur, Gutschick",,0.000054,68,1,1,2,6227,6216,12443,5,0.315789,0.422222,0,0,0
8590949,"Winterthur, Grüzenstrasse",,0.000072,68,2,2,4,11882,11889,23771,5,0.34375,0.45,1680.1,0,0
8590979,"Winterthur, Oberseen",,0.000042,68,1,1,2,11638,11647,23285,5,0.322581,0.395,0,0,0
8590950,"Winterthur, Guggenbühl",,0.000062,68,2,1,3,12639,12653,25292,9,0.2,0.31433,2052,0,0
8590953,"Winterthur, Haldengut",,0.000039,68,1,1,2,7433,7433,14866,10,0.186441,0.288997,994,0,0
8590955,"Winterthur, Hammerweg",,0.000044,68,1,1,2,7433,7435,14868,9,0.208333,0.31623,810,0,0
8590959,"Winterthur, Hinterwiesli",,0.0001,68,2,1,3,14701,14718,29419,4,0.384615,0.483333,964.4,0,0
8590961,"Winterthur, Hohlandweg",,0.000064,68,1,1,2,12653,12661,25314,8,0.222222,0.339732,1832,0,0
8590963,"Winterthur, Im Geissacker",,0.000048,68,1,1,2,7435,7435,14870,8,0.236842,0.35754,624,0,0
8590965,"Winterthur, Irchelstrasse",,0.000033,68,1,1,2,4491,4433,8924,8,0.215686,0.303139,223,0,0
8590966,"Winterthur, Jonas Furrer",,0.000039,68,1,1,2,4433,4448,8881,7,0.25,0.337619,204,0,0
8590967,"Winterthur, Kantonsschule",,0.000052,68,1,2,3,7435,7435,14870,7,0.275862,0.449107,436,0,0
8590972,"Winterthur, Musikschule",,0.000033,68,1,1,2,3739,3739,7478,7,0.25,0.370408,0,0,0
8590976,"Winterthur, Nussbaumweg",,0.000044,68,1,1,2,4448,4491,8939,6,0.3,0.392593,183,0,0
8591002,"Winterthur, Steig",,0.000043,68,1,1,2,4111,4111,8222,6,0.3,0.392593,1602,0,0
8590977,"Winterthur, Oberes Büel",,0.000061,68,2,1,3,7435,7435,14870,6,0.285714,0.408333,54,0,0
8590982,"Winterthur, Palmstrasse",,0.000066,68,1,1,2,12665,12663,25328,6,0.285714,0.408333,1386,0,0
8590978,"Winterthur, Oberfeld",,0.000096,68,1,1,2,14718,14709,29427,3,0.5,0.583333,765.4,0,0
8590980,"Winterthur, Oberwinterthur",,0.000065,68,1,1,2,12661,12665,25326,7,0.25,0.370408,1610,0,0
8590985,"Winterthur, Post Seen",,0.000093,68,3,2,5,15798,15794,31592,4,0.470588,0.572917,174.6,0,0
8590992,"Winterthur, Schloss",,0.000092,68,1,2,3,14709,12996,27705,2,0.75,0.833333,564.4,0,0
8590988,"Winterthur, Römertor",,0.000119,68,2,1,3,20098,12656,32754,5,0.333333,0.456667,1210,0,0
8590991,"Winterthur, Scheidegg",,0.000083,68,2,2,4,11888,11716,23604,3,0.571429,0.708333,836,0,0
8591005,"Winterthur, Strahlegg",,0.000054,68,1,1,2,11637,5820,17457,1,1,1,2,0,0
8590997,"Winterthur, Seen",,0.00009,68,2,2,4,16609,16624,33233,1,1,1,183.066667,0,0
8591015,"Winterthur, Wülflingen",,0.000088,68,2,1,3,13010,12462,25472,1,1,1,93.633333,0,0
8590998,"Winterthur, St. Urban",,0.000046,68,1,1,2,11632,11622,23254,3,0.5,0.611111,420,0,0
8591000,"Winterthur, Stadtrain",,0.000112,68,1,1,2,12656,12662,25318,4,0.4,0.520833,972,0,0
8591003,"Winterthur, Stocken",,0.00005,68,1,1,2,11622,11637,23259,2,0.666667,0.75,212,0,0
8591004,"Winterthur, Storchenbrücke",,0.000085,68,2,2,4,8602,8544,17146,5,0.380952,0.514583,1570,0,0
8591007,"Winterthur, Swica",,0.000106,68,1,1,2,12662,12663,25325,3,0.5,0.611111,732,0,0
8591008,"Winterthur, Talacker",,0.000101,68,1,1,2,12663,12658,25321,2,0.666667,0.75,490,0,0
8591011,"Winterthur, Tössfeld",,0.000047,68,1,1,2,4113,4115,8228,4,0.416667,0.516667,876,0,0
8591014,"Winterthur, Waldheim",,0.000051,68,1,1,2,4491,4491,8982,4,0.416667,0.516667,5,0,0
8591012,"Winterthur, Turmstrasse",,0.000047,68,1,1,2,4431,4491,8922,5,0.333333,0.436111,234,0,0
8591016,"Winterthur, Wylandbrücke",,0.000094,68,2,2,4,8606,8163,16769,3,0.571429,0.708333,654,0,0
8591018,"Winterthur, Zeughaus",,0.000051,68,1,1,2,4017,4452,8469,3,0.5,0.611111,0,0,0
8591020,"Winterthur, Zinzikon",,0.000097,68,1,1,2,12658,12657,25315,1,1,1,246,0,0
8591023,"Zollikerb., Langägerten/Spital",,0.000047,129,1,3,4,2075,15178,17253,13,0.112232,0.129583,2915.9,0,0.000049
8591024,"Zollikerberg, Hasenbart",,0.000024,129,1,1,2,13103,13107,26210,13,0.111485,0.123014,0,0.000007,0.000047
8591027,"Zollikerberg, Sennhof",,0.000024,129,1,2,3,1400,1375,2775,13,0.111673,0.126159,19.508333,0.000007,0.001941
8591028,"Zollikerberg, Station",,0.000055,129,3,3,6,14357,13953,28310,12,0.125,0.142164,2129.225,0.00031,0.003826
8591233,"Zürich, Klusplatz",,0.000247,85,9,10,19,283638,283682,567320,7,0.293939,0.34773,26810.128727,0.016774,0.389671
8591424,"Zürich, Waserstrasse",,0.000078,85,2,2,4,56988,57042,114030,3,0.470588,0.5625,2815.552361,0.000343,0.001939
8591826,"Binz bei Maur, Gassacher",,0.000099,85,5,2,7,27894,27549,55443,2,0.625,0.7,1539.644517,0.012464,0.02461
8591029,"Zollikerberg, Trichtenhauserm.",,0.000027,129,1,1,2,13103,13097,26200,11,0.140192,0.150035,1802,0.000581,0
8591116,"Zürich, Dunkelhölzli",,0.000042,85,4,4,8,115065,114982,230047,8,0.217432,0.247439,6704.748392,0.043446,0.008972
8591101,"Zürich, Bucheggplatz",,0.000131,85,13,11,24,240000,267754,507754,8,0.272808,0.320226,44533.493578,0.20803,0.051275
8591182,"Zürich, Hegianwandweg",,0.000049,85,4,3,7,107478,107618,215096,8,0.236458,0.265686,936.931726,0.016632,0.101237
8591192,"Zürich, Hinterbergstrasse",,0.000019,85,1,2,3,27644,27641,55285,9,0.19761,0.217853,0,0.00998,0.052538
8591197,"Zürich, Hohenklingensteig",,0.00011,85,7,4,11,100179,99521,199700,9,0.243764,0.279736,6034.026286,0.035476,0.108693
8591198,"Zürich, Hölderlinsteig",,0.000033,85,1,2,3,54847,54848,109695,8,0.236142,0.261709,219.682913,0,0.06481
8591202,"Zürich, Hottingerplatz",,0.000043,85,1,3,4,43628,43646,87274,8,0.232684,0.260615,337.748626,0.000396,0.157041
8591040,"Zürich, Altenhofstrasse",,0.000033,85,1,2,3,34346,34352,68698,10,0.166021,0.182225,444.687424,0.000948,0.004318
8591078,"Zürich, Bethanien",,0.000013,85,1,2,3,28284,28316,56600,8,0.233364,0.260877,0,0.010026,0.01299
8591089,"Zürich, Bleulerstrasse",,0.000025,85,1,1,2,17176,17174,34350,10,0.165482,0.17903,0,0.000656,0.004219
8591043,"Zürich, Am Börtli",,0.000013,85,1,1,2,12157,12331,24488,13,0.10567,0.125102,1264,0.017864,0
8591045,"Zürich, Appenzellerstrasse",,0.000022,85,1,1,2,12331,12332,24663,12,0.116715,0.135951,1029,0,0
8591054,"Zürich, Bahnhof Affoltern",,0.000034,85,2,4,6,76816,76791,153607,8,0.207533,0.233289,2720.224859,0.003489,0.004743
8591090,"Zürich, Blumenfeldstrasse",,0.000018,85,1,1,2,29799,29807,59606,10,0.157001,0.168694,0,0.000721,0.000439
8591050,"Zürich, Auzelg Ost",,0.000019,85,1,1,2,24672,24663,49335,9,0.188329,0.211391,310.836094,0.006886,0.000407
8591175,"Zürich, Hallenbad Oerlikon",,0.000039,85,2,2,4,92893,92868,185761,9,0.197689,0.226278,1732.026358,0.00292,0.022125
8591118,"Zürich, Einfangstrasse",,0.000048,85,3,3,6,116133,116214,232347,8,0.214343,0.23763,5054.429539,0.008782,0.004476
8591094,"Zürich, Botanischer Garten",,0.000057,85,5,3,8,90538,90420,180958,9,0.197521,0.220207,4485.649662,0.027763,0.00785
8591135,"Zürich, Förrlibuckstrasse",,0.000125,85,7,6,13,110269,110691,220960,8,0.24257,0.275621,9070.397149,0.135565,0.107179
8591137,"Zürich, Freiestrasse",,0.000043,85,2,3,5,111600,111628,223228,8,0.238322,0.268367,6390.030916,0.001328,0.110566
8591151,"Zürich, Friesenbergstrasse",,0.000087,85,4,6,10,116519,116616,233135,8,0.225557,0.258238,5461.46304,0.012533,0.115433
8591113,"Zürich, Dreispitz",,0.000046,85,3,2,5,92855,92875,185730,9,0.185546,0.203771,860.879157,0.002891,0.001778
8591088,"Zürich, Birchstrasse",,0.000018,85,1,3,4,35164,35187,70351,9,0.209967,0.232721,243.478779,0.000558,0.009689
8591108,"Zürich, Chaletweg",,0.000022,85,2,3,5,34267,34267,68534,8,0.208059,0.231399,134.298167,0.009004,0.00858
8591070,"Zürich, Baslerstrasse",,0.000029,85,3,2,5,67733,67773,135506,9,0.213082,0.234289,221.829905,0.044812,0.007974
8591122,"Zürich, ETH Hönggerberg",,0.000045,85,5,7,12,79494,79450,158944,7,0.253776,0.290032,13560.557942,0.01882,0.093529
8591161,"Zürich, Glaubtenstrasse Süd",,0.000019,85,1,3,4,17565,17570,35135,8,0.214851,0.24255,291.899683,0.00265,0.073123
8591145,"Zürich, Friedhof Sihlfeld",,0.000049,85,3,3,6,53141,53136,106277,8,0.243189,0.27503,7897.126371,0.031435,0.115793
8591158,"Zürich, Giblenstrasse",,0.000021,85,1,2,3,40890,40897,81787,8,0.231064,0.257889,500.002035,0.001337,0.079566
8591160,"Zürich, Glaubtenstrasse",,0.00007,85,5,7,12,160545,160497,321042,7,0.26589,0.305132,10763.355207,0.00584,0.114773
8591169,"Zürich, Güterbahnhof",,0.000086,85,7,2,9,115947,115879,231826,8,0.237595,0.266662,3202.436751,0.049144,0.068048
8591136,"Zürich, Frankental",,0.000135,85,5,7,12,117637,118192,235829,8,0.271605,0.314286,20576.625367,0.021498,0.426017
8591155,"Zürich, Geeringstrasse",,0.000047,85,4,4,8,89917,89828,179745,8,0.229167,0.256833,2920.193049,0.034082,0.057912
8591163,"Zürich, Goldackerweg",,0.00004,85,5,2,7,33516,33499,67015,9,0.22268,0.246871,377.656772,0.030384,0.040448
8591368,"Zürich, Sihlquai/HB",,0.000137,85,7,6,13,134752,134257,269009,4,0.413534,0.474242,1820.465846,0.031409,0.034505
8591075,"Zürich, Bertastrasse",,0.000025,85,3,2,5,52420,52458,104878,10,0.180709,0.197111,937.317883,0.039266,0.001798
8591077,"Zürich, Besenrainstrasse",,0.000022,85,1,1,2,26376,26399,52775,10,0.180233,0.194521,0,0.000273,0.001756
8591245,"Zürich, Laubegg",,0.00016,85,11,9,20,136052,136173,272225,8,0.305357,0.366688,29807.12543,0.163607,0.481214
8591254,"Zürich, Letzipark West",,0.000062,85,3,4,7,80426,80396,160822,7,0.272408,0.312197,1783.176045,0.019652,0.13554
8591304,"Zürich, Post Wollishofen",,0.000076,85,4,9,13,129042,128594,257636,7,0.313776,0.387166,6823.375318,0.01891,0.035417
8591316,"Zürich, Rennweg",,0.000095,85,7,7,14,181014,181058,362072,6,0.318452,0.384579,3006.966253,0.026288,0.033629
8591317,"Zürich, Rentenanstalt",,0.000061,85,4,5,9,93469,92613,186082,8,0.280519,0.341479,5592.106,0.022705,0.021368
8591320,"Zürich, Riedhofstrasse",,0.000034,85,2,2,4,49035,35161,84196,8,0.27013,0.313427,352.990518,0.004467,0.013997
8591351,"Zürich, Schweighof",,0.00004,85,2,2,4,58067,58105,116172,6,0.233918,0.275,1431.38989,0.006738,0.00218
8591062,"Zürich, Bahnhof Oerlikon Nord",,0.000016,85,1,2,3,34781,68176,102957,10,0.182703,0.201994,1500.408917,0.017701,0.003669
8591085,"Zürich, Birch-/Glatttalstrasse",,0.00003,85,2,9,11,70435,71765,142200,10,0.184669,0.231375,2712.355789,0.021468,0.020618
8591092,"Zürich, Bollingerweg",,0.000029,85,3,4,7,84850,84919,169769,10,0.177583,0.208311,1405.139331,0.023589,0.009911
8591103,"Zürich, Buhnstrasse",,0.000038,85,4,5,9,77568,84531,162099,9,0.19713,0.22763,11371.866301,0.032329,0.006426
8591124,"Zürich, Ettenfeld",,0.000019,85,1,1,2,51247,51247,102494,11,0.173333,0.188733,0,0.019899,0.028292
8591128,"Zürich, Fernsehstudio",,0.000096,85,6,6,12,141156,141229,282385,8,0.227917,0.268341,16934.056967,0.068517,0.173665
8591148,"Zürich, Friedrichstrasse",,0.000035,85,3,3,6,52681,52383,105064,8,0.246014,0.296616,239.342955,0.005359,0.034128
8591152,"Zürich, Frohburg",,0.000028,85,2,5,7,52688,52861,105549,8,0.245977,0.304061,29.879192,0.002755,0.044477
8591191,"Zürich, Himmeri",,0.000029,85,3,3,6,51612,51438,103050,9,0.212425,0.252752,727.164571,0.00397,0.03557
8591224,"Zürich, Käshaldenstrasse",,0.000033,85,4,3,7,51538,51552,103090,9,0.211694,0.251984,1142.329802,0.005958,0.033281
8591193,"Zürich, Hirschwiesenstrasse",,0.000072,85,5,4,9,120837,120881,241718,8,0.251861,0.289262,4574.991884,0.023862,0.195833
8591225,"Zürich, Genossenschaftsstrasse",,0.000038,85,1,1,2,83502,83503,167005,8,0.21457,0.238558,162,0,0.046111
8591246,"Zürich, Laubiweg",,0.000056,85,3,4,7,79205,79196,158401,8,0.27551,0.31735,3067.097078,0.026213,0.168432
8591255,"Zürich, Letzistrasse",,0.000093,85,3,10,13,131158,131178,262336,7,0.308688,0.370787,8391.966033,0.015609,0.551256
8591176,"Zürich, Hardhof",,0.000045,85,2,4,6,54424,52011,106435,9,0.252796,0.293354,1171.924114,0.002739,0.345632
8591178,"Zürich, Hardturm",,0.000069,85,5,6,11,100903,93660,194563,8,0.273723,0.317608,4937.125485,0.029773,0.409227
8591222,"Zürich, Kappeli",,0.000099,85,4,5,9,128497,128455,256952,8,0.270083,0.30804,2855.54058,0.011685,0.256927
8591237,"Zürich, Kronenstrasse",,0.000103,85,7,5,12,110699,110674,221373,7,0.27345,0.318729,5725.020341,0.040783,0.428845
8591239,"Zürich, Kunsthaus",,0.000116,85,6,9,15,201692,201625,403317,7,0.29717,0.349521,7318.663757,0.025472,0.498233
8591244,"Zürich, Langmauerstrasse",,0.000074,85,4,2,6,121015,121079,242094,8,0.25,0.283112,1379.262905,0.031913,0.179216
8591226,"Zürich, Kempfhofsteig",,0.000029,85,3,1,4,43194,43249,86443,10,0.162371,0.180612,764.744056,0.021843,0.010263
8591127,"Zürich, Felsenrainstrasse",,0.000046,85,3,2,5,108025,108022,216047,10,0.208781,0.234292,3128.353335,0.028292,0.032278
8591159,"Zürich, Glattwiesen",,0.000054,130,2,2,4,47734,47733,95467,10,0.203493,0.226889,2296.219221,0.03774,0.017351
8591084,"Zürich, Binz Center",,0.000036,85,2,1,3,40835,40852,81687,9,0.2,0.22185,1621.435089,0.017671,0.001141
8591216,"Zürich, Jugendherberge",,0.000056,85,1,3,4,63073,63088,126161,8,0.223368,0.251752,1607.588849,0,0.048077
8591217,"Zürich, Kalchbühlweg",,0.000027,85,1,4,5,11325,50635,61960,7,0.242804,0.277995,58.925033,0.00111,0.156632
8591236,"Zürich, Altes Krematorium",,0.000132,85,8,6,14,153638,152965,306603,7,0.267684,0.307649,7265.387582,0.039458,0.11302
8591112,"Zürich, Dorflinde",,0.000034,85,4,2,6,51161,51868,103029,9,0.210325,0.249848,911.673478,0.025514,0.001707
8591234,"Zürich, Köschenrüti",,0.000054,85,6,5,11,52333,52484,104817,8,0.26,0.317502,6909.014513,0.026436,0.024205
8591272,"Zürich, Max-Bill-Platz",,0.000077,85,6,5,11,119727,119822,239549,8,0.263566,0.324218,7886.913951,0.004924,0.066972
8591289,"Zürich, Neunbrunnen",,0.000051,85,4,3,7,86685,86980,173665,8,0.245714,0.294615,1378.022194,0.003669,0.01273
8591087,"Zürich, Bircher-Benner",,0.000055,85,2,1,3,19064,19059,38123,9,0.186004,0.199424,2478.115276,0.012629,0
8591183,"Zürich, Helmhaus",,0.00006,85,5,4,9,73660,73649,147309,7,0.255162,0.293917,6432.26272,0.130865,0.225253
8591165,"Zürich, Grimselstrasse",,0.000038,85,2,2,4,47889,47838,95727,8,0.241798,0.268754,3840.384159,0.011276,0.059295
8591200,"Zürich, Holzerhurd",,0.000035,85,3,3,6,55789,55703,111492,7,0.232829,0.261036,1415.402472,0.018422,0.063428
8591203,"Zürich, Hubertus",,0.000108,85,8,4,12,180880,180923,361803,8,0.243119,0.274545,7040.303296,0.041345,0.068855
8591209,"Zürich, Im Hagacker",,0.000053,85,3,2,5,107566,107654,215220,8,0.233843,0.257304,492.624238,0.001982,0.062256
8591194,"Zürich, Hirzenbach",,0.000037,85,2,2,4,53357,53342,106699,9,0.208205,0.231306,991.258083,0.003863,0.084575
8591218,"Zürich,Kalkbreite/Bhf.Wiedikon",,0.000137,85,8,6,14,148076,148011,296087,7,0.286957,0.330604,14509.251503,0.05057,0.266306
8591230,"Zürich, Kirche Fluntern",,0.000149,85,7,9,16,172156,171992,344148,7,0.292826,0.341631,10148.188645,0.023465,0.396645
8591259,"Zürich, Lochergut",,0.000086,85,5,4,9,91956,91876,183832,7,0.276408,0.317865,2383.541149,0.025593,0.159831
8591276,"Zürich, Milchbuck",,0.000242,85,14,9,23,326382,326092,652474,8,0.289528,0.358012,14725.095414,0.080769,0.320649
8591282,"Zürich, Museum für Gestaltung",,0.000087,85,4,3,7,134764,134784,269548,7,0.267327,0.306455,705.226263,0.022986,0.112366
8591283,"Zürich, Museum Rietberg",,0.000058,85,2,4,6,51432,51422,102854,8,0.268,0.315769,373.037441,0.005408,0.17433
8591298,"Zürich, Ottikerstrasse",,0.000035,85,2,3,5,71067,71052,142119,8,0.265469,0.307671,56.019282,0.007914,0.019663
8591111,"Zürich, Dangelstrasse",,0.000021,130,1,1,2,20272,20273,40545,8,0.230769,0.258558,0,0.026756,0.015687
8591257,"Zürich, Limmatplatz",,0.000148,85,11,7,18,186396,187196,373592,7,0.286232,0.339376,10108.36548,0.101258,0.321374
8591269,"Zürich, Manesseplatz",,0.000082,85,4,3,7,93342,93312,186654,8,0.248264,0.288387,2859.814335,0.007509,0.188352
8591278,"Zürich, Mittelleimbach",,0.000086,130,2,2,4,79913,58539,138452,8,0.232323,0.2652,1265,0,0.111184
8591147,"Zürich, Friedhof Witikon",,0.00009,129,4,2,6,73320,73430,146750,8,0.229965,0.256632,11910.005202,0.004518,0.017296
8591201,"Zürich, Hönggerberg",,0.00004,85,2,3,5,61953,61954,123907,8,0.223913,0.250202,2284.55552,0.004669,0.012524
8591214,"Zürich, In der Ey",,0.000068,85,4,4,8,91568,91527,183095,8,0.256281,0.29033,2906.277561,0.004972,0.07891
8591240,"Zürich, Lägernstrasse",,0.000019,85,1,2,3,52630,52619,105249,8,0.238381,0.267857,51.861111,0.000963,0.122176
8591252,"Zürich, Letzigrund",,0.000039,85,2,3,5,48044,48069,96113,8,0.246043,0.28073,1651.437312,0.017436,0.135576
8591114,"Zürich, Dreiwiesen",,0.000058,85,1,1,2,19059,19062,38121,8,0.227376,0.248691,1881.115276,0,0.003565
8591220,"Zürich, Kantonsschule",,0.000095,85,7,3,10,101499,101579,203078,8,0.244848,0.275218,8229.396488,0.065126,0.077106
8591229,"Zürich, Kinkelstrasse",,0.000082,85,5,4,9,121052,121126,242178,8,0.249071,0.282806,1939.627888,0.028169,0.097624
8591130,"Zürich, Feusisbergli",,0.00002,85,1,2,3,26698,26708,53406,8,0.206522,0.232206,1076,0.001363,0.008931
8591141,"Zürich, Friedhof Eichbühl",,0.000019,85,1,1,2,6283,6280,12563,8,0.205562,0.227689,0,0.000206,0.008725
8591167,"Zürich, Grünaustrasse",,0.000038,85,2,2,4,83203,83031,166234,10,0.223206,0.249514,1721.122947,0.003838,0.011464
8591249,"Zürich, Lerchenhalde",,0.000054,85,5,4,9,50607,50641,101248,8,0.22251,0.260292,4141.4088,0.007263,0.015931
8591144,"Zürich, Friedhof Schwandenholz",,0.000017,85,1,2,3,33878,33921,67799,8,0.213018,0.233678,2976.605366,0.000977,0.008691
8591153,"Zürich, Fronwald",,0.000024,85,1,1,2,30614,30594,61208,8,0.210702,0.229082,0,0.00068,0.00584
8591120,"Zürich, EPI-Klinik",,0.000027,85,1,1,2,34343,34332,68675,3,0.5,0.611111,2118,0.001193,0
8591248,"Zürich, Leimgrübelstrasse",,0.000042,85,4,4,8,52121,52039,104160,8,0.261421,0.314921,159.311553,0.003175,0.034448
8591258,"Zürich, Lindenplatz",,0.000114,85,8,6,14,137808,137847,275655,7,0.25723,0.302705,10941.128803,0.008725,0.040246
8591267,"Zürich, Maillartstrasse",,0.000017,85,1,1,2,33015,32949,65964,9,0.210204,0.240603,34.871221,0.001506,0.004924
8591206,"Zürich, Hürstholz",,0.000034,85,1,2,3,33926,33922,67848,9,0.184799,0.219601,3734.153846,0,0.021412
8591290,"Zürich, Nordheimstrasse",,0.000038,85,1,2,3,26760,26745,53505,8,0.236328,0.270277,334,0,0.006738
8591307,"Zürich, Radiostudio",,0.000113,85,7,6,13,124882,124835,249717,8,0.272727,0.330863,5314.763133,0.023425,0.010899
8591341,"Zürich, Schmiede Wiedikon",,0.000406,85,13,8,21,278792,262310,541102,6,0.332075,0.404167,19079.643661,0.027344,0.030746
8591342,"Zürich, Schönauring",,0.000057,85,5,3,8,52429,52167,104596,7,0.258462,0.305697,1140.256557,0.007499,0.005059
8591382,"Zürich, Sternen Oerlikon",,0.000292,85,13,8,21,327020,258931,585951,5,0.389831,0.487681,10440.620256,0.065602,0.026529
8591406,"Zürich, Universität Irchel",,0.000201,85,9,7,16,125142,124455,249597,5,0.4,0.51875,2668.019092,0.032225,0.019663
8591429,"Zürich, Wetlistrasse",,0.000128,85,5,1,6,54721,52173,106894,2,0.666667,0.75,131.713511,0.01662,0.002667
8591433,"Zürich, Winkelriedstrasse",,0.000173,85,7,3,10,121055,60709,181764,2,0.666667,0.75,551.733713,0.023104,0.007743
8591132,"Zürich, Flobotstrasse",,0.00002,85,1,1,2,10079,10078,20157,12,0.124733,0.136023,175,0,0
8591133,"Zürich, Flühgasse",,0.000034,85,1,1,2,34332,34352,68684,2,0.666667,0.75,1414,0,0
8591149,"Zürich, Friesenberg",,0.000037,85,3,1,4,54012,54025,108037,9,0.184615,0.201264,1175.209431,0.022937,0.012533
8591150,"Zürich, Friesenberghalde",,0.00002,85,1,1,2,8949,8948,17897,9,0.184615,0.201264,264,0,0.012533
8591306,"Zürich, Quellenstrasse",,0.00006,85,3,7,10,134763,134758,269521,6,0.320225,0.378509,1298.574322,0.015976,0.032931
8591328,"Zürich, Rütihof",,0.000041,85,1,1,2,40952,40885,81837,7,0.248366,0.279981,0,0.002748,0.004265
8591329,"Zürich, Saalsporthalle",,0.000116,85,7,6,13,140817,136244,277061,7,0.307463,0.373093,22968.501346,0.041125,0.026801
8591348,"Zürich, Schützenhaus Höngg",,0.000044,85,1,1,2,12331,12330,24661,7,0.248366,0.279981,434.247189,0.000086,0.004265
8591346,"Zürich, Schumacherweg",,0.000041,85,2,4,6,34250,34110,68360,5,0.345455,0.411842,352.515064,0.00022,0.008888
8591385,"Zürich, Strassenverkehrsamt",,0.000152,85,7,4,11,149503,149413,298916,4,0.397849,0.459459,5241.170141,0.019812,0.012484
8591401,"Zürich, Triemlispital",,0.000033,85,2,1,3,28402,28347,56749,5,0.327434,0.362162,0,0.002897,0.007748
8591162,"Zürich, Glockenacker",,0.000077,129,2,2,4,73455,73451,146906,8,0.229604,0.256242,7056.606381,0.000521,0.020473
8591219,"Zürich, Kanonengasse",,0.000017,85,1,2,3,57917,57925,115842,8,0.233412,0.260074,1820.167768,0.001225,0.029171
8591142,"Zürich, Friedhof Enzenbühl",,0.000058,85,3,1,4,54631,54590,109221,9,0.208086,0.226619,1236.847836,0.021448,0
8591143,"Zürich, Friedhof Hönggerberg",,0.00003,85,1,1,2,12332,12332,24664,11,0.130506,0.149867,792,0,0
8591146,"Zürich, Friedhof Uetliberg",,0.000011,85,0,1,1,0,8949,8949,10,0.156342,0.167643,0,0,0
8591199,"Zürich, Hölderlinstrasse",,0.000076,85,7,2,9,98611,98575,197186,8,0.232508,0.259518,3538.884248,0.064335,0.017171
8591221,"Zürich, Kapfstrasse",,0.000063,85,3,2,5,57000,56986,113986,8,0.228972,0.254999,1351.445042,0.003699,0.017171
8591228,"Zürich, Kienastenwies",,0.000038,85,1,1,2,56762,56749,113511,8,0.22807,0.251178,0,0.000396,0.016774
8591231,"Zürich, Klosbach",,0.000025,85,1,1,2,54829,54835,109664,8,0.22807,0.251178,24.269676,0.009158,0.016774
8591188,"Zürich, Herzogenmühlestrasse",,0.000056,85,3,3,6,86679,86614,173293,8,0.230392,0.271758,3598.048965,0.002676,0.015618
8591297,"Zürich, Orionstrasse",,0.000027,85,1,1,2,24671,24672,49343,8,0.241379,0.27782,0,0.000361,0.00075
8591330,"Zürich, Saatlenstrasse",,0.000044,85,1,2,3,92880,92868,185748,8,0.243553,0.286317,164.465823,0,0.000768
8591343,"Zürich, Schörlistrasse",,0.000129,85,5,1,6,101121,100908,202029,8,0.241379,0.27782,2111.244506,0.02655,0.00075
8591154,"Zürich, Frymannstrasse",,0.000025,130,2,1,3,58570,58571,117141,11,0.139764,0.154545,4632,0.030917,0
8591156,"Zürich, Germaniastrasse",,0.000028,85,1,1,2,10078,10078,20156,11,0.141694,0.154779,348,0,0
8591170,"Zürich, Gutstrasse",,0.000022,85,1,1,2,59427,59428,118855,10,0.163695,0.175984,326.8157,0.002498,0.001627
8591172,"Zürich, Hagenholz",,0.000032,85,2,1,3,83511,83502,167013,9,0.17756,0.193468,1165,0.023909,0
8591256,"Zürich, Leutschenbach",,0.0001,85,6,6,12,200277,200405,400682,7,0.271501,0.321724,18640.530167,0.046111,0.184414
8591195,"Zürich, Höfliweg",,0.000024,85,2,2,4,53995,54019,108014,8,0.196289,0.214967,102.391879,0.009196,0.020404
8591213,"Zürich, Im Wingert",,0.000022,85,1,2,3,28068,28075,56143,9,0.227564,0.263011,133.994199,0.000289,0.090486
8591262,"Zürich, Löwenplatz",,0.000118,85,8,8,16,192620,192558,385178,8,0.295455,0.357547,11824.305921,0.056998,0.231681
8591264,"Zürich, Luegisland",,0.000029,85,1,1,2,53427,53438,106865,9,0.225755,0.256204,125.97731,0.000353,0.080769
8591265,"Zürich, Letzibach",,0.000058,85,3,3,6,71587,71684,143271,8,0.247573,0.284228,1134.868898,0.00918,0.095406
8591271,"Zürich, Mattenhof",,0.000042,85,2,1,3,47684,47710,95394,9,0.225755,0.256204,491.436033,0.005991,0.080769
8591291,"Zürich, Nordstrasse",,0.00006,85,3,5,8,73484,73412,146896,8,0.266958,0.317242,1305.781355,0.001869,0.013074
8591292,"Zürich, Nürenbergstrasse",,0.000072,85,4,1,5,55924,55958,111882,8,0.233184,0.261985,538.320626,0.030745,0.003907
8591296,"Zürich, Okenstrasse",,0.000022,85,1,2,3,21485,21450,42935,8,0.234899,0.269014,39.243374,0.000136,0.0045
8591312,"Zürich, Rebbergsteig",,0.000057,85,4,1,5,43192,43249,86441,8,0.233184,0.261985,204.515474,0.003906,0.003907
8591186,"Zürich, Herdernstrasse",,0.00003,85,3,4,7,64552,64568,129120,8,0.228031,0.260203,5487.167778,0.035651,0.053064
8591366,"Zürich, Sihlcity Nord",,0.000137,85,6,8,14,135161,135132,270293,5,0.405594,0.48477,9737.686926,0.036829,0.031897
8591367,"Zürich, Sihlpost / HB",,0.000171,85,9,4,13,161734,161728,323462,5,0.333333,0.388384,4489.562063,0.027635,0.017461
8591369,"Zürich, Sihlstrasse",,0.000062,85,3,1,4,99448,99457,198905,5,0.317073,0.353526,31.349711,0.018374,0.007485
8591374,"Zürich, Sportweg",,0.000061,85,2,2,4,48946,48925,97871,5,0.320988,0.366346,2943.753885,0.022427,0.008887
8591227,"Zürich, Kernstrasse",,0.00003,85,1,3,4,54330,54365,108695,8,0.228571,0.262827,1785.714135,0.006149,0.041692
8591187,"Zürich, Hertensteinstrasse",,0.000027,85,2,1,3,33910,33926,67836,10,0.157035,0.179737,4794.153846,0.002851,0
8591263,"Zürich, Luchswiesen",,0.000065,85,4,3,7,118665,118683,237348,10,0.202413,0.238158,2322.376603,0.019449,0.015284
8591189,"Zürich, Heubeeriweg",,0.000035,85,1,2,3,10078,10078,20156,10,0.164137,0.182287,519,0,0.000043
8591208,"Zürich, Im Gut",,0.000052,85,2,2,4,113044,113057,226101,9,0.194767,0.213281,1798.796308,0.001627,0.002029
8591196,"Zürich, Hofstrasse",,0.000026,85,2,1,3,54823,54847,109670,9,0.191756,0.206394,1221.682913,0.011193,0
8591273,"Zürich, Messe/Hallenstadion",,0.000072,85,4,4,8,148264,148331,296595,9,0.232053,0.274503,4408.119467,0.010321,0.026216
8591277,"Zürich, Militär-/Langstrasse",,0.000075,85,6,5,11,111586,111284,222870,7,0.260521,0.309066,3780.965731,0.020917,0.049153
8591281,"Zürich, Mühlacker",,0.000026,85,1,1,2,29830,29822,59652,10,0.186289,0.209086,0,0.000605,0.010876
8591204,"Zürich, Hügelstrasse",,0.000053,85,3,1,4,63041,63073,126114,9,0.183349,0.199443,2626.588849,0.018612,0
8591210,"Zürich, Im Hüsli",,0.000032,130,1,2,3,58571,58570,117141,10,0.161327,0.181178,3609,0,0
8591268,"Zürich, Manegg",,0.000024,130,1,1,2,57325,57327,114652,10,0.160367,0.175329,0,0,0
8591212,"Zürich, Im Walder",,0.00004,85,1,1,2,34352,34368,68720,1,1,1,708,0,0
8591275,"Zürich, Michelstrasse",,0.000042,85,1,1,2,12332,12332,24664,9,0.171806,0.194933,312,0,0.009717
8591215,"Zürich, Juchhof",,0.000019,85,1,1,2,4821,4821,9642,3,0.5,0.611111,1171.856755,0.015556,0
8591223,"Zürich, Kappenbühlweg",,0.000036,85,1,1,2,12332,12332,24664,10,0.148218,0.168465,553,0,0
8591326,"Zürich, Rotbuchstrasse",,0.000088,85,3,4,7,108502,108587,217089,7,0.282738,0.335915,798.965928,0.004508,0.008205
8591365,"Zürich, Sihlcity",,0.000061,85,2,1,3,58407,53595,112002,5,0.290076,0.321491,4437.978745,0.011351,0.00301
8591384,"Zürich, Stockerstrasse",,0.000161,85,8,7,15,182292,182345,364637,4,0.375,0.46627,1659.134277,0.042824,0.021624
8591253,"Zürich, Letzipark",,0.000049,85,3,2,5,58536,58616,117152,9,0.219917,0.251897,572.692156,0.021726,0.030382
8591235,"Zürich, Krematorium Nordheim",,0.000025,85,1,1,2,26763,26764,53527,10,0.162483,0.178378,2464,0.000494,0
8591311,"Zürich, Rautistrasse",,0.000072,85,3,4,7,121881,121879,243760,8,0.246819,0.299104,1750.604737,0.001001,0.001265
8591238,"Zürich, Krönleinstrasse",,0.000037,85,2,1,3,10075,10078,20153,9,0.192483,0.208822,845,0.000042,0
8591241,"Zürich, Landiwiese",,0.000027,85,1,1,2,45171,45198,90369,9,0.220648,0.250568,2726.936359,0.015217,0.022705
8591303,"Zürich, Platte",,0.000089,85,6,6,12,97269,97340,194609,7,0.287703,0.347427,5557.491367,0.056525,0.026793
8591242,"Zürich, Langensteinenstrasse",,0.000042,85,1,1,2,10078,10079,20157,8,0.236953,0.263365,1008,0,0.015609
8591243,"Zürich, Langgrütstrasse",,0.000033,85,1,1,2,59427,59429,118856,9,0.186441,0.207768,71.217568,0.000047,0.000977
8591284,"Zürich, Neeserweg",,0.000034,85,1,2,3,26706,24110,50816,9,0.1875,0.215344,229.369017,0,0.001077
8591353,"Zürich, Schwert",,0.000164,85,7,7,14,87008,87082,174090,6,0.326087,0.397333,9174.345823,0.028066,0.023309
8591285,"Zürich, Neuaffoltern",,0.000089,85,5,3,8,115915,116058,231973,9,0.227106,0.266753,2394.41654,0.010876,0.025892
8591251,"Zürich, Lettenstrasse",,0.000038,85,3,3,6,42346,42357,84703,9,0.213793,0.247494,3248.135822,0.043693,0.005911
8591250,"Zürich, Lerchenrain",,0.000022,85,1,1,2,16385,16385,32770,1,1,1,1239,0.000368,0
8591339,"Zürich, Scheuchzerstrasse",,0.000024,85,1,2,3,55930,55931,111861,5,0.301435,0.341534,431.739923,0.005294,0.010012
8591344,"Zürich, Schulhaus Altweg",,0.000039,85,2,1,3,57242,54589,111831,5,0.298077,0.330914,27.676285,0.002159,0.009684
8591280,"Zürich, Mötteliweg",,0.000035,85,2,2,4,34259,34257,68516,9,0.213043,0.251774,1069.442618,0.001914,0.001221
8591310,"Zürich, Rautihalde",,0.00007,85,3,2,5,94650,94642,189292,8,0.226852,0.260168,506.4171,0.000977,0.000285
8591287,"Zürich, Neumarkt",,0.000044,85,3,5,8,101016,100964,201980,6,0.284047,0.343379,2835.813922,0.00878,0.057959
8591260,"Zürich, Loogarten",,0.000027,85,1,1,2,26707,26706,53413,10,0.159236,0.178956,1404.369017,0.000929,0
8591334,"Zürich, SBB-Werkstätte",,0.000058,85,4,2,6,58580,57178,115758,7,0.202857,0.239705,1931.214442,0.007815,0.000632
8594249,"Benglen, Langwis",,0.000113,85,4,1,5,32568,5963,38531,1,1,1,240.121649,0.000826,0.002429
8591266,"Zürich, Maienweg",,0.000032,85,1,1,2,26764,26760,53524,9,0.192429,0.21291,1400,0,0
8591363,"Zürich, Siemens",,0.000037,85,2,2,4,43824,43835,87659,6,0.258687,0.297512,106.597109,0.005028,0.006148
8591398,"Zürich, Toni-Areal",,0.000055,85,1,3,4,48911,48923,97834,5,0.313253,0.400641,50.773748,0,0.005739
8591325,"Zürich, Roswiesen",,0.00005,85,2,2,4,47686,47729,95415,7,0.260504,0.298515,39.83664,0.000676,0.007772
8591414,"Zürich, Waffenplatz-/Bederstr.",,0.000036,85,1,2,3,30638,30616,61254,6,0.3,0.366111,0.5,0.000237,0.0025
8591415,"Zürich, Waffenplatzstrasse",,0.000145,85,6,7,13,140530,97993,238523,5,0.408451,0.532184,1690.187155,0.010016,0.014914
8591345,"Zürich, Schulhaus Buchlern",,0.000085,85,2,2,4,94612,64876,159488,6,0.256881,0.318452,2013.198889,0.005429,0.000499
8591315,"Zürich, Rehalp",,0.000046,85,3,4,7,95318,54715,150033,7,0.26799,0.31228,2219.27695,0.020094,0.00886
8591340,"Zürich, Schlyfi",,0.000051,85,3,3,6,57005,57018,114023,6,0.24911,0.299048,2292.562903,0.00373,0.002207
8591361,"Zürich, Seidelhof",,0.00005,85,2,2,4,57190,57067,114257,6,0.233898,0.271739,1155.865038,0.000431,0.00214
8591327,"Zürich, Rudolf-Brun-Brücke",,0.000058,85,3,3,6,73666,73656,147322,6,0.293375,0.334767,348.770249,0.00165,0.01271
8591364,"Zürich, Signaustrasse",,0.000088,85,6,5,11,112591,112683,225274,5,0.295652,0.355147,1196.710075,0.013749,0.01472
8591371,"Zürich, Singlistrasse",,0.000037,85,1,2,3,40924,40932,81856,5,0.284211,0.321914,54,0,0.005292
8591293,"Zürich, Oberwiesenstrasse",,0.000036,85,1,1,2,60270,60246,120516,8,0.220703,0.246871,79.985922,0.000598,0.000296
8591309,"Zürich, Rathaus",,0.000057,85,4,3,7,73660,73671,147331,7,0.239407,0.274821,1262.187981,0.014997,0.001645
8591305,"Zürich, Probstei",,0.000041,85,2,2,4,47746,47744,95490,7,0.246014,0.281371,1255.660088,0.012785,0.004097
8591300,"Zürich, Stodolastrasse",,0.000038,129,1,1,2,13102,13102,26204,6,0.285714,0.408333,5118,0.000122,0
8591302,"Zürich, Pflegezentr. Käferberg",,0.000079,85,3,2,5,40371,40406,80777,8,0.204787,0.237832,3060.746169,0.009717,0.000564
8591397,"Zürich, Toblerplatz",,0.000075,85,2,4,6,77051,77057,154108,5,0.356436,0.433333,181.392951,0.000047,0.012383
8591404,"Zürich, Tunnelstrasse",,0.000144,85,6,8,14,130095,129517,259612,4,0.414634,0.522059,1476.796333,0.01814,0.026511
8591412,"Zürich, Voltastrasse",,0.000122,85,7,5,12,97311,90160,187471,6,0.348837,0.466111,3286.756278,0.0292,0.00836
8591420,"Zürich, Waldgarten",,0.000158,85,6,2,8,154764,97641,252405,5,0.352941,0.424306,1181.284943,0.020293,0.005621
8591437,"Zürich, Wipkingerplatz",,0.000064,85,1,2,3,31491,31461,62952,3,0.5,0.583333,30.285714,0.000003,0.002458
8591324,"Zürich, Röslistrasse",,0.000051,85,3,2,5,71093,71022,142115,7,0.232274,0.26198,212.608703,0.007222,0.000353
8591331,"Zürich, Sackzelg",,0.000064,85,3,3,6,116696,116695,233391,7,0.267045,0.312361,2445.998252,0.004048,0.004199
8591322,"Zürich, Röntgenstrasse",,0.000037,85,2,1,3,52584,52525,105109,8,0.222222,0.249268,12.628919,0.003643,0.000685
8591427,"Zürich, Werd",,0.000271,85,9,5,14,111561,55034,166595,4,0.396552,0.503623,4678.877342,0.022817,0.007423
8591352,"Zürich, Schweizer Rück",,0.000021,85,1,1,2,44194,44156,88350,3,0.5,0.611111,0,0.003247,0.000505
8591318,"Zürich, Riedbach",,0.000044,85,2,2,4,83513,83512,167025,7,0.228972,0.269291,2588.601623,0.004611,0.000019
8591319,"Zürich, Riedgraben",,0.000039,85,2,1,3,92878,92880,185758,9,0.197701,0.22374,1429.465823,0.002468,0
8591411,"Zürich, Vogelsangstrasse",,0.000039,85,2,1,3,55952,55952,111904,1,1,1,2,0.001927,0.0041
8591431,"Zürich, Wieslergasse",,0.000081,85,3,1,4,53234,2705,55939,1,1,1,6,0.005473,0.0041
8591439,"Zürich, Wollishoferplatz",,0.000166,85,6,4,10,69050,6411,75461,2,0.7,0.785714,2948.310837,0.014174,0.005508
8591447,"Zürich, Zwinglihaus",,0.000145,85,4,1,5,106702,49093,155795,1,1,1,34.257151,0.005538,0.0041
8591896,"Zürich, Würzgraben",,0.000101,85,3,1,4,48925,48923,97848,1,1,1,7.533333,0.002128,0.026985
8591430,"Zürich, Widmerstrasse",,0.000077,85,4,1,5,49657,696,50353,2,0.666667,0.75,358.080437,0.006439,0.000841
8591336,"Zürich, Schäppiweg",,0.000019,85,1,1,2,10071,10078,20149,8,0.198864,0.241327,2568.888889,0.012728,0
8591375,"Zürich, Sprecherstrasse",,0.000062,85,2,1,3,58098,56764,114862,4,0.346154,0.416667,2730.58059,0.00489,0.000052
8591380,"Zürich, Staudenbühl",,0.000034,85,1,1,2,33925,33921,67846,1,1,1,454.12434,0.002683,0.000215
8591446,"Zürich, Zwielplatz",,0.000139,85,4,1,5,68459,17242,85701,1,1,1,766.528056,0.002003,0.000215
8591390,"Zürich, Talwiesenstrasse",,0.0001,85,3,3,6,109620,106763,216383,5,0.342857,0.411111,962.226942,0.016581,0.011065
8591393,"Zürich, Tierspital",,0.0001,85,4,3,7,101170,101146,202316,5,0.346535,0.412381,296.927546,0.017776,0.010736
8591357,"Zürich, Seerose",,0.000039,85,2,1,3,44300,45228,89528,2,0.666667,0.75,2672,0.003324,0
8591358,"Zürich, Segantinistrasse",,0.000031,85,1,1,2,40954,40924,81878,6,0.22449,0.249394,1370,0.003542,0
8591360,"Zürich, Segeten",,0.000044,129,1,1,2,13102,13102,26204,5,0.333333,0.456667,4270,0,0
8591445,"Zürich, Zweiackerstrasse",,0.000044,85,1,1,2,56818,54082,110900,1,1,1,308.386885,0.000295,0.000051
8591386,"Zürich, Strickhof",,0.000022,85,1,1,2,5040,5040,10080,6,0.292035,0.342424,60,0.000152,0.004897
8591392,"Zürich, Thujastrasse",,0.000059,85,3,2,5,62963,62871,125834,6,0.303922,0.37043,1828.37091,0.00864,0.001558
8591405,"Zürich, Uetlihof",,0.00008,85,3,2,5,95455,67461,162916,4,0.379747,0.427778,612.636725,0.007491,0.001941
8591370,"Zürich, Sihlweidstrasse",,0.000054,85,2,1,3,58569,57319,115888,1,1,1,1333,0.007949,0
8591419,"Zürich, Waidspital",,0.000066,85,1,2,3,40407,40406,80813,2,0.75,0.833333,1383,0,0.000851
8591376,"Zürich, Spyriplatz",,0.000029,85,1,2,3,55936,55947,111883,6,0.272059,0.325225,1757.918797,0.008138,0.0003
8591389,"Zürich, Susenbergstrasse",,0.000061,85,3,1,4,48726,48741,97467,6,0.268116,0.307207,1138.452631,0.015495,0.000007
8591377,"Zürich, Spyristeig",,0.000027,85,1,2,3,10078,10079,20157,7,0.241135,0.302801,1319.888889,0,0.000999
8591378,"Zürich, Stadtgrenze",,0.000044,85,1,1,2,45228,45182,90410,1,1,1,1337,0,0
8591408,"Zürich, Untermoosstrasse",,0.000092,85,4,2,6,92891,33270,126161,5,0.320988,0.386538,481.192797,0.003184,0.001401
8591417,"Zürich, Waidfussweg",,0.000099,85,5,1,6,31502,31500,63002,5,0.295455,0.338462,305.047539,0.021,0.000983
8591423,"Zürich, Wartau",,0.000181,85,4,4,8,68475,68492,136967,4,0.403226,0.486667,1802.191074,0.006468,0.004482
8591391,"Zürich, Technopark",,0.000052,85,2,1,3,48927,48911,97838,6,0.245455,0.295679,1466.773748,0.009228,0
8591396,"Zürich, Tobelhof",,0.000025,85,1,1,2,19064,19061,38125,3,0.5,0.611111,3053.314773,0.009158,0
8591399,"Zürich, Trichtenhausenfussweg",,0.000048,129,1,1,2,13102,13102,26204,4,0.4,0.520833,3420,0,0
8591400,"Zürich, Trichtisal",,0.000052,129,1,1,2,13102,13100,26202,3,0.5,0.611111,2568,0,0
8591413,"Zürich, Vulkanstrasse",,0.000027,85,1,1,2,4821,4820,9641,2,0.666667,0.75,102.856755,0,0.000771
8591407,"Zürich, Unteraffoltern",,0.000061,85,2,1,3,30614,30582,61196,1,1,1,1447,0.005677,0
8591442,"Zürich, Zoo",,0.000152,85,5,2,7,58798,53694,112492,1,1,1,1554.257915,0.006423,0.000202
8591416,"Zürich, Waidbadstrasse",,0.000064,85,2,1,3,40406,40407,80813,3,0.5,0.583333,2750,0.003627,0
8591428,"Zürich, Werdhölzli",,0.000119,85,4,1,5,59166,4819,63985,1,1,1,1479,0.005077,0
8591432,"Zürich, Wiesliacher",,0.000055,129,1,1,2,13100,13102,26202,2,0.666667,0.75,1714,0,0
8591435,"Zürich, Winzerstrasse",,0.000126,85,3,2,5,48774,48738,97512,4,0.384615,0.455556,1984.714421,0.001922,0.000018
8591438,"Zürich, Buchzelgstrasse",,0.000057,129,1,1,2,13102,13102,26204,1,1,1,858,0,0
8591453,"Buchs SG, Hallenbad Flös",,0.00007,73,3,3,6,12675,12675,25350,6,0.276923,0.394444,34553.25,0,0
8591452,"Räfis, Gätterli",,0.000048,73,1,1,2,17239,17239,34478,10,0.184211,0.265164,4002,0,0
8591454,"Buchs SG, Haus Wieden",,0.000053,73,2,3,5,12682,12682,25364,6,0.314815,0.432353,21537.916667,0,0
8591455,"Buchs SG, Zentrum",,0.000046,73,2,1,3,6335,6335,12670,11,0.146789,0.225922,0,0,0
8591462,"Räfis, Bäckereistrasse",,0.000078,73,1,2,3,12675,12675,25350,5,0.357143,0.481667,60,0,0
8591456,"Buchs SG, Kath. Kirche",,0.000085,73,3,1,4,12675,12675,25350,10,0.16129,0.240423,10525,0,0
8591458,"Buchs SG, Kreuzgasse",,0.000083,73,1,1,2,12675,12675,25350,9,0.179487,0.258305,8436,0,0
8591459,"Buchs SG, Rheinaustrasse",,0.000082,73,1,1,2,12675,12675,25350,8,0.203125,0.281502,6345,0,0
8591460,"Buchs SG, Röllweg",,0.00008,73,1,1,2,12675,12675,25350,7,0.235294,0.314087,4252,0,0
8591461,"Buchs SG, Sekundarschule",,0.000079,73,1,1,2,12675,12675,25350,6,0.282051,0.366667,2157,0,0
8591464,"Buchs SG, Stüdtli",,0.000059,73,2,2,4,12682,12682,25364,4,0.409091,0.518519,18935.5,0,0
8591465,"Buchs SG, Lilienweg",,0.000069,73,2,3,5,12675,12675,25350,4,0.444444,0.604167,6347.5,0,0
8591466,"Buchs SG, Bahnhofstrasse Ost",,0.000031,73,1,2,3,6335,6335,12670,5,0.35,0.504762,1055.5,0,0
8595373,"Grabs, Unterdorf",,0.000075,73,2,2,4,12682,12211,24893,1,1,1,9,0,0
8595976,"Räfis, Stationsstrasse",,0.000062,73,2,1,3,6340,6340,12680,1,1,1,1055.5,0,0
8591467,"Buchs SG, Wiedenstrasse",,0.000069,73,3,1,4,12682,12682,25364,4,0.352941,0.444444,8449,0,0
8591469,"Buchs SG, Ackerweg",,0.000052,73,1,1,2,17239,17239,34478,9,0.209677,0.293254,2014,0,0
8591475,"Corzoneso Piano, Scaradra",,0.00006,108,1,1,2,4890,4890,9780,1,1,1,15,0,0
8591478,"Olivone, Scona",,0.000065,108,3,1,4,13681,10890,24571,1,1,1,10.5,0,0
8591480,"Balerna, Bisio",,0.000057,99,3,1,4,43384,46261,89645,10,0.189474,0.261332,331.333333,0,0
8591488,"Chiasso, Chiesa",,0.000051,99,2,1,3,12015,6827,18842,4,0.384615,0.483333,51.433333,0,0
8591483,"Brusino Arsizio, Casa Diana",,0.000046,99,1,1,2,8039,8039,16078,11,0.148148,0.215637,358,0,0
8591484,"Brusino Arsizio, Punta Poiana",,0.00005,99,1,1,2,8039,8039,16078,10,0.165217,0.235589,207,0,0
8591490,"Mendrisio, Autosilo",,0.000215,99,5,1,6,72116,57884,130000,7,0.224138,0.296886,1744,0,0
8591491,"Mendrisio, Cantine Delizie",,0.000194,99,1,1,2,57884,57884,115768,6,0.266667,0.341667,1568,0,0
8591492,"Mendrisio, Cantine di Sotto",,0.000175,99,1,2,3,57884,57884,115768,5,0.333333,0.434848,1390,0,0
8591493,"Mendrisio, Cimitero",,0.000085,99,1,1,2,17972,17972,35944,5,0.3125,0.378333,0,0,0
8591494,"Mendrisio, Morgana",,0.000158,99,2,1,3,57884,57884,115768,4,0.409091,0.472222,1028,0,0
8591504,"Riva S. Vitale, Valserrata",,0.00005,99,1,1,2,11311,11311,22622,2,0.666667,0.75,4,0,0
8591496,"Mendrisio, Vignalunga",,0.000042,99,1,1,2,11311,11311,22622,4,0.4,0.520833,388,0,0
8591498,"Pedrinate, Chiesa",,0.000113,99,5,1,6,8418,8601,17019,5,0.315789,0.422222,342,0,0
8591499,"Pedrinate, Cimitero",,0.000107,99,1,1,2,8601,8601,17202,4,0.384615,0.483333,176,0,0
8591500,"Riva S. Vitale, Battistero",,0.000046,99,1,1,2,11311,11311,22622,3,0.5,0.611111,197,0,0
8591501,"Riva S. Vitale, Battuta",,0.00005,99,1,1,2,8039,8039,16078,2,0.666667,0.75,350,0,0
8591502,"Riva S. Vitale, Roncaccio",,0.000053,99,1,1,2,8039,8039,16078,1,1,1,176,0,0
8591506,"Sonvico, al Nido",,0.000087,102,4,1,5,26212,19966,46178,10,0.208134,0.23539,919.45,0,0
8591518,"Ascona, Manor Delta",,0.000087,101,2,1,3,41633,42054,83687,10,0.168067,0.234563,2432.366667,0,0
8591521,"Ascona, Palestre",,0.000085,101,1,1,2,42054,40786,82840,9,0.191919,0.266207,2007.366667,0,0
8591522,"Ascona, Scuole",,0.000083,101,1,2,3,40786,40786,81572,8,0.225,0.329762,1580.366667,0,0
8591528,"Ascona, Via Medere",,0.000075,101,2,2,4,34402,34536,68938,8,0.219178,0.334524,1243.833333,0,0
8591529,"Ascona, Via Pancaldi Mola",,0.000078,101,2,1,3,40786,40786,81572,7,0.232143,0.309158,663,0,0
8591545,"Locarno, Lido",,0.0002,101,4,2,6,35795,34201,69996,5,0.357143,0.47,3027.5,0,0
8591546,"Locarno, Migros",,0.000096,101,1,1,2,17026,17418,34444,4,0.357143,0.466667,1736,0,0
8591547,"Locarno, Sacra Famiglia",,0.000092,101,1,1,2,17418,17031,34449,3,0.444444,0.541667,1303,0,0
8591560,"Muralto, Bellavista",,0.000085,101,1,1,2,6526,6331,12857,3,0.444444,0.541667,24,0,0
8591551,"Losone, Caserma",,0.000044,101,1,1,2,40492,40492,80984,4,0.4,0.520833,1387,0,0
8591553,"Losone, Municipio",,0.000049,101,1,1,2,40492,40147,80639,3,0.5,0.611111,934,0,0
8591554,"Losone, Via Cesura",,0.000044,101,1,1,2,42054,42054,84108,5,0.333333,0.456667,1824,0,0
8591555,"Minusio, Crocifisso",,0.000049,101,1,1,2,42054,42054,84108,4,0.4,0.520833,1372,0,0
8591557,"Minusio, Moranda",,0.000174,101,2,2,4,23647,23842,47489,4,0.461538,0.597222,914,0,0
8591558,"Minusio, Ponte Navegna",,0.000052,101,1,1,2,42054,42054,84108,3,0.5,0.611111,918,0,0
8591559,"Minusio, Remorino",,0.000055,101,1,1,2,42054,42054,84108,2,0.666667,0.75,462,0,0
8591561,"Muralto, Residenza Montana",,0.000161,101,2,1,3,23362,23649,47011,2,0.6,0.666667,891,0,0
8591565,"Porto Ronco, Acapulco",,0.000043,101,1,1,2,13747,13747,27494,1,1,1,451,0,0
8591568,"Solduno, Passetto",,0.000052,101,1,1,2,40147,39548,79695,2,0.666667,0.75,479,0,0
8591574,"Campione, Corso Italia",,0.000031,102,1,1,2,5000,5000,10000,10,0.208134,0.23539,273,0,0
8591577,"Albonago, ai Ronchi",,0.000013,102,1,1,2,11367,12075,23442,11,0.158879,0.198472,8,0,0
8591578,"Albonago, al Bosco",,0.000022,102,1,1,2,12075,12075,24150,10,0.183333,0.224976,37,0,0
8591579,"Albonago, Roccolo",,0.00003,102,1,2,3,17841,17841,35682,13,0.133429,0.159093,2534,0,0
8591582,"Aldesago, Arcate",,0.000024,102,1,1,2,13909,13909,27818,13,0.132184,0.149953,0,0,0
8591581,"Albonago, Via Max Frisch",,0.000038,102,2,2,4,12527,23893,36420,8,0.269565,0.346275,171.160714,0,0
8591645,"Pregassona, Fola",,0.000048,102,1,2,3,52747,52747,105494,8,0.264151,0.344685,539.5,0,0
8591647,"Ruvigliana, ex Clinica",,0.000045,102,1,1,2,11818,11818,23636,8,0.257143,0.320414,81,0,0
8591651,"Vezia, Villa Recreatio",,0.000035,102,1,1,2,43910,49017,92927,8,0.257143,0.320414,0,0,0
8591583,"Aldesago, Narbostra",,0.000044,102,2,1,3,17841,17841,35682,12,0.150662,0.169545,1992,0,0
8591584,"Aldesago, Pontaccio",,0.000048,102,1,1,2,17841,17841,35682,11,0.175439,0.197174,1718,0,0
8591585,"Aldesago, Ronchée",,0.000052,102,1,1,2,17841,17813,35654,10,0.210402,0.239464,1442,0,0
8591587,"Brè, Paese",,0.000034,102,1,1,2,13909,13909,27818,10,0.208134,0.23539,368,0,0
8591590,"Cassarate, Lido",,0.000056,102,2,2,4,88871,88871,177742,11,0.180077,0.211833,1574,0,0
8591592,"Castagnola, S. Domenico",,0.000035,102,1,1,2,36124,36124,72248,12,0.151316,0.17042,728,0,0
8591593,"Castagnola, S. Giorgio",,0.000027,102,1,1,2,9102,11818,20920,11,0.15625,0.199618,24,0,0
8591594,"Castagnola, S. Michele",,0.000034,102,1,1,2,11818,11818,23636,10,0.179012,0.223248,45,0,0
8591595,"Castagnola, Serenella",,0.00004,102,1,1,2,36124,36124,72248,11,0.176357,0.19867,455,0,0
8591596,"Castagnola, Vallée",,0.00004,102,1,1,2,11818,11818,23636,9,0.210526,0.258858,64,0,0
8591598,"Cureggia, Bassa",,0.000023,102,2,1,3,4320,4320,8640,2,0.666667,0.75,8.75,0,0
8591600,"Lugano, Bellavista",,0.000066,102,2,1,3,36121,36121,72242,10,0.208134,0.23539,377,0,0
8591605,"Lugano, Loreto",,0.000043,102,1,2,3,53835,54060,107895,8,0.211864,0.255143,0,0,0
8591618,"Lugano, Tassino",,0.000057,102,2,3,5,71970,71970,143940,10,0.217391,0.28086,1599.452309,0,0
8591621,"Lugano, Via F. Pelli",,0.000055,102,3,3,6,68772,68772,137544,10,0.224066,0.290572,570.613925,0,0
8591606,"Lugano, Malpensata",,0.000043,102,1,1,2,43168,43633,86801,6,0.283333,0.344118,0,0,0
8591630,"Paradiso, Brentino",,0.000027,102,1,1,2,18185,18185,36370,6,0.283333,0.344118,188.928571,0,0
8591634,"Paradiso, Geretta",,0.000086,102,2,2,4,36124,36124,72248,4,0.461538,0.597222,422,0,0
8591637,"Pazzallo, P&R Fornaci",,0.00007,102,2,3,5,47484,31497,78981,4,0.458333,0.568182,2573,0,0
8591718,"Villa Luganese, Vigna",,0.000054,102,1,1,2,4597,2758,7355,1,1,1,4.5,0,0
8591795,"Breganzona, Posta",,0.000079,102,2,2,4,61374,61374,122748,5,0.375,0.547222,2173.775,0,0
8591654,"Viganello, Meridiana",,0.000067,102,2,1,3,52747,52747,105494,6,0.304348,0.421429,788.891667,0,0
8591614,"Lugano, Santa Birgitta",,0.000028,102,1,1,2,36124,36124,72248,11,0.181009,0.218951,10.5,0,0
8591622,"Viganello, Via Molinazzo",,0.000038,102,2,1,3,52747,52747,105494,12,0.146245,0.185447,107.166667,0,0
8591624,"Lugano, Via Zurigo",,0.000033,102,1,1,2,22814,22814,45628,12,0.146245,0.185447,0,0,0
8591646,"Pregassona, Viarnetto",,0.000048,102,1,2,3,45860,45860,91720,3,0.5,0.611111,449.5,0,0
8591798,"Lugano, Piazza Molino Nuovo 2",,0.000054,102,2,2,4,32109,32109,64218,2,0.666667,0.75,422.75,0,0
8594224,"Lugano, Piazza Loreto",,0.000026,102,1,1,2,17910,17910,35820,2,0.6,0.666667,5,0,0
8591805,"Lugano, Stazione Nord",,0.000242,102,8,3,11,66637,22176,88813,4,0.5,0.635417,2045.120671,0,0
8594220,"Lugano, Bressanella",,0.000026,102,1,2,3,17936,17936,35872,1,1,1,7,0,0
8594259,"Canobbio, Paese",,0.000078,102,3,2,5,27939,25163,53102,1,1,1,140.151948,0,0
8591619,"Lugano, Via Brentani",,0.000033,102,1,1,2,42367,42367,84734,3,0.5,0.611111,561.735714,0,0
8594974,"Villa Luganese, Luss",,0.00012,102,2,1,3,20433,19966,40399,3,0.5,0.611111,579.430952,0,0
8595131,"Lamone-Cadempino, Posta/Staz.",,0.000139,102,4,1,5,61522,49017,110539,3,0.5,0.611111,157.833333,0,0
8591623,"Lugano, Via Tesserete",,0.000059,102,2,2,4,47188,41139,88327,9,0.246269,0.325409,1824.385714,0,0
8591625,"Massagno, al Sole",,0.000059,102,2,1,3,48905,48905,97810,9,0.228346,0.286959,423.214286,0,0
8591627,"Noranco, Asilo Bagion",,0.000014,102,1,1,2,3851,3851,7702,7,0.222222,0.287585,14,0,0
8591628,"Noranco, Furnas",,0.000023,102,1,1,2,3851,3851,7702,6,0.265306,0.328205,26,0,0
8591629,"Pambio, S. Pietro Chiesa",,0.00003,102,1,1,2,3851,3851,7702,5,0.333333,0.398611,36,0,0
8591631,"Paradiso, Carzo",,0.000118,102,4,3,7,79999,79757,159756,5,0.372093,0.476042,4562,0,0
8591632,"Paradiso, Fontana",,0.000044,102,1,1,2,17939,17939,35878,5,0.35,0.445238,410,0,0
8591633,"Paradiso, Via S. Salvatore",,0.000044,102,1,1,2,18185,18185,36370,5,0.35,0.445238,410,0,0
8591635,"Paradiso, Via Cattori",,0.000048,102,1,1,2,18185,18185,36370,3,0.5,0.583333,4.5,0,0
8591802,"Paradiso, Stazione",,0.000099,102,3,2,5,61854,40009,101863,3,0.571429,0.708333,1657.5,0,0
8594210,"Albonago, Via Ruscello",,0.000059,102,1,2,3,11818,11818,23636,3,0.555556,0.666667,46,0,0
8594211,"Albonago, Sentiero di Camà",,0.000053,102,2,1,3,12075,11141,23216,3,0.5,0.583333,45,0,0
8591638,"Pazzallo, Scuole Fano",,0.000031,102,1,1,2,6255,6255,12510,2,0.666667,0.75,828,0,0
8591639,"Pazzallo, Senago",,0.000037,102,1,1,2,6255,6255,12510,1,1,1,415,0,0
8591642,"Pregassona, Boschina",,0.000093,102,3,1,4,98607,98607,197214,11,0.166667,0.208213,2529,0,0
8591643,"Pregassona, Bozzoreda",,0.00009,102,1,1,2,98607,98607,197214,10,0.194444,0.243073,2155,0,0
8591644,"Pregassona, Croce Verde",,0.000088,102,1,2,3,98607,98607,197214,9,0.234483,0.307785,1779,0,0
8591648,"Ruvigliana, Fulmignano",,0.000043,102,1,1,2,17841,17841,35682,4,0.4,0.520833,1580,0,0
8591649,"Ruvigliana, Ronchetti",,0.000047,102,1,1,2,17841,17841,35682,3,0.5,0.611111,1188,0,0
8591650,"Ruvigliana, Trona",,0.000051,102,1,1,2,17841,17841,35682,2,0.666667,0.75,794,0,0
8591652,"Viganello, Bottogno",,0.000031,102,1,1,2,26374,26374,52748,7,0.258065,0.365774,24,0,0
8591793,"Albonago, Paese",,0.00004,102,1,2,3,9359,12075,21434,4,0.4375,0.559524,467,0,0
8591657,"Wil SG, Neualtwil",,0.000082,20,3,1,4,28032,28617,56649,5,0.305556,0.377273,655.5,0,0
8591660,"Wil SG, Oelberg",,0.000025,20,1,3,4,28143,28143,56286,5,0.35,0.475,1100,0,0
8591661,"Wil SG, Reuttistrasse",,0.000018,20,1,2,3,27417,27417,54834,5,0.333333,0.434615,0,0,0
8591658,"Wil SG, Neugruben",,0.000034,20,2,2,4,28143,28382,56525,6,0.3125,0.41,1757.5,0,0
8591659,"Wil SG, Neulanden",,0.000019,20,1,1,2,27918,27918,55836,3,0.5,0.583333,652,0,0
8591662,"Wil SG, Rosenberg",,0.000027,20,1,2,3,27918,27918,55836,2,0.75,0.833333,492,0,0
8591670,"Wil SG, Ulrich-Röschstrasse",,0.000022,20,1,1,2,13958,13958,27916,2,0.666667,0.75,0,0,0
8591668,"Wil SG, Städeli",,0.000096,20,3,2,5,42816,42816,85632,4,0.4,0.5,1393.5,0,0
8591669,"Wil SG, Stadtmarkt",,0.000117,20,2,2,4,35238,34974,70212,2,0.666667,0.75,860,0,0
8591671,"Wil SG, Waldau",,0.000061,20,1,1,2,27413,27413,54826,2,0.6,0.666667,0,0,0
8591672,"Wil SG, Weidle",,0.000112,20,2,2,4,34974,35238,70212,1,1,1,434,0,0
8591673,"Wil SG, Wilerwald",,0.000059,20,1,1,2,27413,27413,54826,1,1,1,0,0,0
8591674,"Wil SG, Buebenloo",,0.000041,20,2,1,3,27918,13958,41876,1,1,1,166,0,0
8591677,"Wil SG, Krebsbachbrücke",,0.000052,20,1,1,2,28617,28617,57234,3,0.5,0.611111,672,0,0
8591678,"Wil SG, Hofberg",,0.000055,20,1,1,2,28617,28617,57234,2,0.666667,0.75,450,0,0
8591679,"Wil SG, Langegg/Turm Hofberg",,0.00004,20,3,1,4,14183,14183,28366,4,0.4,0.486111,345.5,0,0
8591700,Merlischachen Sumpf,,0.000061,90,1,1,2,135,135,270,1,1,1,400,0,0
8591703,"Küssnacht am Rigi, Chliarniweg",,0.000024,91,1,1,2,6113,6125,12238,6,0.257143,0.344444,636,0,0
8591704,"Haltikon, Säge",,0.000031,91,1,1,2,6125,6125,12250,5,0.307692,0.389583,326,0,0
8591705,"Root D4, Bahnhof",,0.000037,91,1,1,2,6125,6125,12250,4,0.388889,0.464286,14,0,0
8591890,"Gersau, Felsenegg",,0.000118,91,3,1,4,15625,18070,33695,4,0.388889,0.464286,506.333333,0,0
8595542,"Weggis, Zingelistrasse",,0.000064,91,1,1,2,2260,2260,4520,7,0.25,0.370408,63,0,0
8591716,"Cadro, Grescia",,0.000047,102,2,1,3,4597,4597,9194,3,0.5,0.611111,804.5,0,0
8591717,"Cadro, Municipio",,0.000051,102,1,1,2,4597,4597,9194,2,0.666667,0.75,405.5,0,0
8591723,"Jona, Altersheim Meienberg",,0.000038,67,2,1,3,11326,11326,22652,7,0.27027,0.367619,1519.752381,0,0
8591724,"Jona, Aubrigstrasse",,0.000043,67,1,2,3,11326,11976,23302,6,0.333333,0.475926,1068.752381,0,0
8591748,"Rapperswil SG, EW",,0.000046,67,1,2,3,11376,11376,22752,2,0.75,0.833333,11,0,0
8591726,"Jona, Feldlistrasse",,0.000022,67,1,1,2,10758,10758,21516,8,0.22,0.310714,0,0,0
8591727,"Jona, Geberit",,0.00004,67,2,1,3,23541,23540,47081,7,0.25641,0.354286,4900,0,0
8591728,"Jona, Grünfeld",,0.000045,67,1,2,3,23540,23541,47081,6,0.310345,0.448148,4419,0,0
8591733,"Jona, Langrütistrasse",,0.00003,67,1,1,2,10758,10758,21516,6,0.285714,0.379167,0,0,0
8591730,"Jona, Hummelwaldstrasse",,0.00003,67,2,2,4,9741,9741,19482,1,1,1,806,0,0
8591731,"Jona, Kindergarten Hummelberg",,0.000024,67,1,1,2,4858,4857,9715,1,1,1,0,0,0
8591732,"Jona, Kreuzackerstrasse",,0.00004,67,2,1,3,14181,14203,28384,5,0.3,0.413889,515,0,0
8591735,"Jona, Lenggisrain",,0.000059,67,2,1,3,14227,28497,42724,3,0.444444,0.541667,1968,0,0
8591736,"Jona, Molkereistrasse",,0.000056,67,2,1,3,23541,23532,47073,5,0.35,0.445238,3451,0,0
8591738,"Jona, Rankstrasse",,0.000045,67,2,2,4,11376,11400,22776,5,0.388889,0.540476,2635.247619,0,0
8591750,"Rapperswil SG, Hanfländer",,0.000049,67,2,1,3,11973,11965,23938,2,0.666667,0.75,143.752381,0,0
8591739,"Jona, Sonnenblickstrasse",,0.000061,67,1,1,2,28497,28438,56935,2,0.6,0.666667,1479,0,0
8591740,"Jona, Spitzenwies",,0.000063,67,1,2,3,28438,12914,41352,1,1,1,988,0,0
8591741,"Jona, Vita-Parcours",,0.000038,67,1,1,2,12748,14028,26776,1,1,1,0,0,0
8591742,"Jona, Vogelau/Bahnhof",,0.00003,67,1,1,2,11375,11376,22751,5,0.315789,0.422222,1394,0,0
8591743,"Jona, Weiden",,0.000058,67,1,2,3,23532,23541,47073,4,0.461538,0.597222,2964,0,0
8591744,"Jona, Tägernau",,0.000036,67,1,1,2,11376,11376,22752,4,0.384615,0.483333,935,0,0
8591746,"Rapperswil SG, Bahnhof Süd",,0.000036,67,1,1,2,12783,12783,25566,4,0.4,0.520833,495,0,0
8591747,"Rapperswil SG, Bildau",,0.000042,67,1,1,2,11376,11376,22752,3,0.5,0.583333,474,0,0
8591749,"Rapperswil SG, Greithstrasse",,0.000036,67,1,1,2,10758,10755,21513,3,0.5,0.611111,1485,0,0
8591751,"Rapperswil SG, Kinderzoo",,0.000041,67,1,1,2,12783,12782,25565,3,0.5,0.611111,3,0,0
8591752,"Rapperswil SG, Oberseeplatz",,0.000076,67,2,1,3,23537,12783,36320,2,0.666667,0.75,996,0,0
8591753,"Rapperswil SG, Schulstrasse",,0.000091,67,3,1,4,12040,6318,18358,1,1,1,469,0,0
8591754,"Rapperswil SG, Sportanl. Lido",,0.000076,67,1,1,2,12783,12783,25566,1,1,1,499,0,0
8591772,"Lenk, Krummenbach",,0.000061,23,2,1,3,2599,1273,3872,1,1,1,31,0,0
8591778,"Sargans, Gutshof",,0.000094,73,2,2,4,17349,17349,34698,7,0.297297,0.432684,12138.795331,0,0
8591789,"Willisau, Leuenplatz",,0.000104,59,3,1,4,2625,2625,5250,1,1,1,181,0,0
8591791,"Wil SG, Eggfeld",,0.000124,20,5,2,7,43985,28143,72128,2,0.75,0.833333,690,0,0
8594156,"Wil SG, Schönengrundweg",,0.000064,20,1,1,2,27417,27417,54834,2,0.666667,0.75,0,0,0
8591792,"Wil SG, Grundstrasse",,0.000057,20,1,1,2,28617,27650,56267,1,1,1,226,0,0
8591794,"Aldesago, Paese",,0.000054,102,1,1,2,17841,17841,35682,1,1,1,398,0,0
8591796,"Cureggia, Paese",,0.000031,102,1,1,2,4320,4094,8414,1,1,1,4.75,0,0
8591799,"Lugano, Scuole Molino Nuovo",,0.000031,102,1,1,2,23046,23046,46092,1,1,1,6,0,0
8591797,"Lugano, Osp. Civico/Torricelli",,0.000036,102,1,2,3,35846,35846,71692,2,0.625,0.7,819,0,0
8591800,"Noranco, Paese",,0.000031,102,1,1,2,3172,3851,7023,2,0.666667,0.75,828,0,0
8591801,"Pambio, Paese",,0.000037,102,1,1,2,3851,3851,7702,1,1,1,415,0,0
8594218,"Castagnola, Capolinea",,0.000164,102,4,2,6,47942,29757,77699,2,0.75,0.833333,909,0,0
8591806,"Châtel-St-Denis, L'Epine",,0.000066,12,2,1,3,5666,5679,11345,2,0.666667,0.75,40,0,0
8591807,"Châtel-St-Denis, Pontille",,0.000067,12,1,1,2,5679,5647,11326,1,1,1,21,0,0
8591808,"Cheyres, école",,0.000044,13,1,1,2,4735,4868,9603,2,0.666667,0.75,646,0,0
8591811,"Goldach, Sonnenhalde",,0.000043,72,1,1,2,15324,7666,22990,1,1,1,572,0,0
8591817,Hergiswil Bahnhof,,0.000093,90,1,1,2,81,81,162,1,1,1,470,0,0
8591820,"Roche VD, Salines",,0.000043,103,1,1,2,2709,2709,5418,4,0.4,0.520833,292,0,0
8591822,"Roche VD, Rotzéranne-Pré-Clos",,0.000048,103,1,1,2,2709,2709,5418,3,0.5,0.611111,222,0,0
8591823,"Roche VD, centre commercial",,0.000051,103,1,1,2,2709,2708,5417,2,0.666667,0.75,150,0,0
8591830,Glattpark,,0.000249,85,6,1,7,150071,35271,185342,1,1,1,1479,0.017551,0
8591831,"Gockhausen, Dorf",,0.00006,85,3,1,4,19338,171,19509,1,1,1,622.166667,0.001725,0
8594261,"Dübendorf, Hochbord Nord",,0.000044,85,1,1,2,25576,25576,51152,1,1,1,632.833333,0.010985,0
8591834,"Versvey, Lac Vernay/campings",,0.000055,103,1,1,2,2708,2709,5417,1,1,1,76,0,0
8591843,"Le Noirmont, gare",,0.000049,1,2,1,3,361,361,722,3,0.5,0.611111,168,0,0
8591844,"Les Emibois, gare",,0.000052,1,1,1,2,361,359,720,2,0.666667,0.75,100,0,0
8591851,"Widnau, Girlen",,0.000059,73,2,1,3,20636,20636,41272,5,0.333333,0.456667,515,0,0
8591852,"Widnau, Rosenau",,0.000061,73,1,1,2,20636,20636,41272,4,0.4,0.520833,416,0,0
8591853,"Widnau, Unterdorf",,0.000063,73,1,1,2,20636,20636,41272,3,0.5,0.611111,315,0,0
8591854,"Widnau, Viscose",,0.000064,73,1,1,2,20636,13682,34318,2,0.666667,0.75,212,0,0
8591886,"Grasswil, Sonne",,0.000072,88,2,2,4,9006,9006,18012,2,0.75,0.833333,270,0,0
8591887,"Riedtwil, Mittlerer Kasten",,0.000041,88,1,1,2,8758,8758,17516,2,0.666667,0.75,0,0,0
8591888,"Riedtwil, Schulhaus",,0.000077,88,2,1,3,9006,8758,17764,1,1,1,92,0,0
8591902,"Monts-de-Corsier, Dautère",,0.000065,12,1,1,2,9738,7623,17361,2,0.666667,0.75,42,0,0
8591904,"Carrouge VD, Ecorcheboeuf",,0.00011,13,3,1,4,4818,4818,9636,10,0.208333,0.303042,2623.8,0,0
8591908,"Thun, Asterweg",,0.000042,43,1,1,2,5722,5722,11444,5,0.3,0.366667,1024,0,0
8591909,"Thun, Bubenbergstrasse",,0.000047,43,1,2,3,5722,5722,11444,4,0.392857,0.484848,737,0,0
8591910,"Thun, Buchegg",,0.000024,43,2,3,5,5993,5994,11987,5,0.371429,0.496154,3016,0,0
8591913,"Thun, Klosestrasse",,0.000037,43,2,2,4,5782,5823,11605,4,0.416667,0.508333,1835,0,0
8591919,"Thun, Pfarrhausweg",,0.000058,43,1,2,3,5994,5993,11987,4,0.421053,0.53125,326,0,0
8591920,"Thun, Progymatte",,0.000036,43,1,1,2,5723,5724,11447,4,0.388889,0.464286,0,0,0
8591917,"Thun, Mattenstrasse",,0.000026,43,1,1,2,5724,5724,11448,6,0.263158,0.343333,10,0,0
8591916,"Thun, Lerchenfeldstrasse",,0.00006,43,2,1,3,2907,30,2937,2,0.666667,0.75,4,0,0
8591912,"Thun, Freiestrasse",,0.000018,43,1,1,2,5724,5724,11448,7,0.22449,0.306926,233,0,0
8591914,"Thun, Lerchenfeld",,0.000051,43,2,2,4,5814,5814,11628,3,0.571429,0.708333,536,0,0
8591915,"Thun, Forstweg",,0.000033,43,1,1,2,2937,30,2967,3,0.5,0.611111,0,0,0
8591918,"Thun, Neufeld",,0.000056,43,3,1,4,5994,5994,11988,5,0.321429,0.401852,622,0,0
8591922,"Thun, Schorenfriedhof",,0.000102,43,4,2,6,11757,11716,23473,3,0.545455,0.638889,1842,0,0
8591923,"Thun, Strättligenplatz",,0.000054,43,1,1,2,5722,5722,11444,1,1,1,308,0,0
8591925,"Thun, Talacker",,0.000054,43,1,2,3,5994,5994,11988,2,0.75,0.833333,924,0,0
8591927,"Thun, Waisenhausstrasse",,0.00004,43,1,1,2,5724,5724,11448,1,1,1,1,0,0
8591926,"Thun, Tellstrasse",,0.000034,43,1,1,2,5724,5724,11448,2,0.666667,0.75,309,0,0
8591930,"Bussigny, Croix de Plan",,0.000022,5,1,1,2,34194,34192,68386,18,0.127561,0.14447,203.821429,0,0
8591931,"Bussigny, Buyère",,0.000029,5,1,1,2,34192,34193,68385,17,0.145455,0.167443,316.821429,0,0
8592011,"Lausanne, Chauderon-Ale",,0.000024,10,2,2,4,39480,39004,78484,16,0.16875,0.213408,334.563883,0,0
8592041,"Lausanne, EPSIC",,0.000054,5,1,1,2,44833,44830,89663,12,0.176174,0.215046,840.858333,0,0
8592142,"Le Mont-sur-Lausanne, Fougères",,0.000044,5,1,2,3,26288,26289,52577,5,0.357143,0.47,1630.25,0,0
8592223,"Renens VD, village",,0.00006,5,1,1,2,68385,34193,102578,5,0.333333,0.411111,2746,0,0
8591940,"Cugy VD, Cavenette",,0.000025,5,2,1,3,26289,26289,52578,8,0.203125,0.280311,2716.25,0,0
8591944,"Ecublens VD, Argand",,0.000038,5,3,2,5,41960,41956,83916,16,0.116361,0.140693,15005.666667,0,0
8591945,"Ecublens VD, Champagne",,0.000041,5,3,1,4,33938,33945,67883,12,0.133612,0.161038,962.5,0,0
8591946,"Ecublens VD, Cocarde",,0.000027,5,1,1,2,8359,8218,16577,15,0.114509,0.13056,892,0,0
8591947,"Ecublens VD, Coquerellaz",,0.000034,5,1,1,2,8218,8304,16522,14,0.128514,0.147844,660,0,0
8591949,"Ecublens VD, En Enjalin",,0.000052,5,3,2,5,38557,38724,77281,15,0.116667,0.138321,12371.666667,0,0
8591950,"Ecublens VD, allée de Dorigny",,0.000045,5,1,1,2,33945,33932,67877,11,0.151807,0.183454,932.5,0,0
8592226,"St-Sulpice VD, Russel",,0.000027,5,1,1,2,33597,33598,67195,11,0.151807,0.183454,13494.666667,0,0
8591951,"Ecublens VD, Motty",,0.00004,5,1,1,2,8304,8219,16523,13,0.146544,0.172595,426,0,0
8591954,"Ecublens VD, Perrettes",,0.000067,5,2,2,4,37427,38724,76151,13,0.149186,0.181167,11693.666667,0,0
8591960,"Ecublens VD, Veilloud",,0.000058,5,1,1,2,30667,30662,61329,13,0.146544,0.172595,795,0,0
8591952,"Ecublens VD, Ormet",,0.000033,5,1,1,2,8058,8057,16115,14,0.130503,0.152095,5877.833333,0,0
8591953,"Ecublens VD, Parc",,0.000033,5,1,1,2,30666,29370,60036,14,0.130503,0.152095,5877.833333,0,0
8591955,"Ecublens VD, place de sport",,0.000039,5,1,1,2,30666,30663,61329,18,0.086544,0.099348,1975,0,0
8591956,"Ecublens VD, Renges",,0.000044,5,1,1,2,30663,30667,61330,17,0.094165,0.107504,1743,0,0
8591957,"Ecublens VD, Stand",,0.000048,5,1,1,2,30667,30664,61331,16,0.103316,0.11762,1509,0,0
8591958,"Ecublens VD, Suchet-Forêt",,0.000052,5,1,1,2,30664,30110,60774,15,0.114509,0.13056,1273,0,0
8591959,"Ecublens VD, Champs-Courbes",,0.000055,5,1,1,2,30110,30667,60777,14,0.128514,0.147844,1035,0,0
8591962,"Epalinges, Ballègue",,0.000025,13,1,1,2,32479,32479,64958,17,0.126829,0.203095,713,0,0
8591964,"Epalinges, Bois-Murat",,0.000082,13,3,2,5,47765,47853,95618,15,0.155844,0.290459,7038.479579,0,0
8591965,"Epalinges, centre",,0.000046,13,1,1,2,34521,34514,69035,15,0.150327,0.259609,0,0,0
8591966,"Epalinges, Croix-Blanche",,0.000085,13,2,4,6,47846,47507,95353,14,0.169231,0.356943,5652.479579,0,0
8591967,"Epalinges, En Praz Bin",,0.000029,13,1,2,3,32477,32478,64955,15,0.137931,0.256884,718,0,0
8591968,"Epalinges, Grand Chemin",,0.000029,13,1,1,2,11290,11290,22580,15,0.131944,0.217772,0,0,0
8591969,"Epalinges, Polny",,0.000023,13,1,1,2,15988,15984,31972,15,0.131944,0.217772,0,0,0
8591971,"Epalinges, Tuileries",,0.000086,13,4,1,5,45984,13400,59384,14,0.144,0.24182,54,0,0
8592015,"Lausanne, Chevreuils",,0.000032,13,1,2,3,32791,32788,65579,13,0.163636,0.295722,1595.520421,0,0
8591970,"Epalinges, Pré-d'Yverdon",,0.000025,13,1,1,2,32750,32791,65541,14,0.147287,0.24225,2290.520421,0,0
8591976,"La Conversion, gare",,0.00002,10,1,1,2,12702,12702,25404,16,0.110048,0.178165,1680,0,0
8591977,"Lausanne, Abeilles",,0.00003,10,2,1,3,57883,57883,115766,16,0.139818,0.164442,11845.375666,0,0
8591984,"Lausanne, Beaulieu",,0.000048,10,3,3,6,74300,74930,149230,15,0.151538,0.190803,24376.96916,0,0
8592002,"Lausanne, Boveresses",,0.000052,10,3,3,6,42415,42468,84883,14,0.191176,0.250502,13587.006052,0,0
8592026,"Lausanne, Croix d'Ouchy",,0.00003,10,1,1,2,42405,42409,84814,15,0.144764,0.1864,521.431119,0,0
8592043,"Lausanne, Faverges",,0.000032,10,1,1,2,38690,38697,77387,15,0.144764,0.1864,801.288095,0,0
8592050,"Lausanne, gare",,0.000125,10,6,6,12,162865,162824,325689,13,0.188608,0.267708,5750.683578,0,0
8591985,"Lausanne, Beauregard",,0.000057,10,1,3,4,84296,84297,168593,16,0.147866,0.187628,8928.169475,0,0
8591983,"Lausanne, Batelière",,0.000055,10,4,1,5,84118,84296,168414,17,0.129396,0.154734,9119.169475,0,0
8591995,"Lausanne, Bois de Vaux",,0.000027,10,1,1,2,37115,37109,74224,16,0.126473,0.155565,0,0,0
8591992,"Lausanne, Bergières",,0.000042,10,3,3,6,74770,74824,149594,16,0.14623,0.181572,2852.3284,0,0
8591993,"Lausanne, Béthanie",,0.00002,10,1,2,3,49717,49710,99427,14,0.190665,0.243321,1008.260286,0,0
8591997,"Lausanne, Boissonnet",,0.000037,10,1,2,3,57883,57883,115766,15,0.161661,0.199131,11701.375666,0,0
8591989,"Lausanne, Bellerive",,0.000026,10,2,2,4,71674,71676,143350,17,0.118771,0.150462,380.431119,0,0
8592079,"Lausanne, Mont-Fleuri",,0.000036,10,2,1,3,42412,42404,84816,10,0.186441,0.288997,4906,0,0
8591990,"Lausanne, Belvédère",,0.00002,10,1,1,2,28983,28974,57957,14,0.186368,0.236236,1008.260286,0,0
8591991,"Lausanne, Benj. Constant",,0.000014,10,1,1,2,31595,31595,63190,5,0.333333,0.456667,30,0,0
8591994,"Lausanne, Blécherette",,0.000048,10,4,2,6,85731,98232,183963,16,0.146472,0.179946,853.613212,0,0
8591998,"Lausanne, Boisy",,0.000043,10,2,2,4,55116,55100,110216,15,0.164062,0.202951,1707.518643,0,0
8592005,"Lausanne, Cèdres",,0.000058,10,3,4,7,84110,84291,168401,15,0.143885,0.190645,3313.330708,0,0
8592012,"Lausanne, chemin du Cap",,0.000019,10,1,1,2,19377,19375,38752,15,0.139726,0.171372,0,0,0
8592027,"Lausanne, Dapples",,0.000043,10,2,2,4,46990,47087,94077,15,0.139854,0.17464,180.902381,0,0
8592044,"Lausanne, Figuiers",,0.000042,10,2,2,4,75838,75843,151681,15,0.157895,0.209853,604.390861,0,0
8592029,"Lausanne, Denantou",,0.000029,10,3,1,4,36814,36902,73716,14,0.159574,0.201961,48.27236,0,0
8592038,"Lausanne, Eglantine",,0.000074,10,5,3,8,87941,87658,175599,14,0.161359,0.212461,4526.343732,0,0
8592040,"Lausanne, Epinettes",,0.00005,10,2,1,3,47006,47109,94115,14,0.159574,0.201961,137.55,0,0
8592024,"Lausanne, Cour",,0.000023,10,1,1,2,20900,20892,41792,16,0.123397,0.147809,0,0,0
8592006,"Lausanne, Chalet-Fontaine",,0.000085,13,2,2,4,6453,6627,13080,10,0.206349,0.3471,3528.633333,0,0
8592100,"Lausanne, Praz-Collet",,0.00008,13,1,1,2,32787,1949,34736,10,0.193548,0.292692,192,0,0
8592117,"Lausanne, Ste-Catherine",,0.000047,13,1,1,2,3027,3027,6054,10,0.193548,0.292692,0,0,0
8592008,"Lausanne, Champ-Rond",,0.000021,10,1,1,2,33368,33368,66736,4,0.4,0.520833,1312,0,0
8592009,"Lausanne, Chandolin",,0.000023,10,1,1,2,31595,31596,63191,4,0.4,0.520833,28,0,0
8592033,"Lausanne, Druey",,0.000045,10,4,1,5,30117,30114,60231,15,0.159255,0.197295,182.257596,0,0
8592039,"Lausanne, Elysée",,0.000031,10,1,1,2,37110,37117,74227,16,0.137297,0.171036,216.728083,0,0
8592042,"Lausanne, Fauconnières",,0.000033,5,1,1,2,57320,55011,112331,15,0.112224,0.143727,241.5,0,0
8592097,"Lausanne, Pont Marc Dufour",,0.000042,10,2,1,3,38891,38743,77634,13,0.149547,0.181568,112.666667,0,0
8592099,"Lausanne, Praz-Berthoud",,0.00005,10,1,1,2,57883,1781,59664,13,0.149547,0.181568,198,0,0
8592060,"Lausanne, Beaulieu-Jomini",,0.000107,10,3,6,9,127205,127195,254400,13,0.18892,0.267637,17158.488529,0,0
8592077,"Lausanne, Montchoisi",,0.000098,10,5,5,10,108629,108704,217333,12,0.19349,0.276381,4996.24223,0,0
8592082,"Lausanne, Motte",,0.000077,10,5,7,12,144864,141621,286485,12,0.191806,0.286305,4459.5989,0,0
8592088,"Lausanne, Parc Vélodrome",,0.000056,10,3,4,7,62326,62527,124853,12,0.184448,0.255708,801.160317,0,0
8592096,"Lausanne, Pont Chauderon",,0.000089,10,6,6,12,63933,64001,127934,12,0.185874,0.269561,2781.292448,0,0
8592101,"Lausanne, Praz-Séchaud",,0.000094,10,3,2,5,42407,42468,84875,12,0.174067,0.223118,1490.833333,0,0
8592037,"Lausanne, Cojonnex/EHL",,0.000115,13,3,2,5,16856,15254,32110,13,0.158879,0.293509,2384.810134,0,0
8592016,"Lausanne, Chocolatière",,0.000016,10,1,1,2,28983,28977,57960,16,0.118512,0.147084,690.013636,0,0
8592018,"Lausanne, Cigale",,0.000041,10,2,1,3,57883,57883,115766,15,0.117034,0.138851,830,0,0
8592020,"Lausanne, Closelet",,0.000022,10,1,1,2,42413,42405,84818,16,0.12724,0.156091,391.431119,0,0
8592053,"Lausanne, Grande-Borde",,0.000061,10,6,4,10,88987,88883,177870,14,0.151856,0.211144,9467.896242,0,0
8592022,"Lausanne, Couchirard",,0.000046,5,2,1,3,44947,44831,89778,14,0.132262,0.154165,808.858333,0,0
8592023,"Lausanne, Coudrette",,0.000026,5,2,1,3,57308,57320,114628,16,0.102518,0.133253,604.5,0,0
8592025,"Lausanne, Craivavers",,0.000029,10,1,1,2,33368,33369,66737,3,0.5,0.611111,987,0,0
8592028,"Lausanne, Délices",,0.000023,10,1,1,2,37115,37110,74225,17,0.121557,0.147251,479.728083,0,0
8592030,"Lausanne, Désert",,0.000041,10,2,1,3,39172,39173,78345,15,0.138746,0.167751,434.608587,0,0
8592031,"Lausanne, Devin",,0.000035,10,1,1,2,33369,33367,66736,2,0.666667,0.75,660,0,0
8592035,"Lausanne, Ecole Commerce",,0.000041,10,3,4,7,49803,49806,99609,13,0.170772,0.235845,1380.705802,0,0
8592092,"Lausanne, Piécettes",,0.000028,10,1,3,4,41885,41459,83344,11,0.204167,0.298163,51.034921,0,0
8592104,"Lausanne, Presbytère",,0.000114,10,5,4,9,74814,74829,149643,11,0.205298,0.28164,6492.778865,0,0
8592107,"Lausanne, Rapille",,0.000032,10,2,2,4,49896,49711,99607,9,0.210046,0.272895,54.204762,0,0
8592076,"Lausanne, Mont-Blanc",,0.000026,10,1,2,3,52343,52363,104706,13,0.168254,0.22927,984.413036,0,0
8592085,"Lausanne, Oiseaux",,0.00003,10,2,1,3,25902,25890,51792,13,0.157012,0.197702,87.959495,0,0
8592125,"Lausanne, Valentin",,0.000117,10,4,3,7,95935,94059,189994,9,0.233766,0.330776,1684.4,0,0
8592175,"Prilly, Chasseur",,0.000062,5,2,2,4,53914,30941,84855,9,0.2,0.2902,1497.451826,0,0
8592036,"Lausanne, Ecole des Métiers",,0.00005,5,1,1,2,44831,44833,89664,13,0.150997,0.178067,825.858333,0,0
8592058,"Lausanne, Haute Combe",,0.000074,13,2,2,4,32788,32791,65579,12,0.173913,0.310617,1329.4116,0,0
8592062,"Lausanne, Jurigoz",,0.000079,10,5,3,8,71360,71559,142919,13,0.167546,0.227942,6311.937064,0,0
8592071,"Lausanne, Mémise",,0.000079,10,4,4,8,89000,88886,177886,13,0.171516,0.243858,4774.167827,0,0
8592072,"Lausanne, Mirabeau",,0.000072,10,4,4,8,59053,59017,118070,13,0.174352,0.246555,5976.203005,0,0
8592045,"Lausanne, Floreyres",,0.00003,10,1,1,2,31596,31600,63196,3,0.5,0.611111,24,0,0
8592046,"Lausanne, Fontenay",,0.000038,10,2,1,3,38818,38744,77562,16,0.119847,0.145817,472.806818,0,0
8592055,"Lausanne, Grangette",,0.000035,10,2,3,5,35588,35592,71180,13,0.166018,0.228139,898.295533,0,0
8592098,"Lausanne, Port-Franc",,0.000029,5,1,1,2,44495,44724,89219,11,0.179439,0.214869,0,0,0
8592102,"Lausanne, Prélaz",,0.00015,5,9,3,12,75250,75234,150484,11,0.204211,0.270198,11906.28941,0,0
8592056,"Lausanne, Grattapaille",,0.000047,10,3,1,4,35773,35684,71457,14,0.159905,0.202296,15895.424915,0,0
8592057,"Lausanne, Grey",,0.000046,10,1,1,2,39173,39172,78345,14,0.159905,0.202296,202.608587,0,0
8592080,"Lausanne, Montoie",,0.000067,10,3,3,6,85979,85977,171956,13,0.170248,0.232498,723.64697,0,0
8592084,"Lausanne, Musée Olympique",,0.000028,10,1,5,6,74011,74013,148024,12,0.192164,0.271911,1135.651325,0,0
8592064,"Lausanne, Languedoc",,0.000043,10,1,1,2,38744,38748,77492,15,0.135076,0.169405,172.806818,0,0
8592061,"Lausanne, Jordils",,0.000023,10,1,2,3,42394,42411,84805,14,0.151741,0.198677,1007.193074,0,0
8592068,"Lausanne, Maladière",,0.00006,10,2,3,5,85147,85991,171138,14,0.154912,0.209547,954.095809,0,0
8592110,"Lausanne, Riant-Cour",,0.000035,10,2,2,4,84289,83994,168283,12,0.149606,0.221023,657.714286,0,0
8592067,"Lausanne, Lisière",,0.000053,10,1,2,3,28965,28938,57903,14,0.148631,0.196474,899,0,0
8592054,"Lausanne, Grand Vennes",,0.000034,10,2,1,3,28937,28966,57903,18,0.095702,0.115517,2215,0,0
8592070,"Lausanne, Mauvernay",,0.000091,13,2,2,4,15254,13224,28478,12,0.166667,0.297992,1136.377289,0,0
8592059,"Lausanne, Hermitage",,0.00004,10,1,1,2,28966,28990,57956,17,0.104933,0.126757,1889,0,0
8592094,"Lausanne, Pierrefleur",,0.000033,10,1,1,2,39173,39173,78346,12,0.171846,0.213996,94,0,0
8592063,"Lausanne, Lac Sauvabelin",,0.000045,10,1,1,2,28990,28871,57861,16,0.116232,0.141623,1561,0,0
8592065,"Lausanne, Les Chavannes",,0.000041,10,1,1,2,33367,33369,66736,1,1,1,331,0,0
8592066,"Lausanne, Libellules",,0.000049,10,1,1,2,28871,28965,57836,15,0.130385,0.162607,1231,0,0
8592075,"Lausanne, Mont d'Or",,0.000028,10,1,1,2,38717,38726,77443,14,0.146685,0.18444,0,0,0
8592091,"Lausanne, Petit Château",,0.000033,10,1,1,2,14629,14684,29313,16,0.105263,0.157011,10,0,0
8592111,"Lausanne, Rouvraie",,0.000039,10,3,4,7,68430,70379,138809,11,0.206278,0.318695,1090.506173,0,0
8592120,"Lausanne, St-Roch",,0.00009,10,5,4,9,112470,106565,219035,10,0.223958,0.333739,1048.4297,0,0
8592122,"Lausanne, Tivoli",,0.000062,10,1,2,3,28989,28880,57869,12,0.15544,0.256418,120,0,0
8592073,"Lausanne, Molliettes",,0.000081,13,2,1,3,32791,32787,65578,11,0.173333,0.266914,907,0,0
8592074,"Lausanne, Mon Repos",,0.000037,10,1,1,2,31600,31598,63198,2,0.666667,0.75,18,0,0
8592114,"Lausanne, Sablons",,0.000026,5,1,1,2,37115,37110,74225,11,0.148148,0.203194,33.333333,0,0
8592132,"Lausanne, Vieux-Moulin",,0.000149,10,8,3,11,114311,48471,162782,11,0.174699,0.296322,2430.893867,0,0
8592143,"Le Mont-sur-Lausanne, Martines",,0.000071,10,1,2,3,35590,35591,71181,11,0.155844,0.250416,896.25,0,0
8592078,"Lausanne, Montétan",,0.000044,5,2,1,3,57523,57530,115053,14,0.124153,0.157352,948,0,0
8592081,"Lausanne, Montolieu",,0.000046,10,1,1,2,57883,57883,115766,14,0.131234,0.156377,515,0,0
8592083,"Lausanne, Mousquines",,0.000042,10,1,1,2,31598,31596,63194,1,1,1,10,0,0
8592116,"Lausanne, Stade Olympique",,0.000069,10,3,2,5,62337,62525,124862,10,0.208531,0.281457,130.749666,0,0
8592134,"Lausanne, Villard",,0.00003,10,1,1,2,46444,19296,65740,4,0.416667,0.516667,0,0,0
8592086,"Lausanne, Ouchy-Olympique",,0.000053,10,2,1,3,71667,71658,143325,9,0.208333,0.31623,4580,0,0
8592087,"Lausanne, Parc Rivier",,0.000026,10,1,1,2,39173,39173,78346,13,0.147975,0.177959,438,0,0
8592113,"Lausanne, rue Neuve",,0.000078,10,5,2,7,76001,76003,152004,10,0.205479,0.273351,547.446092,0,0
8592089,"Lausanne, Pavement",,0.00002,10,1,1,2,41884,41885,83769,12,0.172414,0.227898,468.034921,0,0
8592090,"Lausanne, Pêcheurs",,0.000056,10,1,1,2,71658,71673,143331,8,0.236842,0.35754,4131,0,0
8592105,"Lausanne, Provence nord",,0.000056,10,2,1,3,28985,28983,57968,15,0.114187,0.16846,1398,0,0
8592106,"Lausanne, Provence sud",,0.000058,10,1,1,2,28983,28969,57952,14,0.125,0.184189,974,0,0
8592115,"Lausanne, Signal",,0.000061,10,1,1,2,28969,28989,57958,13,0.138393,0.208396,548,0,0
8592118,"Lausanne, St-Etienne",,0.000062,10,2,2,4,42467,42466,84933,3,0.571429,0.708333,2060,0,0
8592126,"Lausanne, Vallonnette",,0.000037,10,1,1,2,40685,40674,81359,3,0.5,0.611111,0,0,0
8592119,"Lausanne, St-Paul",,0.000048,5,1,1,2,57530,57522,115052,13,0.139175,0.176038,581,0,0
8592121,"Lausanne, Théâtre de Vidy",,0.000058,10,1,2,3,71673,71676,143349,7,0.275862,0.449107,3680,0,0
8592127,"Lausanne, Valmont",,0.000069,10,2,1,3,42455,40686,83141,2,0.666667,0.75,1034,0,0
8592130,"Lausanne, Vert-Bois/EHL",,0.000155,13,3,1,4,8576,3223,11799,9,0.22,0.332937,2297.633333,0,0
8592131,"Lausanne, Victor-Ruffy",,0.00007,10,1,1,2,40686,40681,81367,1,1,1,518,0,0
8592137,"Lausanne, Cascades",,0.000079,10,2,2,4,28884,28964,57848,1,1,1,1058,0,0
8592138,"Lausanne, Vulliemin",,0.000045,10,1,1,2,14564,14595,29159,1,1,1,0,0,0
8592139,"Le Mont-sur-Lausanne, Budron",,0.000032,5,1,1,2,26289,26289,52578,7,0.235294,0.311905,2356.25,0,0
8592140,"Le Mont-sur-Lausanne, Côtes",,0.000071,10,3,1,4,35588,35590,71178,12,0.139665,0.209701,1401.25,0,0
8592141,"Le Mont-sur-Lausanne, Etavez",,0.000038,5,1,1,2,26289,26288,52577,6,0.282051,0.362121,1994.25,0,0
8593249,"Le Mont-sur-Lausanne, Rionzi",,0.000072,5,2,1,3,35697,35592,71289,1,1,1,351.25,0,0
8592145,"Lutry, avenue William",,0.000028,10,1,1,2,12702,12702,25404,15,0.11828,0.187424,1366,0,0
8592146,"Lutry, Brélaz",,0.00002,10,1,1,2,5477,5477,10954,12,0.154472,0.232147,3049,0,0
8592147,"Lutry, Brûlées",,0.000035,10,1,1,2,12702,12702,25404,14,0.128049,0.198635,1050,0,0
8592149,"Lutry, Corsy-Dessous",,0.00004,10,1,1,2,12702,12701,25403,13,0.13986,0.212838,732,0,0
8592150,"Lutry, Grand-Pont",,0.000049,10,3,1,4,49164,48965,98129,8,0.222222,0.321726,5065,0,0
8592151,"Lutry, Colline",,0.000045,10,1,1,2,12701,12702,25403,12,0.154472,0.232147,412,0,0
8592152,"Lutry, Corsy-Dessus",,0.000049,10,1,1,2,12702,12702,25404,11,0.173077,0.261907,90,0,0
8592153,"Lutry, Gravesse",,0.000028,10,1,1,2,5477,5477,10954,11,0.173077,0.261907,2731,0,0
8592154,"Lutry, Les Champs",,0.000077,10,2,2,4,18179,18176,36355,10,0.197674,0.323436,2513,0,0
8592155,"Lutry, Corniche",,0.000053,10,1,2,3,48965,48965,97930,7,0.261905,0.405411,4560,0,0
8592159,"Lutry, Ponfilet",,0.000052,10,1,2,3,12702,12702,25404,7,0.25,0.395952,135,0,0
8592160,"Lutry, Rive",,0.000033,10,1,1,2,22145,22145,44290,7,0.243902,0.345952,0,0,0
8592156,"Lutry, port",,0.000044,10,1,1,2,5477,5477,10954,4,0.4,0.520833,1035,0,0
8592157,"Lutry, Marionnettes",,0.000044,10,1,1,2,12699,12702,25401,9,0.190476,0.285847,805,0,0
8592158,"Lutry, Orzens",,0.000048,10,1,1,2,12702,12702,25404,8,0.215686,0.320671,471,0,0
8592164,"Lutry, Voisinand",,0.000083,10,3,2,5,55831,55821,111652,6,0.290323,0.433333,3658,0,0
8593856,"Lutry, Bossières",,0.000055,10,1,1,2,5477,5477,10954,1,1,1,3,0,0
8592161,"Lutry, Savoie",,0.000048,10,1,1,2,5477,5477,10954,3,0.5,0.611111,693,0,0
8592162,"Lutry, Savuit-place",,0.000052,10,1,1,2,5477,5477,10954,2,0.666667,0.75,349,0,0
8592165,"Moudon, Sorbiers",,0.00011,13,2,1,3,7530,7530,15060,4,0.4,0.520833,1114.283333,0,0
8592167,"Paudex, Marronnier",,0.000046,10,1,1,2,48958,48963,97921,5,0.318182,0.409524,2622,0,0
8592168,"Paudex, Verrière",,0.000084,10,5,2,7,36921,36900,73821,3,0.571429,0.708333,2092,0,0
8592170,"Pully, Bourdonnière",,0.000047,10,1,1,2,36822,36868,73690,3,0.5,0.611111,0,0,0
8592169,"Paudex, village",,0.00005,10,1,1,2,48963,48959,97922,4,0.4,0.486111,2096,0,0
8592185,"Pully, Margerol",,0.000048,10,1,1,2,45737,45737,91474,4,0.4,0.486111,1120,0,0
8592172,"Pully, C. F. Ramuz",,0.000133,5,5,1,6,71696,71810,143506,10,0.166667,0.222498,1789.209585,0,0
8592176,"Prilly, Coudraie",,0.000092,10,4,3,7,80445,80346,160791,8,0.236559,0.350866,2256.571429,0,0
8592180,"Prilly, Grand Vigne",,0.000042,10,1,1,2,30535,30529,61064,8,0.213483,0.274687,19,0,0
8592177,"Pully, Daillettes",,0.000039,10,2,1,3,45737,45737,91474,6,0.266667,0.3625,1814,0,0
8592179,"Prilly, Flumeaux",,0.000037,10,1,1,2,30534,30535,61069,9,0.183486,0.242063,531,0,0
8592181,"Prilly, Huttins",,0.000025,5,1,1,2,57534,57522,115056,1,1,1,457,0,0
8592182,"Pully, Joliette",,0.000124,5,1,1,2,71810,71809,143619,9,0.191304,0.250361,1278.209585,0,0
8592183,"Pully, Les Liaudes",,0.000044,10,1,1,2,45737,45737,91474,5,0.318182,0.409524,1468,0,0
8592186,"Pully, Métairie",,0.000116,5,1,1,2,71809,71806,143615,8,0.225806,0.296145,765.209585,0,0
8592188,"Pully, Montillier",,0.000095,10,2,2,4,94696,94707,189403,3,0.555556,0.666667,2690,0,0
8592189,"Pully, Moulins",,0.000051,10,1,2,3,48971,48964,97935,3,0.571429,0.708333,269.5,0,0
8592190,"Pully, Perraudettaz",,0.000073,10,2,2,4,94611,94676,189287,2,0.75,0.833333,1349.5,0,0
8592191,"Pully, Pavillard",,0.000042,10,1,1,2,45737,45737,91474,1,1,1,541,0,0
8592209,"Renens VD, Censuy",,0.000172,5,5,3,8,94868,94861,189729,6,0.326923,0.454902,8435.457082,0,0
8592197,"Pully, Tour Haldimand",,0.000086,10,2,1,3,36946,36900,73846,2,0.666667,0.75,1050,0,0
8592198,"Pully, Verney",,0.000084,10,1,1,2,36900,36900,73800,1,1,1,526,0,0
8592203,"Renens VD, Baumettes",,0.000047,5,2,1,3,43682,43681,87363,13,0.136364,0.212927,1036.5,0,0
8592204,"Renens VD, Bois-Genoud",,0.000051,5,1,1,2,43681,43681,87362,12,0.150376,0.237762,545.5,0,0
8592205,"Renens VD, Borjod",,0.000057,5,2,1,3,18049,18049,36098,12,0.150376,0.237762,3149.5,0,0
8592206,"Renens VD, Bourg-Dessus",,0.000103,5,2,2,4,61730,61730,123460,11,0.168142,0.289496,3207,0,0
8592207,"Renens VD, Broye",,0.000055,5,1,1,2,43681,43684,87365,10,0.164835,0.245529,1110,0,0
8592208,"Renens VD, Bugnon",,0.000057,5,1,1,2,43684,43685,87369,9,0.184211,0.26712,595,0,0
8593837,"Lausanne, Maladière-Figuiers",,0.000091,5,2,1,3,37114,36080,73194,4,0.421053,0.489583,56,0,0
8593868,"Chavannes-R., Concorde",,0.000079,5,2,1,3,58381,58381,116762,4,0.421053,0.489583,743,0,0
8592210,"Renens VD, Chêne",,0.00006,5,1,1,2,55450,55447,110897,9,0.180723,0.255503,3600.833333,0,0
8592211,"Renens VD, Florissant",,0.00006,5,1,1,2,43685,43683,87368,8,0.209677,0.299542,78,0,0
8592213,"Renens VD, Hôtel-de-Ville",,0.000059,5,2,1,3,68386,68385,136771,8,0.209677,0.299542,4756,0,0
8592212,"Renens VD, Follieu",,0.000055,5,1,1,2,18049,18049,36098,2,0.666667,0.75,1058,0,0
8592214,"Renens VD, Industrie",,0.000057,5,1,1,2,18049,18047,36096,1,1,1,530,0,0
8592215,"Renens VD, Longemalle",,0.000062,5,1,1,2,55447,55448,110895,8,0.205882,0.281718,3061.833333,0,0
8592217,"Renens VD, Perrelet",,0.000112,5,2,2,4,112068,112058,224126,7,0.244898,0.36746,4327,0,0
8592218,"Renens VD, Caudray",,0.000063,5,1,1,2,55448,55450,110898,7,0.240741,0.322527,2520.833333,0,0
8592219,"Renens VD, rue du Lac",,0.000065,5,1,2,3,55450,55442,110892,6,0.292683,0.408333,1977.833333,0,0
8592221,"Renens VD, Sous l'Eglise",,0.000058,5,1,1,2,68384,68385,136769,6,0.27027,0.348333,3271,0,0
8592224,"Ropraz, Corcelles-Jorat",,0.000161,13,3,1,4,4828,3223,8051,8,0.222222,0.339732,1870.866667,0,0
8592228,"Savigny, ancienne poste",,0.000217,13,3,1,4,5812,5690,11502,6,0.285714,0.408333,4464,0,0
8592229,"Savigny, Clair-Matin",,0.000195,13,1,1,2,5690,6155,11845,5,0.333333,0.456667,3725,0,0
8592230,"Savigny, Crêt-Rouge",,0.000177,13,1,1,2,6155,5690,11845,4,0.4,0.520833,2984,0,0
8592231,"Savigny, Grange-la-Ville",,0.000161,13,1,1,2,5690,6155,11845,3,0.5,0.611111,2241,0,0
8592232,"Savigny, Palaz",,0.000148,13,1,1,2,6155,5690,11845,2,0.666667,0.75,1496,0,0
8592233,"Savigny, Publoz",,0.000137,13,1,1,2,5690,5690,11380,1,1,1,749,0,0
8592240,"Denges, Pierraz-Mur",,0.0001,5,4,2,6,50297,50293,100590,9,0.194656,0.2399,13532.781818,0,0
8592241,"Denges, Sur les Moulins",,0.000054,5,1,1,2,16035,16035,32070,9,0.180451,0.215732,3263.781818,0,0
8592248,"Ecublens VD, Larges Pièces",,0.000053,5,1,2,3,16465,15951,32416,8,0.209524,0.258469,129.916667,0,0
8592249,"Lonay, Carouge",,0.000076,5,2,2,4,42617,42619,85236,8,0.211823,0.261157,1595.634848,0,0
8592243,"Echandens, Riaz",,0.000104,5,5,1,6,51087,51080,102167,10,0.156463,0.192918,2929.551515,0,0
8592244,"Echandens, Chocolatière",,0.000099,5,1,2,3,51080,51084,102164,9,0.181452,0.231041,2543.551515,0,0
8592258,"Morges, Bellevue",,0.000023,5,1,2,3,33505,33497,67002,6,0.3125,0.36381,12,0,0
8592253,"Lonay, Levant",,0.00004,5,1,1,2,34624,34625,69249,7,0.25,0.288847,1128,0,0
8592283,"Tolochenaz, Les Saux",,0.0001,5,3,2,5,47593,45685,93278,4,0.478261,0.55303,691.583333,0,0
8592284,"Tolochenaz, Molliau",,0.000073,5,2,3,5,29117,29112,58229,4,0.5,0.608333,193.835714,0,0
8592257,"Morges, Banc-Vert",,0.000029,5,2,2,4,33586,33555,67141,6,0.288,0.333796,472.154279,0,0
8592262,"Morges, Charpentiers",,0.000151,5,7,4,11,45433,45446,90879,5,0.358696,0.435354,6186.354679,0,0
8592259,"Morges, Bief",,0.000054,5,1,1,2,34258,34257,68515,7,0.220859,0.257209,9466,0,0
8592266,"Morges, La Prairie",,0.000074,5,3,1,4,34558,34557,69115,7,0.268041,0.320879,449.845455,0,0
8592268,"Morges, Grosse-Pierre",,0.000096,5,5,2,7,34197,34242,68439,5,0.358209,0.422917,2148.086014,0,0
8592273,"Morges, Eglantine",,0.000052,5,2,3,5,34556,34555,69111,5,0.377049,0.454348,26.5,0,0
8592267,"Morges, Grassey",,0.000078,5,3,2,5,25361,25064,50425,6,0.305556,0.37803,960.638745,0,0
8592269,"Morges, hôpital",,0.000085,5,2,3,5,29930,29930,59860,6,0.318182,0.410317,786.403535,0,0
8592272,"Morges, St-Jean sud",,0.000082,5,3,3,6,34227,34256,68483,6,0.32,0.404167,2946.340404,0,0
8592276,"Morges, St-Domingue",,0.000024,5,1,1,2,8140,8140,16280,7,0.25974,0.319643,5,0,0
8592281,"Tolochenaz, Le Portail",,0.000049,5,1,2,3,31483,31483,62966,6,0.302326,0.40641,99.733333,0,0
8592280,"Tolochenaz, La Grillette",,0.000136,5,6,3,9,42933,42890,85823,5,0.4,0.508333,1678.328571,0,0
8592282,"Tolochenaz, Les Noyers",,0.000045,5,2,1,3,27538,27536,55074,5,0.342857,0.398611,10,0,0
8592277,"Morges, St-Louis",,0.000049,5,2,1,3,17035,17037,34072,3,0.5,0.611111,604.9,0,0
8592279,"Préverenges, Taudaz",,0.000084,5,2,1,3,34261,33940,68201,2,0.666667,0.75,952,0,0
8595220,"Lonay, collège sud",,0.000098,5,4,1,5,38956,17626,56582,1,1,1,374.483333,0,0
8595221,"Lussy-sur-Morges, Riettaz",,0.000091,5,3,1,4,24098,23868,47966,1,1,1,54.961905,0,0
8595646,"St-Prex, Epondaz",,0.000075,5,1,1,2,6259,6167,12426,1,1,1,39.452381,0,0
8592285,"Vaux-sur-Morges, bif. Bugnon",,0.000027,5,1,1,2,4991,4800,9791,2,0.666667,0.75,116,0,0
8592286,"Bäch SZ, Badi",,0.000049,113,1,1,2,15303,15303,30606,7,0.25,0.370408,518,0,0
8592287,"Bäch SZ, Bahnhof",,0.000052,113,1,1,2,15303,15303,30606,6,0.285714,0.408333,450,0,0
8592289,"Bäch SZ, Schulhaus",,0.000055,113,1,1,2,15303,15303,30606,5,0.333333,0.456667,380,0,0
8592290,"Freienbach, Bezirksschule",,0.000058,113,1,1,2,15303,15303,30606,4,0.4,0.520833,308,0,0
8592291,"Freienbach, Obstgarten",,0.00006,113,1,1,2,15303,15303,30606,3,0.5,0.611111,234,0,0
8592292,"Freienbach, Seeberg",,0.000062,113,1,1,2,15303,15303,30606,2,0.666667,0.75,158,0,0
8592293,"Freienbach, Stationsweg",,0.000064,113,1,1,2,15303,15303,30606,1,1,1,80,0,0
8592294,"Pfäffikon SZ, Zentrum",,0.000018,113,1,1,2,22493,22493,44986,5,0.333333,0.456667,165,0,0
8592295,"Pfäffikon SZ, Eichenstrasse",,0.000027,113,1,1,2,22493,22493,44986,4,0.4,0.520833,136,0,0
8592296,"Pfäffikon SZ, Zeughaus",,0.000033,113,1,1,2,22493,22493,44986,3,0.5,0.611111,105,0,0
8592297,"Pfäffikon SZ, Hofmatt",,0.000039,113,1,1,2,22493,22493,44986,2,0.666667,0.75,72,0,0
8592298,"Pfäffikon SZ, Roggenacker",,0.000044,113,1,1,2,22493,21237,43730,1,1,1,37,0,0
8592304,Hölstein Süd Station,,0.000032,2,1,1,2,6455,6455,12910,2,0.666667,0.75,326,0,0
8592306,Niederdorf Hirschlang,,0.000039,2,1,1,2,6455,6455,12910,1,1,1,164,0,0
8592309,"Adelboden, Dorf Sillerenbahn",,0.00002,43,1,2,3,4192,4192,8384,5,0.321429,0.451852,144,0,0
8592310,"Adelboden, Gilbach, des Alpes",,0.000019,43,1,1,2,646,646,1292,4,0.368421,0.452381,59.5,0,0
8592311,"Adelboden, Gulli",,0.000019,43,1,1,2,3546,3560,7106,4,0.368421,0.452381,59.5,0,0
8592312,"Adelboden, Heinrichseggen",,0.000044,43,2,2,4,4206,4206,8412,3,0.5,0.611111,114,0,0
8592313,"Adelboden, Jugendh. Heilsarmee",,0.00003,43,1,1,2,3560,3560,7120,4,0.4,0.520833,40,0,0
8592314,"Adelboden, Schermtanne",,0.000036,43,1,1,2,3560,3560,7120,3,0.5,0.611111,23,0,0
8592315,"Adelboden, Schreiner Bärtschi",,0.000041,43,1,1,2,3560,3560,7120,2,0.666667,0.75,4,0,0
8592316,"Adelboden, Unter der Fluh",,0.00003,43,1,1,2,646,646,1292,2,0.666667,0.75,40,0,0
8592317,"Adelboden, Wegscheide",,0.000071,43,2,1,3,4206,3560,7766,1,1,1,24,0,0
8592319,"Kandersteg, Erika",,0.000054,43,2,1,3,2714,1114,3828,1,1,1,53,0,0
8593504,Pantheon,,0.000061,2,1,1,2,2706,2592,5298,2,0.666667,0.75,0,0,0
8592366,"Fribourg, Torry",,0.000099,126,3,1,4,53161,53080,106241,6,0.237288,0.29881,3910,0,0
8592367,"Fribourg, Bourgknecht",,0.000095,126,1,1,2,53080,53080,106160,5,0.288889,0.347436,1986,0,0
8592369,"Fribourg, Champ-des-Fontaines",,0.000209,126,6,1,7,37653,38565,76218,5,0.3125,0.373333,2021.150501,0,0
8592372,"Fribourg, Eglise-St-Jean",,0.000031,126,2,2,4,37817,40303,78120,4,0.4375,0.559524,812,0,0
8592380,"Fribourg, Karrweg",,0.000024,126,1,1,2,20872,19916,40788,4,0.4,0.486111,0,0,0
8592382,"Fribourg, Miséricorde",,0.000205,126,2,1,3,90584,13440,104024,1,1,1,2,0,0
8592389,"Fribourg, Villa-Beau-Site",,0.000056,126,1,1,2,9792,2538,12330,1,1,1,0,0,0
8592375,"Fribourg, Guintzet",,0.000087,126,1,1,2,32995,32629,65624,2,0.666667,0.75,3924,0,0
8592376,"Fribourg, Guisan",,0.000087,126,1,1,2,53080,53080,106160,2,0.666667,0.75,973.566416,0,0
8592379,"Fribourg, Jura Chassotte",,0.000141,126,2,1,3,38128,37504,75632,2,0.666667,0.75,988.433584,0,0
8592377,"Villars-sur-Glâne, Hôp. cant.",,0.000085,126,1,1,2,32629,32629,65258,1,1,1,1963,0,0
8592383,"Fribourg, Neuveville/Court-Ch.",,0.000044,126,2,2,4,39347,40303,79650,3,0.555556,0.666667,590,0,0
8592384,"Fribourg, Palme",,0.00003,126,1,1,2,38758,36269,75027,3,0.5,0.583333,0,0,0
8592385,"Fribourg, Neuveville/Motta",,0.000055,126,2,2,4,37814,39085,76899,2,0.75,0.833333,360,0,0
8592386,"Fribourg, Petit-St-Jean",,0.000034,126,1,2,3,38757,36270,75027,1,1,1,121,0,0
8592395,"Ibach, Eichenweg",,0.000027,91,1,1,2,5785,5813,11598,8,0.202128,0.256704,668,0,0
8592396,"Ibach, Husmatt",,0.000038,91,2,1,3,4635,4635,9270,9,0.196581,0.256798,606,0,0
8592399,"Ibach, Muotastrasse",,0.000049,91,4,2,6,4284,3405,7689,7,0.277778,0.36631,934.5,0,0
8592400,"Ibach, Plätzli",,0.000044,91,2,1,3,3876,4672,8548,7,0.267606,0.332957,292.5,0,0
8592401,"Ibach, Rainweg",,0.000034,91,1,1,2,5813,5813,11626,7,0.24,0.294974,403,0,0
8592405,"Küssnacht, Räbmatt",,0.000168,91,3,2,5,24750,24881,49631,3,0.545455,0.638889,2208,0,0
8592410,"Schwyz, Grundstrasse",,0.000045,91,1,1,2,5548,5813,11361,4,0.357143,0.466667,639,0,0
8592418,"Schwyz, Salesheim",,0.000058,91,1,1,2,6048,5890,11938,3,0.5,0.611111,12,0,0
8592414,"Schwyz, Lärchenweg/Kollegi",,0.000045,91,1,1,2,4769,5890,10659,7,0.25,0.370408,1328,0,0
8592415,"Schwyz, Loostrasse",,0.000049,91,1,1,2,5890,6048,11938,6,0.285714,0.408333,1002,0,0
8592416,"Schwyz, Obermatt",,0.000053,91,1,1,2,6048,5890,11938,5,0.333333,0.456667,674,0,0
8592417,"Schwyz, Rest. Mythen",,0.000056,91,1,1,2,5890,6048,11938,4,0.4,0.520833,344,0,0
8592419,"Schwyz, St. Martinstrasse",,0.00008,91,2,1,3,7722,5667,13389,2,0.666667,0.75,676,0,0
8592420,"Schwyz, Weidhuobli",,0.000079,91,1,1,2,5667,6048,11715,1,1,1,339,0,0
8592423,"Weggis, Bannholz",,0.000036,91,1,1,2,2130,2260,4390,16,0.117647,0.211296,3267,0,0
8592424,"Weggis, Bodenberg",,0.000042,91,1,1,2,2260,2260,4520,15,0.125,0.221215,2919,0,0
8592425,"Weggis, Föhrenrain",,0.000046,91,1,1,2,2260,2260,4520,14,0.133333,0.232254,2569,0,0
8592426,"Weggis, Lärchenweg",,0.00005,91,1,1,2,2260,2214,4474,13,0.142857,0.244626,2217,0,0
8592427,"Weggis, Lützelau",,0.000082,91,1,2,3,18768,18768,37536,1,1,1,738,0,0
8592428,"Weggis, Magnolienweg",,0.000054,91,1,1,2,2214,2260,4474,12,0.153846,0.258601,1863,0,0
8592429,"Weggis, Obstbaumstrasse",,0.000056,91,1,1,2,2260,2260,4520,11,0.166667,0.274534,1507,0,0
8592433,"Weggis, Tannenbergstrasse",,0.000059,91,1,1,2,2260,2260,4520,10,0.181818,0.292897,1149,0,0
8592456,"Biel/Bienne, Am Stutz",,0.000034,87,1,1,2,16319,16319,32638,4,0.384615,0.483333,1250,0,0
8592457,"Biel/Bienne, Bärenhof",,0.00004,87,1,1,2,48513,48461,96974,11,0.168317,0.241435,5201,0,0
8592458,"Biel/Bienne, Battenberg",,0.000045,87,1,1,2,48461,48460,96921,10,0.190476,0.266989,3958,0,0
8592462,"Biel/Bienne, Fuchsenried",,0.000023,87,1,1,2,22627,22685,45312,9,0.208054,0.258807,1244,0,0
8592467,"Biel/Bienne, Löhre/Mauchamp",,0.000049,87,1,1,2,48460,48452,96912,9,0.220588,0.307487,2713,0,0
8592469,"Biel/Bienne, Museen/Musées",,0.000062,87,2,2,4,23051,23022,46073,2,0.75,0.833333,3744,0,0
8592476,"Biel/Bienne, Römergüetli",,0.000037,87,1,1,2,16290,16319,32609,2,0.666667,0.75,0,0,0
8592471,"Biel/Bienne, Diamantstrasse",,0.000094,87,4,5,9,61047,61167,122214,8,0.263158,0.36045,10809.433333,0,0
8592479,"Brügg BE, Brüggmoos",,0.000027,87,1,1,2,43177,43099,86276,12,0.12406,0.167777,0,0,0
8592480,"Brügg BE, Mehrzweckhalle",,0.00005,87,2,1,3,43151,43219,86370,11,0.137339,0.180992,32,0,0
8592478,"Brügg BE, Brüggfeld",,0.000097,87,2,2,4,31397,8782,40179,8,0.271186,0.385491,19639.666667,0,0
8593322,"Biel/Bienne, Bubenbergstrasse",,0.00006,87,4,4,8,63314,63246,126560,7,0.305263,0.416174,27540.566667,0,0
8593326,"Biel/Bienne, Erlacherweg/Cerl.",,0.000075,87,2,1,3,43259,43221,86480,7,0.243243,0.296384,162,0,0
8593332,"Biel/Bienne, Goldgrube/Mine-Or",,0.000031,87,1,1,2,31116,31124,62240,7,0.243243,0.296384,27,0,0
8592474,"Biel/Bienne, Piasio",,0.000053,87,1,2,3,48452,48452,96904,8,0.264151,0.392942,1466,0,0
8593321,"Biel/Bienne, Brühlplatz/Breuil",,0.00006,87,3,2,5,78171,78143,156314,6,0.315789,0.436111,14934.095238,0,0
8592481,"Brügg BE, Mooswäldli",,0.000069,87,2,1,3,43248,43253,86501,10,0.154229,0.198746,5158,0,0
8592482,"Brügg BE, Pfeid",,0.00007,87,1,1,2,43253,43185,86438,9,0.176471,0.224788,3912,0,0
8592483,"Nidau, Milanweg/Chemin Milan",,0.00007,87,1,2,3,43185,43259,86444,8,0.207143,0.272003,2664,0,0
8593315,"Biel/Bienne, Aegertenstrasse",,0.000041,87,1,1,2,21467,21467,42934,8,0.201439,0.246003,0,0,0
8592484,"Orvin, Sous les Roches",,0.000051,87,3,1,4,2208,2192,4400,1,1,1,1261,0,0
8592485,"Port, Gummen",,0.000033,87,2,1,3,16615,16660,33275,7,0.238532,0.292399,3172.157143,0,0
8593316,"Biel/Bienne, Alpenstrasse",,0.000025,87,2,2,4,29663,29661,59324,7,0.274725,0.351048,19306.414286,0,0
8593325,"Biel/Bienne, Eichhölzli/Pt-Chê",,0.000047,87,3,1,4,31046,31150,62196,7,0.266667,0.324008,13.666667,0,0
8593329,"Biel/Bienne, Eglise française",,0.000022,87,1,1,2,29550,29550,59100,7,0.266667,0.324008,0,0,0
8593330,"Biel/Bienne, Friedweg/Ch. Paix",,0.000042,87,3,2,5,24446,24393,48839,7,0.289157,0.37123,4582.014286,0,0
8592491,"Vauffelin, Les Oeuches",,0.000076,87,1,1,2,4243,2981,7224,1,1,1,1263,0,0
8592493,Einkaufszentren,,0.000049,66,2,2,4,32816,32815,65631,9,0.208333,0.282751,1131.92381,0,0
8592494,Hägli,,0.000032,66,1,1,2,19517,19518,39035,9,0.183824,0.230635,120,0,0
8592496,Neutal,,0.000038,66,1,1,2,19518,19518,39036,8,0.216216,0.26503,84,0,0
8592498,Rhytech,,0.000052,66,3,2,5,36565,36564,73129,14,0.132353,0.21031,1338.5,0,0
8592499,Bahnhofstrasse,,0.000033,66,1,2,3,26968,26969,53937,14,0.130952,0.211302,162,0,0
8592500,Burgunwiese,,0.000025,66,1,2,3,20364,20364,40728,13,0.136808,0.203158,126,0,0
8592501,Durstgraben,,0.000021,66,1,1,2,10085,10085,20170,13,0.13468,0.187274,8,0,0
8592502,Fernblick,,0.000047,66,2,2,4,16201,16201,32402,13,0.137931,0.212869,1137.5,0,0
8592503,Gemeindehaus,,0.000049,66,2,2,4,16690,16690,33380,12,0.151751,0.225256,808,0,0
8592504,Gemeindewiesen,,0.000021,66,1,1,2,10279,10279,20558,12,0.136752,0.182344,48,0,0
8592505,Herbstäcker,,0.00005,66,2,1,3,20364,20364,40728,11,0.153465,0.201025,846,0,0
8592506,Hohfluh,,0.000052,66,2,2,4,16201,16201,32402,5,0.375,0.547222,321.5,0,0
8592509,Rheinstrasse,,0.000033,66,1,1,2,6614,6614,13228,5,0.333333,0.456667,0,0,0
8592508,Neue Welt,,0.000053,66,1,1,2,20364,20364,40728,10,0.175439,0.228995,816,0,0
8592510,Rhenania,,0.000056,66,1,2,3,20364,20364,40728,9,0.205674,0.281007,784,0,0
8592516,Birkenstrasse,,0.00004,66,1,2,3,10089,10089,20178,8,0.241071,0.323854,27,0,0
8592511,Trubegüetli,,0.000061,66,2,1,3,16201,16201,32402,4,0.4,0.520833,211.5,0,0
8592512,Zuba,,0.000063,66,1,1,2,16201,16201,32402,3,0.5,0.611111,153.5,0,0
8592513,Alpenblick,,0.000035,66,1,1,2,9785,10089,19874,9,0.2,0.255329,63,0,0
8592519,Brüggli,,0.000052,66,2,1,3,20364,20262,40626,8,0.234234,0.297848,624,0,0
8592523,Busdepot,,0.000032,66,1,1,2,13298,15116,28414,8,0.234234,0.297848,921.92381,0,0
8592518,Bruderhöfli,,0.000035,66,1,1,2,19159,19159,38318,12,0.138095,0.188139,324,0,0
8592521,Buchthalen,,0.000041,66,1,1,2,19159,19159,38318,11,0.154696,0.207045,296,0,0
8592522,Spendtrottengut,,0.000046,66,1,1,2,19159,19159,38318,10,0.176471,0.235567,266,0,0
8592524,Cilag,,0.00005,66,2,2,4,19412,19412,38824,8,0.238532,0.323489,947,0,0
8592526,Dachsenbüel,,0.00005,66,1,2,3,19159,19159,38318,9,0.206349,0.289713,234,0,0
8592527,Durach,,0.000053,66,2,2,4,19280,19280,38560,8,0.240385,0.328429,306,0,0
8592540,GZM Mühlental,,0.000059,66,2,3,5,10215,9915,20130,8,0.234043,0.346699,398,0,0
8592542,Grafenbuckstieg,,0.000062,66,1,1,2,19159,19159,38318,8,0.223404,0.29178,63,0,0
8592534,Feuerwehrzentrum,,0.000094,66,5,4,9,59371,59438,118809,6,0.34375,0.457576,1468.209524,0,0
8592565,Niklausen,,0.000056,66,2,2,4,10089,10089,20178,2,0.75,0.833333,68.061905,0,0
8592576,Schönenberg,,0.000093,66,3,2,5,39779,39184,78963,1,1,1,121.547619,0,0
8592531,Ebnatring,,0.000032,66,1,1,2,15655,15117,30772,1,1,1,89,0,0
8592546,Grubenstieg,,0.000025,66,1,2,3,9928,9928,19856,5,0.368421,0.516667,134.5,0,0
8592563,Künzleheim - Munot,,0.000051,66,3,3,6,9999,9933,19932,3,0.538462,0.666667,484,0,0
8592552,Hohenstoffel,,0.000052,66,2,2,4,10109,10088,20197,3,0.555556,0.666667,207.480952,0,0
8592535,Frohberg,,0.000039,66,2,2,4,19861,19861,39722,5,0.363636,0.461111,930.5,0,0
8592544,Grenzstrasse,,0.000027,66,1,1,2,9933,9933,19866,5,0.34375,0.412121,0,0,0
8592536,Fulachbrücke,,0.000031,66,1,1,2,19515,19518,39033,4,0.357143,0.466667,200,0,0
8592537,Geissberg,,0.000055,66,2,1,3,19159,19159,38318,11,0.147239,0.201969,192,0,0
8592538,Geisshof,,0.000057,66,1,1,2,19159,19159,38318,10,0.165468,0.220738,151,0,0
8592539,Pflegezentrum,,0.00006,66,1,1,2,19159,19159,38318,9,0.189655,0.247691,108,0,0
8592543,Gräfler,,0.000124,66,4,3,7,38707,38707,77414,7,0.273973,0.38881,1292,0,0
8592541,Glockengut,,0.000037,66,1,1,2,19518,19517,39035,3,0.444444,0.541667,104,0,0
8592551,Hohberg,,0.00005,66,1,1,2,19412,19412,38824,7,0.246377,0.310364,17,0,0
8592569,Psychiatriezentrum,,0.000101,66,3,3,6,25004,19276,44280,3,0.625,0.766667,153.5,0,0
8592547,Grünau,,0.000043,66,1,1,2,19517,19518,39035,2,0.6,0.666667,6,0,0
8592561,Kronenhalde,,0.000053,66,2,2,4,20260,20261,40521,2,0.666667,0.75,202.128571,0,0
8592548,Hallenbad,,0.000064,66,1,1,2,16201,16201,32402,2,0.666667,0.75,93.5,0,0
8592549,Hanfpünt,,0.000046,66,1,1,2,19412,19412,38824,8,0.206897,0.266336,85,0,0
8592553,Hornbergstieg,,0.000088,66,2,2,4,38571,38571,77142,6,0.307692,0.4,1026,0,0
8592555,Im Freien,,0.000031,66,1,1,2,5822,5823,11645,3,0.416667,0.5,108,0,0
8592556,J.J.Wepferstrasse,,0.000048,66,1,1,2,19159,20621,39780,9,0.173913,0.267328,440,0,0
8592557,Kantonsspital,,0.000052,66,1,1,2,20621,19159,39780,8,0.192982,0.28658,363,0,0
8592558,Kegelgässchen,,0.000055,66,1,1,2,19159,19159,38318,7,0.217391,0.310238,284,0,0
8592560,Klingenstrasse,,0.000058,66,1,1,2,19159,19159,38318,6,0.25,0.340741,203,0,0
8592572,Riet,,0.000054,66,1,2,3,18803,18803,37606,4,0.4375,0.559524,287.5,0,0
8592575,Schweizersbild,,0.000062,66,1,1,2,19159,19159,38318,4,0.368421,0.452381,35,0,0
8592574,Säntisstrasse,,0.000054,66,2,1,3,3211,3211,6422,3,0.5,0.611111,0,0,0
8592567,Pilgerweg,,0.00006,66,1,1,2,19159,19159,38318,5,0.296296,0.383333,120,0,0
8592570,Quellenstrasse,,0.00005,66,2,1,3,18803,18803,37606,5,0.333333,0.420833,369.5,0,0
8592583,Stokarbergstrasse,,0.000065,66,1,1,2,16201,16201,32402,1,1,1,31.5,0,0
8592584,Trüllenbuck,,0.000059,66,1,1,2,19412,18608,38020,1,1,1,8,0,0
8594361,"Ramsen, Petersburg",,0.000109,65,5,1,6,18008,4682,22690,1,1,1,67.666667,0,0
8592577,Seidenhof,,0.000107,66,3,2,5,38571,38571,77142,3,0.5,0.611111,491,0,0
8592579,Spiegelgutstrasse,,0.000056,66,1,1,2,19159,19159,38318,2,0.666667,0.75,196,0,0
8592580,St. Peter,,0.000059,66,1,1,2,19159,19157,38316,1,1,1,99,0,0
8592581,Steingut,,0.000056,66,1,1,2,19412,19412,38824,2,0.666667,0.75,105,0,0
8592589,Winkelriedstrasse,,0.0001,66,3,1,4,9933,9933,19866,2,0.666667,0.75,236,0,0
8592590,Zündelgut,,0.000096,66,1,1,2,9933,3211,13144,1,1,1,119,0,0
8592591,"Davos Laret, Landhaus",,0.00007,131,3,3,6,12472,12472,24944,19,0.114504,0.245004,26663.252564,0,0
8592606,"Davos Platz, Tanzbühl",,0.000028,131,1,1,2,19022,12854,31876,7,0.25,0.370408,0,0,0
8592594,"Davos Wolfgang, Hochgebirgskl.",,0.000095,131,5,1,6,14748,14748,29496,17,0.112971,0.176992,20034.516667,0,0
8592595,"Davos Wolfgang, Seebüel",,0.000091,131,1,1,2,14748,14748,29496,16,0.122642,0.19134,18082.516667,0,0
8592596,"Davos Dorf, Meierhöfe",,0.000089,131,1,1,2,14748,14748,29496,15,0.134409,0.21308,16128.516667,0,0
8592598,"Davos Dorf, Parsennbahn",,0.000091,131,5,1,6,40401,41279,81680,14,0.119171,0.182607,22331,0,0
8592599,"Davos Dorf, Dischmastrasse",,0.000088,131,1,1,2,41279,41279,82558,13,0.129412,0.192912,20369,0,0
8592600,"Davos Dorf, Schiabach",,0.000086,131,1,1,2,41279,41279,82558,12,0.141892,0.205521,18405,0,0
8592601,"Davos Platz, Horlauben",,0.000084,131,1,1,2,41279,41279,82558,11,0.15748,0.221609,16439,0,0
8592602,"Davos Platz, Kongresszentrum",,0.000082,131,1,1,2,41279,41279,82558,10,0.17757,0.2434,14471,0,0
8592603,"Davos Platz, Sportzentrum",,0.000081,131,1,1,2,41279,41279,82558,9,0.204545,0.27575,12501,0,0
8592604,"Davos Platz, Schatzalpbahn",,0.00008,131,1,1,2,41279,41279,82558,8,0.242857,0.332003,10529,0,0
8592608,"Davos Platz, Skistrasse",,0.000039,131,2,1,3,14348,14491,28839,5,0.333333,0.456667,9960,0,0
8592609,"Davos Platz, Tobelmühlestrasse",,0.000044,131,1,1,2,14491,14491,28982,4,0.4,0.520833,7972,0,0
8592610,"Davos Platz, Tourismuszentrum",,0.000048,131,1,1,2,14491,14491,28982,3,0.5,0.611111,5982,0,0
8592611,"Davos Platz, Hertistrasse",,0.000052,131,1,1,2,14491,14491,28982,2,0.666667,0.75,3990,0,0
8592612,"Davos Dorf, Schiaweg",,0.000055,131,1,1,2,14491,14491,28982,1,1,1,1996,0,0
8592614,"Davos Dorf, Flüelastrasse",,0.000036,131,2,1,3,14744,14709,29453,1,1,1,1381,0,0
8592616,"Davos Dorf, Pischabahn",,0.000049,131,1,1,2,1083,1083,2166,1,1,1,612,0,0
8592615,"Davos Dorf, Bedra",,0.000044,131,3,1,4,1083,1083,2166,2,0.666667,0.75,2065,0,0
8592619,"Aire-la-Ville, Pont-de-Peney",,0.00003,120,2,1,3,18096,18095,36191,23,0.097811,0.110049,2476,0,0
8592620,"Aire-la-Ville, Treulaz",,0.000036,120,1,1,2,18095,18093,36188,22,0.108188,0.124026,2864,0,0
8592623,"Anières, Courbes",,0.000031,120,1,1,2,30883,30882,61765,22,0.109309,0.122348,429.499328,0,0
8592624,"Anières, douane",,0.000049,120,3,2,5,34531,34533,69064,22,0.116238,0.134376,2118.628894,0,0
8592626,"Anières, Marguerite",,0.000035,120,1,1,2,30883,30883,61766,27,0.082208,0.093123,238.5,0,0
8592628,"Avully, Martinet",,0.000036,120,2,2,4,25464,25466,50930,23,0.099034,0.115785,284.849803,0,0
8592631,"Avully, Touvière",,0.00006,120,3,3,6,17918,17916,35834,22,0.109253,0.132052,773.367354,0,0
8592637,"Avusy, Les Quoattes",,0.000021,120,1,1,2,8499,8501,17000,22,0.108335,0.125004,0,0,0
8592632,"Athenaz, école",,0.00002,120,1,1,2,17404,17404,34808,26,0.076293,0.084204,243,0,0
8592635,"Avusy, La Tuiliere",,0.000028,120,1,1,2,17404,17390,34794,25,0.082423,0.091464,645,0,0
8592636,"Sézegnin, Le Renfort",,0.000035,120,1,1,2,17390,17390,34780,24,0.089641,0.100396,1045,0,0
8593027,"Onex, Bandol",,0.000069,132,3,3,6,93312,84795,178107,7,0.258065,0.39747,1581.91814,0,0
8592640,"Croix-de-Rozon, place",,0.000028,120,3,1,4,39278,39284,78562,14,0.110849,0.137243,520.427794,0,0
8592641,"Croix-de-Rozon, Evordes",,0.000035,120,1,1,2,39284,39286,78570,13,0.123342,0.155345,525.427794,0,0
8592642,"Bardonnex, Feuillat",,0.000021,132,1,1,2,11546,11546,23092,13,0.114374,0.14226,965.424042,0,0
8592985,"Grand-Lancy, Burgy",,0.000033,120,1,1,2,19388,19389,38777,12,0.134375,0.169218,3839.707038,0,0
8592644,"Bardonnex, Charrot",,0.000029,132,1,1,2,11546,11545,23091,12,0.1274,0.15923,921.424042,0,0
8592645,"Bellevue GE, chemin des Clys",,0.000039,120,3,1,4,57798,57856,115654,18,0.134589,0.152497,788.697883,0,0
8592647,"Bellevue GE, Le Nant",,0.000044,120,1,1,2,57856,57802,115658,17,0.155125,0.182428,1064.697883,0,0
8592779,"Genève, Athénée",,0.000054,132,4,4,8,133421,133073,266494,19,0.141679,0.176484,959.840702,0,0
8592785,"Genève, Baulacre",,0.00003,132,2,3,5,45180,45333,90513,18,0.147222,0.184934,391.274591,0,0
8592794,"Genève, Bovy-Lysberg",,0.000039,132,3,3,6,63000,62949,125949,18,0.147352,0.185794,189.343544,0,0
8592808,"Genève, Colladon",,0.00003,132,3,1,4,56013,56021,112034,18,0.144223,0.173233,78.874052,0,0
8592810,"Genève, Contamines",,0.000058,132,4,6,10,96817,96814,193631,18,0.146371,0.188295,1297.771973,0,0
8592650,"Bernex, église",,0.000055,120,2,2,4,37293,41103,78396,22,0.108745,0.127417,2072.038035,0,0
8592651,"Bernex, Blanchards",,0.000021,120,1,1,2,8998,9010,18008,23,0.10868,0.122877,234,0,0
8592654,"Bernex, Chèvres",,0.000029,120,1,1,2,9010,9010,18020,22,0.121671,0.140919,583,0,0
8592662,"Bernex, Pré-Polly",,0.000038,120,1,1,2,23498,23501,46999,24,0.099224,0.111525,0,0,0
8592661,"Bernex, Pont-de-Lully",,0.000055,132,3,2,5,17615,17621,35236,22,0.127194,0.153503,1456.617311,0,0
8592664,"Bernex, Guillon",,0.000071,120,1,1,2,41101,41101,82202,22,0.123234,0.145761,942,0,0
8592687,"Cartigny, Moulin-de-Vert",,0.000055,120,2,2,4,21568,21751,43319,20,0.129973,0.156437,1878.513886,0,0
8592690,"Chancy, usine",,0.000047,120,1,2,3,25466,25466,50932,20,0.129088,0.154105,793.844949,0,0
8592759,"Bernex, Les Oulaines",,0.000038,120,1,2,3,24123,24123,48246,12,0.142857,0.172524,413.439579,0,0
8592663,"Bernex, Saule",,0.000071,120,2,1,3,41106,41101,82207,23,0.109921,0.125892,617,0,0
8595228,"Satigny, Centre sportif",,0.000032,120,1,1,2,15377,15384,30761,1,1,1,0,0,0
8592668,"Carouge GE, Ancienne",,0.000029,120,3,2,5,91458,91606,183064,22,0.119377,0.13944,386.306899,0,0
8592674,"Carouge GE, Fontenette",,0.000027,120,3,3,6,79457,79815,159272,21,0.135476,0.166517,833.339136,0,0
8592673,"Carouge GE, Fillion",,0.00003,133,2,1,3,18121,19870,37991,10,0.155405,0.208592,495.2,0,0
8592678,"Carouge GE, Moraines",,0.000019,120,1,1,2,23547,23545,47092,22,0.11233,0.12914,11.324935,0,0
8592680,"Carouge GE, Rue des Mouettes",,0.000035,120,2,1,3,46865,46893,93758,21,0.12622,0.149793,397.324935,0,0
8592675,"Carouge GE, Grange-Collomb",,0.00005,120,2,2,4,37883,37881,75764,11,0.151052,0.206014,1102.479526,0,0
8592994,"Grand-Lancy, Préventorium",,0.000056,120,2,2,4,39657,39662,79319,11,0.15343,0.205095,3888.010838,0,0
8592676,"Vessy, Vüy",,0.000036,133,1,1,2,19870,19871,39741,9,0.176,0.228373,403.2,0,0
8592709,"Chêne-Bourg, Peillonnex",,0.000072,132,4,3,7,132710,132725,265435,20,0.14433,0.181201,4710.166515,0,0
8592713,"Chêne-Bourg, Place Favre",,0.000067,132,3,6,9,146432,146431,292863,19,0.15589,0.20036,7367.963993,0,0
8592943,"Grand-Saconnex, Fret",,0.000052,132,2,3,5,45452,45451,90903,11,0.175209,0.21498,7595.560606,0,0
8592945,"Grand-Saconnex, Le Pommier",,0.00006,132,2,3,5,120655,120660,241315,15,0.153316,0.1935,2456.358652,0,0
8592908,"Genève, Sainte-Clotilde",,0.00007,132,4,3,7,104545,104776,209321,14,0.165568,0.213965,2135.037003,0,0
8592925,"Genève, Vollandes",,0.000067,132,4,4,8,121527,105004,226531,13,0.16636,0.215497,3692.521665,0,0
8592975,"Petit-Lancy, Bossons",,0.000056,132,4,3,7,78664,78708,157372,11,0.179234,0.222047,2363.579391,0,0
8592754,"Confignon, Bains de Cressy",,0.00002,132,1,1,2,18165,18211,36376,11,0.162065,0.188792,0,0,0
8592915,"Genève, Uni-Mail",,0.000097,132,6,5,11,106755,106438,213193,11,0.18171,0.238456,4668.952525,0,0
8592924,"Genève, Villereuse",,0.000064,132,4,4,8,96697,96321,193018,11,0.17132,0.217123,1365.121197,0,0
8592982,"Grand-Lancy, Curé-Baud",,0.000058,132,3,2,5,43768,43130,86898,11,0.16226,0.192496,1418.311088,0,0
8592682,"Carouge GE, Val-d'Arve",,0.000049,120,2,3,5,79832,79826,159658,20,0.14408,0.18197,1276.760952,0,0
8592776,"Genève, Gos",,0.000016,132,2,1,3,55321,55346,110667,20,0.124385,0.145966,57.546309,0,0
8592684,"Cartigny, Croix-en-Champagne",,0.000037,120,2,2,4,22109,22127,44236,21,0.115793,0.136592,1221.513886,0,0
8592686,"Cartigny, La Passe",,0.000034,120,1,1,2,16650,16650,33300,21,0.115291,0.133363,380,0,0
8592685,"Cartigny, Eaumorte croisée",,0.000027,120,1,1,2,17209,16650,33859,22,0.103617,0.117362,161,0,0
8592971,"Laconnex, Chemin de la Douane",,0.000032,120,1,1,2,17402,17404,34806,3,0.444444,0.541667,252.374725,0,0
8592688,"Chancy, Les Bouveries",,0.000037,120,2,1,3,25452,25465,50917,22,0.103062,0.116353,363.844949,0,0
8592689,"Chancy, Raclerets",,0.000043,120,1,1,2,25465,25466,50931,21,0.114599,0.131901,579.844949,0,0
8592691,"Chêne-Bougeries, C.-Florissant",,0.000036,120,3,2,5,55405,55404,110809,20,0.12756,0.153476,570.461806,0,0
8592693,"Chêne-Bougeries, Castan",,0.000028,120,2,1,3,75089,75114,150203,23,0.096189,0.10655,224.308658,0,0
8592695,"Chêne-Bougeries, Fourches",,0.000035,120,1,1,2,75114,75108,150222,22,0.106199,0.119412,585.308658,0,0
8592696,"Chêne-Bougeries, L.-Sismondi",,0.000022,120,1,1,2,12390,12260,24650,22,0.106199,0.119412,142.158766,0,0
8592703,"Chêne-Bougeries,Ch.de l'Eperon",,0.000029,120,1,1,2,75086,75082,150168,22,0.113873,0.1304,0,0,0
8592705,"Chêne-Bougeries, Coq-d'Inde",,0.000053,132,2,1,3,75107,75114,150221,21,0.12822,0.151687,1679.500253,0,0
8593109,"Thônex, Pont-Bochet",,0.00006,132,3,2,5,52027,52246,104273,10,0.176647,0.227778,1004.21134,0,0
8593110,"Thônex, Cyprès",,0.000068,132,1,1,2,16958,16958,33916,10,0.173021,0.212685,1056.804029,0,0
8592711,"Chêne-Bourg, Petit-Bel-Air",,0.000104,132,4,4,8,119744,119708,239452,20,0.14675,0.18504,4133.104604,0,0
8592748,"Cologny, Le-Fort",,0.000093,132,2,2,4,37647,37650,75297,21,0.138716,0.169113,5222.128182,0,0
8592752,"Cologny, Temple",,0.000054,132,1,1,2,18283,18283,36566,21,0.138134,0.166023,376,0,0
8592717,"Choulex, Bonvard",,0.000037,120,2,1,3,31379,31378,62757,26,0.087436,0.100584,4446.5,0,0
8592910,"Genève, Terrassière",,0.000101,132,6,8,14,174705,174363,349068,18,0.170895,0.230566,9142.998672,0,0
8592912,"Genève, Tranchées",,0.000052,132,3,4,7,48982,49347,98329,18,0.124407,0.165674,1354.892194,0,0
8593087,"Puplinge, Marquis",,0.000052,132,2,3,5,38579,38581,77160,12,0.170868,0.25356,2257.079312,0,0
8592724,"Collonge-Bellerive, Bellerive",,0.000053,120,2,1,3,43936,43935,87871,26,0.089361,0.102954,622.933333,0,0
8592720,"Collex, école",,0.000054,135,3,2,5,28340,28339,56679,17,0.094774,0.113838,8156,0,0
8592721,"Collex, La Prêle",,0.000034,135,1,1,2,14882,14565,29447,17,0.094373,0.109678,0,0,0
8592722,"Collex, Seuchat",,0.000063,135,2,2,4,28022,28340,56362,16,0.103718,0.124018,8272,0,0
8592723,"Collex, Vireloup",,0.000038,135,1,2,3,14882,14238,29120,15,0.113869,0.135604,6962,0,0
8592950,"Grand-Saconnex, Palexpo",,0.000072,132,3,3,6,71243,71047,142290,14,0.163743,0.293352,7763.507816,0,0
8592725,"Collonge-Bellerive, Bois-Caran",,0.000068,120,2,3,5,44101,44100,88201,25,0.097899,0.117082,3265.635714,0,0
8592726,"Collonge-Bellerive, La Gabiule",,0.00003,120,1,1,2,30882,30882,61764,26,0.092197,0.105675,0,0,0
8592727,"Collonge-Bellerive,Pré-d'Orsat",,0.000056,120,2,2,4,43936,43936,87872,25,0.101321,0.119783,1592.721645,0,0
8592731,"Vésenaz, Chemin des Princes",,0.000032,120,2,2,4,18281,18283,36564,24,0.104311,0.121831,3077.690043,0,0
8592728,"Collonge-Bellerive, Savonnière",,0.000035,120,1,1,2,30882,30883,61765,24,0.107143,0.123879,1497.464928,0,0
8592729,"Vésenaz, Bois-Galland",,0.000032,120,1,2,3,21480,21473,42953,23,0.115123,0.133441,1596.385402,0,0
8592734,"Vésenaz, La Bise",,0.000065,120,2,4,6,44103,44103,88206,23,0.119692,0.145319,4859.796852,0,0
8592736,"Vésenaz, Mancy",,0.000027,120,1,1,2,19585,19585,39170,23,0.114633,0.130255,466.5,0,0
8592730,"Vésenaz, Californie",,0.000021,120,1,1,2,6095,6095,12190,25,0.100097,0.11594,554.871212,0,0
8592732,"Vésenaz, Crêts-de-la-Capite",,0.000068,120,3,2,5,31376,31377,62753,24,0.107527,0.127946,3472.197734,0,0
8592738,"Vésenaz, Repentance",,0.000047,120,2,3,5,32638,32645,65283,23,0.114823,0.133846,926.036364,0,0
8592753,"Cologny, Tour-Carrée",,0.000064,120,1,2,3,49667,49667,99334,22,0.12831,0.149542,1905,0,0
8592958,"Hermance, Villars",,0.000063,132,1,1,2,43937,13054,56991,11,0.153846,0.202931,595.733333,0,0
8592735,"Vésenaz, La Dame",,0.000038,120,2,2,4,32639,32639,65278,24,0.103688,0.119868,1157.268182,0,0
8592737,"Vésenaz, Petray",,0.000047,120,2,2,4,21473,21472,42945,22,0.12914,0.151612,2230.617221,0,0
8592761,"Anières, Foyer",,0.000024,120,1,1,2,13054,13054,26108,22,0.127551,0.145849,701.5,0,0
8592741,"Cologny, Boissier",,0.000038,120,2,1,3,49652,49641,99293,27,0.078953,0.086833,722.666667,0,0
8592740,"Cologny, Bessinge",,0.000053,120,2,1,3,18282,18283,36565,23,0.10907,0.123942,3387.477041,0,0
8592742,"Cologny, Chemin du Righi",,0.000057,120,2,1,3,49666,49667,99333,26,0.085497,0.094177,1257,0,0
8592744,"Cologny, Falquets",,0.00004,132,2,1,3,19364,19364,38728,22,0.122101,0.142157,1113.651141,0,0
8592745,"Cologny, Fraidieu",,0.000056,120,1,1,2,18283,18283,36566,22,0.122101,0.142157,3560.477041,0,0
8592747,"Cologny, La Belotte",,0.000059,120,1,1,2,49667,49665,99332,25,0.093245,0.103141,1422,0,0
8592749,"Cologny, Montalègre",,0.000061,120,1,1,2,49665,49667,99332,24,0.102564,0.114376,1585,0,0
8592750,"Cologny, Rippaz",,0.00005,132,1,1,2,18286,18283,36569,22,0.121652,0.140701,211,0,0
8592751,"Cologny, Ruth",,0.000063,120,1,1,2,49667,49667,99334,23,0.113985,0.129014,1746,0,0
8592755,"Bernex, Cressy",,0.00002,132,2,1,3,37127,37162,74289,20,0.14167,0.166225,115.316587,0,0
8592756,"Confignon, Croix-de-Chavant",,0.000032,120,1,1,2,24118,24123,48241,13,0.125803,0.146474,427.439579,0,0
8592995,"Petit-Lancy, Quidort",,0.000024,132,1,2,3,58692,58689,117381,11,0.162069,0.205265,1244.482886,0,0
8593022,"Meyrin, Vaudagne",,0.00003,132,1,2,3,58466,58485,116951,5,0.346939,0.423529,623.774026,0,0
8593065,"Plan-les-Ouates, Pré-Fleuri",,0.000072,132,3,5,8,59879,58375,118254,8,0.207143,0.291605,2883.362932,0,0
8592760,"Corsier GE, Corsier-Port",,0.000052,120,2,1,3,30877,30879,61756,22,0.127421,0.145405,2624.3317,0,0
8592762,"Corsier GE, Le Soleil",,0.000079,120,3,1,4,34529,34533,69062,21,0.145809,0.172624,5447.849039,0,0
8592900,"Genève, Rue du Lac",,0.000039,132,2,3,5,99290,99099,198389,14,0.156468,0.20302,428.636149,0,0
8592864,"Genève, Mont-Blanc",,0.000085,132,5,9,14,171410,170317,341727,19,0.181556,0.242059,4627.832776,0,0
8592764,"Anières, Nant-d'Aisy",,0.000055,120,1,1,2,30879,30883,61762,21,0.145639,0.171822,2777.3317,0,0
8592767,"Dardagny, La Donzelle",,0.000049,120,3,1,4,14295,14614,28909,16,0.09062,0.126822,228.666667,0,0
8592768,"La Plaine, école",,0.000052,120,1,1,2,14614,14614,29228,15,0.097902,0.138269,263.666667,0,0
8592769,"Dardagny, Le Moulin",,0.000055,120,1,2,3,14614,14275,28889,14,0.106589,0.15928,296.666667,0,0
8592770,"Dardagny, Les Tilleuls",,0.000034,120,1,2,3,13964,12267,26231,13,0.116379,0.168544,277.333333,0,0
8592848,"Genève, Lombard",,0.000034,132,2,1,3,23667,18971,42638,20,0.138298,0.161804,18.172617,0,0
8592822,"Genève, Epinettes",,0.000023,132,1,2,3,46880,46804,93684,21,0.14527,0.177374,154.988279,0,0
8592825,"Genève, Maison de la Paix",,0.000037,132,2,5,7,48759,48784,97543,20,0.15625,0.200954,466.730268,0,0
8592831,"Genève, Goulart",,0.000061,132,4,4,8,44359,44333,88692,20,0.157581,0.200912,719.810682,0,0
8592833,"Genève, Grange-Canal",,0.000031,132,2,3,5,96679,96687,193366,20,0.167732,0.214585,360.225366,0,0
8592890,"Genève, Prairie",,0.000079,132,6,5,11,154135,154372,308507,18,0.174669,0.231169,11734.335868,0,0
8592921,"Genève, Vidollet",,0.000081,132,3,5,8,100472,99864,200336,17,0.140751,0.188299,1356.835126,0,0
8592927,"Genève, Weber",,0.000053,132,3,3,6,84136,84155,168291,17,0.138594,0.177484,1667.247862,0,0
8592934,"Genthod, Vieux-Valavran",,0.000057,132,2,1,3,27407,13668,41075,17,0.135979,0.163826,7583,0,0
8592829,"Genève-Eaux-Vives, gare",,0.000052,132,6,3,9,143388,143458,286846,20,0.167317,0.213143,3383.193886,0,0
8592840,"Genève, Intercontinental",,0.000061,132,3,4,7,71637,71648,143285,18,0.152622,0.191744,2862.534192,0,0
8592885,"Genève, Place de Neuve",,0.000123,132,9,7,16,258832,254777,513609,18,0.169654,0.225678,5428.951485,0,0
8592847,"Genève, La Fenêtre",,0.000033,132,2,2,4,25889,25850,51739,16,0.152815,0.187521,4315.562443,0,0
8592860,"Genève, Miremont",,0.00005,132,3,3,6,55327,55344,110671,19,0.167624,0.212905,1160.799468,0,0
8592870,"Genève, Muséum",,0.000084,132,4,6,10,128310,129114,257424,18,0.168952,0.220923,3278.986809,0,0
8592878,"Genève-Champel, gare/Peschier",,0.000064,132,4,4,8,68954,68940,137894,19,0.151966,0.194462,832.174358,0,0
8592879,"Genève, Petit-Palais",,0.000022,132,1,1,2,11065,11065,22130,19,0.145482,0.176235,0,0,0
8592880,"Genève, Petit-Saconnex",,0.000046,132,2,3,5,83676,83681,167357,19,0.147211,0.185027,277.794641,0,0
8592842,"Carouge GE, Pictet-Thellusson",,0.000048,132,2,6,8,80353,80362,160715,20,0.17603,0.232154,1375.457507,0,0
8592863,"Genève, Môle",,0.000061,132,5,3,8,48780,48775,97555,20,0.143543,0.181635,655.160583,0,0
8592809,"Genève, Collège Rousseau",,0.00002,132,1,2,3,46540,46541,93081,20,0.142371,0.174051,496.642238,0,0
8592818,"Genève, Dôle",,0.000044,132,3,2,5,118483,118587,237070,20,0.153811,0.189636,896.288582,0,0
8592830,"Genève, Gautier",,0.000085,132,5,3,8,78373,78371,156744,20,0.151915,0.192901,632.87029,0,0
8592832,"Genève, Grand-Pré",,0.00006,132,4,2,6,102925,102905,205830,20,0.152025,0.191966,220.512742,0,0
8592841,"Genève, Mercier",,0.000084,132,5,6,11,76731,76717,153448,20,0.160587,0.210126,995.151088,0,0
8592792,"Genève, Bourg-de-Four",,0.000013,120,1,1,2,11065,11064,22129,24,0.099234,0.110681,336,0,0
8592816,"Genève, Délices",,0.000058,132,3,4,7,116191,116189,232380,20,0.146218,0.185221,884.064138,0,0
8592819,"Genève, Ecole-de-Médecine",,0.000049,132,4,2,6,45397,45399,90796,20,0.138289,0.168443,184.336029,0,0
8592823,"Genève, Florence",,0.000058,132,3,4,7,84005,84162,168167,20,0.149677,0.191995,1518.090241,0,0
8592824,"Genève, Florissant",,0.000038,132,3,4,7,72209,72205,144414,20,0.1388,0.173241,167.199036,0,0
8592799,"Genève, Cathédrale",,0.000022,120,1,1,2,11064,11065,22129,23,0.109827,0.123609,575,0,0
8592811,"Genève, Contrat-Social",,0.000057,132,4,2,6,69335,69326,138661,21,0.135798,0.165552,479.573018,0,0
8592813,"Genève, Crêts-de-Champel",,0.000051,132,3,4,7,102091,102096,204187,20,0.152003,0.193559,619.434292,0,0
8592838,"Genève, Hôtel-de-Ville",,0.000042,120,1,1,2,11065,11065,22130,20,0.162025,0.20117,1280,0,0
8592856,"Genève, Métropole",,0.000156,132,11,7,18,218932,220727,439659,20,0.167792,0.223385,11603.399115,0,0
8592858,"Genève, Miléant",,0.000102,132,6,4,10,92814,92893,185707,20,0.167627,0.217686,1036.683307,0,0
8592898,"Genève-Champel, gare/Hôpital",,0.000075,132,4,3,7,59017,57885,116902,15,0.151994,0.198242,1503.068419,0,0
8592944,"Grand-Saconnex, Gardiol",,0.000035,132,1,2,3,56023,53917,109940,2,0.75,0.833333,28.5,0,0
8593043,"Onex, Duret",,0.000054,132,1,1,2,37151,33729,70880,2,0.666667,0.75,50.983333,0,0
8593165,"Vernier, Balexert-Pailly",,0.000064,132,2,4,6,65657,65652,131309,7,0.25641,0.353095,1423.016857,0,0
8595018,"Genève, Concorde",,0.000089,132,2,1,3,69347,1394,70741,2,0.666667,0.75,11.333333,0,0
8595020,"Genève, Les Ouches",,0.000092,132,3,1,4,127592,44207,171799,2,0.666667,0.75,171.083333,0,0
8592806,"Genève, Clinique Générale",,0.000023,132,1,1,2,46737,46749,93486,21,0.132275,0.157388,36.990301,0,0
8592845,"Genève, Joli-Mont",,0.000035,132,3,2,5,19493,19490,38983,18,0.121452,0.15,1595.567506,0,0
8592852,"Genève, Maison des Parlements",,0.000033,132,2,3,5,83659,83655,167314,20,0.149977,0.185484,353.172475,0,0
8592834,"Genève, Grottes",,0.000039,132,3,2,5,55390,55405,110795,19,0.134513,0.161227,194.484635,0,0
8592837,"Genève, Hôpital",,0.000117,132,8,5,13,143638,143636,287274,19,0.158848,0.205828,2340.575165,0,0
8592839,"Genève, Industrielle",,0.00006,132,6,2,8,80339,80365,160704,21,0.15336,0.190261,883.909246,0,0
8592820,"Genève, Eglise Russe",,0.00003,120,1,1,2,11065,11064,22129,22,0.122995,0.140682,812,0,0
8592828,"Genève, Liszt",,0.000036,120,1,1,2,11064,11065,22129,21,0.139808,0.164538,1047,0,0
8592868,"Genève, Musée d'ethnographie",,0.000046,132,5,3,8,78330,78335,156665,19,0.165081,0.203667,2165.40127,0,0
8592869,"Genève, Musée Voltaire",,0.000033,132,1,2,3,35784,35780,71564,19,0.167045,0.206296,533.886325,0,0
8592866,"Genève, Monthoux",,0.000071,132,4,2,6,78349,78373,156722,19,0.154423,0.188794,949.471473,0,0
8592867,"Genève, Motta",,0.000103,132,6,4,10,102257,101086,203343,19,0.154459,0.195648,3269.745209,0,0
8592891,"Genève, Queue-d'Arve",,0.000047,132,2,3,5,82100,82095,164195,18,0.15237,0.191241,3238.790096,0,0
8592902,"Genève, Perle du Lac",,0.000062,132,4,3,7,78371,78064,156435,18,0.156118,0.197117,812.18259,0,0
8592903,"Genève, Servette",,0.000136,132,3,5,8,191624,191594,383218,18,0.163164,0.211633,2342.166437,0,0
8592905,"Genève, Collège Sismondi",,0.000064,132,3,2,5,48775,47891,96666,20,0.151373,0.191488,842.131334,0,0
8592887,"Genève, Pont-d'Arve",,0.00009,132,7,6,13,110261,108464,218725,19,0.155093,0.206648,3755.876736,0,0
8592906,"Genève, Stand",,0.000099,132,5,4,9,181339,180808,362147,19,0.163085,0.212418,3229.983741,0,0
8592846,"Genève, Krieg",,0.000057,132,4,1,5,55401,55399,110800,21,0.132168,0.155742,181.546899,0,0
8592853,"Genève, Maternité-Pédiatrie",,0.000043,132,2,3,5,26835,26639,53474,21,0.145899,0.182037,422.187343,0,0
8592865,"Genève-Eaux-Vives, gare/Bloch",,0.000078,132,4,3,7,112731,112753,225484,19,0.159979,0.19814,3098.005383,0,0
8592893,"Genève, Riant-Parc",,0.000026,132,1,2,3,18858,18859,37717,18,0.137731,0.194932,126.641769,0,0
8592917,"Genève, Varembé",,0.000057,132,3,3,6,95226,95231,190457,16,0.131026,0.169372,2724.15425,0,0
8592935,"Grand-Saconnex, Arena-Halle 7",,0.0001,132,5,5,10,116460,116538,232998,16,0.156627,0.20495,17727.317023,0,0
8592938,"Grand-Saconnex, CS Blanché",,0.000043,132,2,2,4,43505,43391,86896,16,0.114481,0.151724,650.964652,0,0
8592942,"Grand-Saconnex, Ferme Sarasin",,0.000049,132,1,2,3,21063,21067,42130,16,0.135135,0.172366,321.672727,0,0
8592874,"Genève, Palladium",,0.000034,132,3,2,5,93861,93874,187735,19,0.133824,0.162678,3149.438265,0,0
8592886,"Genève-Champel, gare",,0.000052,132,3,3,6,68340,67375,135715,20,0.141304,0.175851,778.056897,0,0
8592855,"Genève, Mervelet",,0.000053,132,4,3,7,55171,55184,110355,19,0.132784,0.169635,2244.556324,0,0
8592871,"Genève, Navigation",,0.000053,132,2,5,7,78375,78373,156748,18,0.173153,0.220949,883.953566,0,0
8592876,"Genève, parc plage Eaux-Vives",,0.000062,132,4,1,5,74954,74977,149931,19,0.153766,0.185321,589.837016,0,0
8592873,"Genève, Ormeaux",,0.000044,132,2,2,4,33536,33557,67093,16,0.136608,0.175971,659.110717,0,0
8593021,"Genève-Aéroport, Tour-Contrôle",,0.000064,132,4,5,9,113622,113506,227128,9,0.269076,0.34583,4723.947004,0,0
8592861,"Genève, Moillebeau",,0.00005,132,3,2,5,83685,83681,167366,20,0.133117,0.162521,588.703986,0,0
8592892,"Genève, Reverdin",,0.000023,132,1,1,2,13151,13222,26373,16,0.132507,0.161357,33.791378,0,0
8592894,"Genève, Rieu",,0.000073,132,5,5,10,130911,129106,260017,17,0.160597,0.208999,3099.32575,0,0
8592904,"Genève, Seujet",,0.000034,132,1,1,2,46875,46884,93759,19,0.111863,0.135393,196.821537,0,0
8592888,"Genève, poste",,0.000047,132,3,3,6,118569,118720,237289,17,0.144302,0.179534,2325.698746,0,0
8592914,"Genève, UIT",,0.000085,132,4,3,7,102236,101896,204132,18,0.125366,0.161563,1931.283837,0,0
8592881,"Genève, Philosophes",,0.00002,132,1,1,2,20180,20180,40360,19,0.135487,0.160659,0,0,0
8593131,"Vandoeuvres, La Blanche",,0.000086,132,2,2,4,32378,32378,64756,9,0.198675,0.276918,521.771429,0,0
8592909,"Genève, Taconnerie",,0.000033,132,1,1,2,11065,11065,22130,1,1,1,1,0,0
8593124,"Thônex, Vallard",,0.000057,132,3,1,4,84183,45135,129318,1,1,1,135.639261,0,0
8592916,"Genève, Valais",,0.000024,132,1,1,2,73388,72389,145777,17,0.11633,0.14084,0,0,0
8592889,"Genève, Poterie",,0.000121,132,8,2,10,144733,144732,289465,19,0.141189,0.171906,2197.513427,0,0
8592895,"Genève-Sécheron, gare",,0.00005,132,3,2,5,72727,74542,147269,18,0.144572,0.175295,618.44392,0,0
8592899,"Grand-Saconnex, Giacometti",,0.000062,132,1,1,2,28179,28181,56360,19,0.140733,0.168781,0,0,0
8593138,"Vernier, Avenue de l'Ain",,0.000107,132,7,4,11,82366,82316,164682,6,0.279762,0.355319,6208.418022,0,0
8593038,"Onex, marché",,0.000102,132,4,2,6,107249,75773,183022,7,0.248677,0.305167,1014.15323,0,0
8592907,"Genève, Saint-Antoine",,0.000026,132,1,1,2,7556,11065,18621,2,0.666667,0.75,341,0,0
8593107,"Thônex, Belle-Idée-Centre",,0.000065,132,4,2,6,51884,52046,103930,11,0.169972,0.221813,1173.828233,0,0
8592911,"Genève, Tourelle",,0.000055,132,2,1,3,83662,83678,167340,17,0.120106,0.141935,1041.522331,0,0
8592913,"Genève, Trembley",,0.000058,132,1,2,3,83678,83675,167353,16,0.135747,0.167952,865.522331,0,0
8592940,"Grand-Saconnex, Crêts-Morillon",,0.000085,132,5,3,8,117829,118899,236728,16,0.140326,0.177339,5846.112512,0,0
8592918,"Genève, Velours",,0.000058,132,3,4,7,55031,55405,110436,17,0.129527,0.170615,3333.17404,0,0
8592919,"Genève, Vermont",,0.00004,132,2,1,3,45330,45086,90416,18,0.123899,0.152012,264.149741,0,0
8593070,"Plan-les-Ouates, Trèfle-Blanc",,0.000081,132,4,2,6,30154,27945,58099,7,0.247191,0.333766,1601.034314,0,0
8593111,"Thônex, Fossard",,0.000103,132,3,3,6,30533,30533,61066,9,0.205674,0.271476,3136.973562,0,0
8593201,"Veyrier, La Salésienne",,0.00017,133,3,4,7,57343,62056,119399,5,0.395349,0.516667,4526.644526,0,0
8592920,"Genève, Vernets",,0.000035,132,1,1,2,46884,46889,93773,1,1,1,364,0,0
8593026,"Meyrin, village",,0.000074,132,2,4,6,61432,48982,110414,9,0.2,0.268365,654.92102,0,0
8593118,"Thônex, Moillesulaz",,0.000069,132,2,1,3,96195,397,96592,7,0.224138,0.296886,496.5,0,0
8592923,"Genève, Village-Suisse",,0.000027,132,1,2,3,26460,26458,52918,1,1,1,736,0,0
8595999,"Genève, Clinique La Colline",,0.000023,132,1,1,2,13219,13222,26441,1,1,1,0,0,0
8592976,"Petit-Lancy, De-Ternier",,0.00007,132,4,3,7,107357,107366,214723,11,0.174123,0.211869,4601.952145,0,0
8592952,"Grand-Saconnex, Taverney",,0.000052,132,1,1,2,21060,21066,42126,11,0.179431,0.208348,665.840951,0,0
8592986,"Petit-Lancy, Lancy-Hubert",,0.000039,132,2,2,4,43565,43563,87128,11,0.185501,0.224535,2450.06308,0,0
8592993,"Petit-Lancy, Pré-Monnard",,0.000043,132,2,5,7,50481,50485,100966,10,0.23614,0.295825,1952.404939,0,0
8593014,"Genève-Aéroport, ICC",,0.00008,132,2,4,6,98523,98514,197037,10,0.246106,0.315094,5122.816584,0,0
8593019,"Meyrin, Sainte-Cécile",,0.00003,132,1,1,2,21014,21018,42032,10,0.214511,0.253356,134.52684,0,0
8592930,"Genthod, Chênaie",,0.000027,132,1,1,2,13375,13678,27053,18,0.120206,0.139995,6994,0,0
8592933,"Genthod, Malagny",,0.000027,132,1,1,2,13729,13729,27458,18,0.120206,0.139995,356,0,0
8592932,"Genthod, La Pralay",,0.000019,132,1,1,2,13729,13729,27458,19,0.107763,0.12351,293,0,0
8592936,"Grand-Saconnex, Attenville",,0.000037,132,2,2,4,21065,21066,42131,17,0.111954,0.144526,743.117022,0,0
8592937,"Grand-Saconnex,Palexpo-Halle 7",,0.000028,132,1,1,2,45428,45427,90855,12,0.149949,0.173885,0,0,0
8592939,"Grand-Saconnex, Corbillettes",,0.000045,132,2,1,3,21070,21063,42133,17,0.119959,0.1461,623.672727,0,0
8592947,"Grand-Saconnex, mairie",,0.000038,132,1,2,3,38045,38046,76091,15,0.137136,0.173831,967.168224,0,0
8592951,"Grand-Saconnex, Susette",,0.000035,132,1,1,2,47672,47674,95346,1,1,1,9.018056,0,0
8592946,"Grand-Saconnex, Machéry",,0.000097,132,5,3,8,69568,69991,139559,15,0.126106,0.169292,10879.797589,0,0
8592948,"Grand-Saconnex, Massettes",,0.000048,132,2,1,3,21073,21060,42133,12,0.153704,0.176846,1004.840951,0,0
8592949,"Grand-Saconnex, P+R P47",,0.000028,132,1,1,2,47674,47672,95346,2,0.666667,0.75,426.018056,0,0
8592955,"Gy, La Chêna",,0.00006,132,3,2,5,18365,18365,36730,6,0.314286,0.445455,3451.45,0,0
8592956,"Gy, poste",,0.000036,132,1,2,3,9972,9972,19944,6,0.30303,0.44,339,0,0
8592970,"Jussy, Sionnet",,0.000088,132,2,3,5,23056,23058,46114,13,0.131833,0.188166,1629.254029,0,0
8592957,"Hermance, Triaz",,0.000061,132,4,1,5,43934,43937,87871,12,0.136719,0.181704,914.733333,0,0
8592959,"Jussy, Bellebouche",,0.000017,132,1,1,2,12679,12938,25617,19,0.080915,0.106366,111,0,0
8592963,"Jussy, La Forge",,0.000058,132,1,1,2,16963,16963,33926,16,0.103009,0.141744,267,0,0
8592964,"Jussy, La Loure",,0.000076,132,2,3,5,23058,23058,46116,15,0.113548,0.171793,1523.377015,0,0
8592962,"Jussy, château",,0.000055,132,3,1,4,16842,16963,33805,17,0.09434,0.125611,390,0,0
8592965,"Jussy, L'Abbaye",,0.000048,132,2,2,4,23822,23822,47644,15,0.111695,0.15914,1884.996062,0,0
8592967,"Jussy, Peupliers",,0.000038,132,1,1,2,12938,12938,25876,15,0.107459,0.140526,85,0,0
8593007,"Meinier, route de Presinge",,0.000036,132,1,1,2,426,426,852,19,0.081422,0.108831,50,0,0
8592966,"Jussy, Monniaz-Hameau",,0.000032,132,1,1,2,12938,12938,25876,16,0.098062,0.126126,215,0,0
8592968,"Jussy, place",,0.000086,132,3,2,5,23058,23056,46114,14,0.11898,0.16464,1901.254029,0,0
8592969,"Jussy, Route de Lullier",,0.000047,132,1,1,2,426,426,852,14,0.11773,0.154576,0,0,0
8592972,"Laconnex, Mollaz",,0.000061,120,2,1,3,22320,22322,44642,2,0.6,0.666667,495,0,0
8592973,"Laconnex, stand de tir",,0.000063,120,1,2,3,22322,22322,44644,1,1,1,332,0,0
8595044,"Soral, village",,0.000038,120,1,1,2,22162,16542,38704,1,1,1,0,0,0
8592979,"Petit-Lancy, Cimetière St-G.",,0.000039,132,2,1,3,78302,78322,156624,15,0.11174,0.138407,433.803896,0,0
8592980,"Petit-Lancy, Claire-Vue",,0.000052,132,2,1,3,78347,78339,156686,14,0.124204,0.155144,3155.49936,0,0
8592997,"Petit-Lancy, Les Marbriers",,0.000055,132,1,2,3,78339,78351,156690,13,0.14,0.182454,2802.49936,0,0
8592998,"Grand-Lancy, Voirets",,0.000057,132,3,4,7,43719,43102,86821,8,0.240964,0.30183,9905.597187,0,0
8593051,"Plan-les-Ouates, Au Contour",,0.000076,132,2,4,6,52669,52818,105487,10,0.16895,0.242224,934.056504,0,0
8593069,"Plan-les-Ouates, Tourbillon",,0.000023,132,1,3,4,31461,31469,62930,7,0.237885,0.303924,390.214852,0,0
8593073,"Plan-les-Ouates, ZIPLO",,0.000061,132,4,3,7,36908,37358,74266,7,0.231818,0.295658,2394.972243,0,0
8593008,"Meyrin, Champs-Fréchets",,0.000015,132,1,1,2,21016,21017,42033,11,0.156928,0.183633,296.289192,0,0
8593028,"Onex, Belle-Cour",,0.000035,120,1,1,2,19394,19389,38783,13,0.125,0.151059,951.250956,0,0
8593056,"Plan-les-Ouates, Ch.-d.-Filles",,0.000082,132,3,4,7,58437,58160,116597,9,0.191489,0.268138,3176.921912,0,0
8593059,"Plan-les-Ouates, Galaise",,0.000066,132,3,2,5,51783,52819,104602,9,0.176812,0.229879,541.584511,0,0
8592999,"Meinier, Compois",,0.000026,132,1,1,2,204,204,408,5,0.333333,0.420833,2.5,0,0
8593001,"Meinier, église",,0.000077,132,3,2,5,24256,23445,47701,5,0.347826,0.483333,2821.5,0,0
8593002,"Meinier, Merlinge",,0.000066,132,2,2,4,17554,18365,35919,4,0.4375,0.559524,1070,0,0
8593003,"Meinier, Murailles",,0.000071,132,2,1,3,6299,6299,12598,4,0.4,0.486111,1061,0,0
8593004,"Meinier, Pralys",,0.0001,132,2,2,4,24460,23648,48108,3,0.555556,0.666667,1785,0,0
8593005,"Meinier, Route de Compois",,0.000053,132,1,1,2,6299,6299,12598,3,0.5,0.583333,0,0,0
8593006,"Meinier, Route de Corsinge",,0.000098,132,2,2,4,23648,14112,37760,2,0.75,0.833333,1077,0,0
8593013,"Meyrin, Hôpital de La Tour",,0.00011,132,6,4,10,78725,78744,157469,9,0.235988,0.29938,7749.153616,0,0
8593015,"Meyrin, Jardin-Alpin-Vivarium",,0.000066,132,3,3,6,107499,107466,214965,9,0.210674,0.262704,1683.399784,0,0
8593023,"Meyrin, Vernes",,0.000022,132,1,1,2,21013,20993,42006,10,0.177711,0.2204,0,0,0
8593018,"Meyrin, Maisonnex",,0.000053,132,2,1,3,40405,40415,80820,10,0.169096,0.208573,459.652281,0,0
8593025,"Meyrin, Veyrot",,0.000064,132,3,3,6,38305,38330,76635,9,0.212454,0.285721,4071.848221,0,0
8593155,"Vernier, gare/Croisette",,0.00008,132,2,4,6,124719,124741,249460,7,0.293103,0.388025,1919.846493,0,0
8593141,"Vernier, Balexert",,0.000167,132,1,2,3,88692,80600,169292,5,0.333333,0.434848,1332.664615,0,0
8593180,"Vernier, ZIMOGA",,0.000037,132,1,1,2,21011,21009,42020,5,0.3125,0.378333,154.899351,0,0
8594946,"Meyrin, Mategnin",,0.000011,132,0,1,1,0,10571,10571,5,0.3125,0.378333,0,0,0
8593169,"Vernier, gare/Renfile",,0.00011,132,5,3,8,70101,70107,140208,5,0.37037,0.46,3511.985344,0,0
8594961,"Meyrin, Gravière",,0.000135,132,4,1,5,90066,21017,111083,4,0.409091,0.472222,774.499933,0,0
8593029,"Onex, La Traille",,0.000064,132,2,1,3,56546,56554,113100,12,0.140927,0.171364,3305.750316,0,0
8593030,"Onex, cité",,0.000051,132,2,1,3,70213,70221,140434,9,0.173611,0.207484,1886.402914,0,0
8593031,"Onex, Vallet",,0.000065,132,1,2,3,56554,56554,113108,11,0.161798,0.204889,2931.750316,0,0
8593032,"Onex, Bois Carrien",,0.000054,132,1,2,3,70221,70217,140438,8,0.205882,0.253912,1502.402914,0,0
8593033,"Onex, Galeries du Loup",,0.000039,132,1,2,3,37160,37034,74194,8,0.205882,0.253912,655.750316,0,0
8593035,"Onex, Gros-Chêne",,0.000027,132,1,1,2,37009,37008,74017,8,0.202532,0.238368,0,0,0
8593037,"Onex, Maison Onésienne",,0.000034,132,1,1,2,35261,35260,70521,8,0.202532,0.238368,0,0,0
8593034,"Onex, Genévrière",,0.000039,132,1,1,2,19394,19388,38782,15,0.093575,0.121943,1452,0,0
8593039,"Onex, Montesquiou",,0.000044,132,1,1,2,19388,19389,38777,14,0.101695,0.131266,1070,0,0
8593042,"Onex, Rochette",,0.000048,132,1,1,2,19389,19390,38779,13,0.111492,0.143533,686,0,0
8593044,"Certoux, Foulon",,0.000023,132,1,1,2,17619,17621,35240,14,0.105756,0.133078,949.268398,0,0
8593045,"Certoux, village",,0.00003,132,1,1,2,17621,17621,35242,13,0.116766,0.148141,584.268398,0,0
8593046,"Perly, douane",,0.000032,132,1,1,2,35208,35208,70416,13,0.116766,0.148141,1755.788105,0,0
8593047,"Perly, En Louche",,0.000064,132,2,2,4,52829,52678,105507,12,0.130508,0.172495,2050.056504,0,0
8593048,"Perly, mairie",,0.000038,132,1,1,2,17470,17473,34943,11,0.146199,0.189113,616.528252,0,0
8593050,"Plan-les-Ouates, Arare",,0.000038,132,1,1,2,35208,35196,70404,11,0.146199,0.189113,616.528252,0,0
8593054,"Plan-les-Ouates, Centenaire",,0.000046,132,3,1,4,40488,39697,80185,10,0.162584,0.205719,2452.412012,0,0
8593055,"Plan-les-Ouates, Roday",,0.000056,120,2,3,5,39285,39284,78569,10,0.168203,0.240194,2846.239407,0,0
8593052,"Plan-les-Ouates, Badosse",,0.000036,132,1,1,2,11545,11546,23091,11,0.144,0.184591,875.424042,0,0
8593057,"Plan-les-Ouates, Comm.-Réunies",,0.000075,132,3,3,6,65170,65368,130538,10,0.165888,0.231332,2765.164904,0,0
8593053,"Plan-les-Ouates, Bellins",,0.000052,132,1,1,2,19390,19394,38784,12,0.123552,0.161012,300,0,0
8593060,"Plan-les-Ouates, La Chapelle",,0.000092,132,3,2,5,39658,39662,79320,11,0.138767,0.19112,883.7,0,0
8593061,"Plan-les-Ouates, Les Bruyères",,0.000068,132,3,3,6,44346,44827,89173,8,0.206294,0.272538,5020.986965,0,0
8593064,"Plan-les-Ouates, Aviateurs",,0.000057,132,2,2,4,53841,53824,107665,9,0.176647,0.237672,478.42619,0,0
8593062,"Plan-les-Ouates, Moulins-Drize",,0.000066,132,2,3,5,39285,39285,78570,10,0.15601,0.220349,1324.565807,0,0
8593071,"Plan-les-Ouates, Vélodrome",,0.000054,132,3,4,7,53831,53827,107658,8,0.196296,0.265656,641.633333,0,0
8595014,"Bernex, Maison du Terroir",,0.000039,120,2,2,4,24051,24123,48174,1,1,1,532.811007,0,0
8593199,"Carouge GE, Baumgartner",,0.00003,132,1,1,2,19018,19018,38036,2,0.666667,0.75,0,0,0
8595013,"Landecy, La Mûre",,0.00004,132,2,1,3,16687,16688,33375,2,0.666667,0.75,0,0,0
8593063,"Plan-les-Ouates, Nant-Malet",,0.000032,132,1,1,2,11539,11539,23078,4,0.4,0.520833,1860,0,0
8593067,"Plan-les-Ouates, Saconnex-Arve",,0.000038,132,1,1,2,11539,11545,23084,3,0.5,0.611111,1398,0,0
8593072,"Plan-les-Ouates, Vuattes",,0.000043,132,1,1,2,11545,11539,23084,2,0.666667,0.75,934,0,0
8593074,"Chambésy, Caron",,0.000059,132,2,1,3,38041,38042,76083,4,0.4,0.520833,1704,0,0
8593075,"Chambésy, Foretaille",,0.000061,132,1,1,2,38042,25849,63891,3,0.5,0.611111,1281,0,0
8593076,"Chambésy, place",,0.000063,132,1,1,2,25849,25848,51697,2,0.666667,0.75,856,0,0
8593077,"Pregny, mairie",,0.000064,132,1,1,2,25848,25849,51697,1,1,1,429,0,0
8593079,"Presinge, Cara-Douane",,0.000062,132,2,1,3,17727,17727,35454,18,0.087391,0.115198,1046.119048,0,0
8593080,"Presinge, Bornes",,0.000063,132,1,1,2,17727,17727,35454,17,0.094391,0.12296,893.119048,0,0
8593081,"Presinge, Grand-Cara",,0.000065,132,1,1,2,17727,17727,35454,16,0.102719,0.132693,738.119048,0,0
8593082,"Puplinge, Aumônes",,0.000066,132,1,1,2,17727,17727,35454,15,0.112795,0.145372,581.119048,0,0
8593084,"Puplinge, Frémis",,0.000036,132,1,1,2,16537,16533,33070,12,0.132035,0.160333,835.704029,0,0
8593085,"Puplinge, Grésy",,0.000097,132,3,1,4,37149,37095,74244,13,0.140998,0.189338,1266.005959,0,0
8593114,"Thônex, Jumelles",,0.000051,132,1,1,2,38838,19162,58000,4,0.384615,0.483333,134.305556,0,0
8593116,"Thônex, Tronchet",,0.000088,132,3,2,5,34307,30131,64438,4,0.428571,0.569444,1978.541216,0,0
8593117,"Thônex, mairie",,0.000048,132,1,1,2,12820,16958,29778,4,0.384615,0.483333,0,0,0
8593123,"Thônex, Sous-Vilette",,0.00008,132,2,2,4,13574,13574,27148,7,0.253846,0.320274,2608.721489,0,0
8593128,"Vandoeuvres, Cocuaz",,0.000078,132,2,1,3,13220,13220,26440,10,0.176471,0.23658,827.734848,0,0
8593088,"Russin, La Chaumaz",,0.000042,120,2,1,3,11275,11289,22564,11,0.142077,0.181053,507,0,0
8593090,"Russin, Noirettes",,0.000069,120,3,1,4,12578,11072,23650,2,0.666667,0.75,33.333333,0,0
8593102,"Satigny, poste",,0.000104,132,4,3,7,26140,16344,42484,9,0.186312,0.252519,2394.563626,0,0
8593091,"Satigny, Bois-de-Bay",,0.000041,132,2,1,3,11918,16666,28584,11,0.140957,0.17748,2899.1,0,0
8593092,"Satigny, Bourdigny-Douane",,0.000024,132,1,1,2,6072,6072,12144,14,0.10325,0.134011,368,0,0
8593093,"Satigny, Camping Bois-de-Bay",,0.000046,132,1,2,3,16666,16665,33331,10,0.160991,0.210958,2574.1,0,0
8593098,"Vernier, Moulières",,0.00003,132,1,1,2,7372,7372,14744,10,0.158385,0.195487,0,0,0
8593094,"Satigny, Chemin du Paradis",,0.000031,132,1,1,2,6072,6072,12144,13,0.113006,0.144051,329,0,0
8593095,"Satigny, Crédery",,0.000037,132,1,1,2,6072,6072,12144,12,0.125,0.157039,288,0,0
8593096,"Satigny, Les Maladières",,0.000045,132,2,1,3,26383,26410,52793,8,0.215,0.249474,674.639224,0,0
8593097,"Satigny, Maison-Rouge",,0.000043,132,1,1,2,6072,6072,12144,11,0.14011,0.174799,245,0,0
8593099,"Satigny, Pré-de-la-Fontaine",,0.000049,132,1,2,3,26410,26409,52819,7,0.267516,0.320068,247.639224,0,0
8593144,"Vernier, Bois-des-Frères",,0.000161,132,7,6,13,150895,151053,301948,6,0.304054,0.394815,9080.71783,0,0
8593146,"Vernier, Bouleaux",,0.000089,132,2,2,4,37738,37739,75477,7,0.241573,0.295404,1952.41668,0,0
8593156,"Vernier, Delay",,0.000049,132,2,2,4,28386,28386,56772,5,0.333333,0.397826,662.835383,0,0
8593161,"Vernier, De-Sauvage",,0.000051,132,2,3,5,105226,105270,210496,5,0.328125,0.415873,1297.100915,0,0
8593168,"Vernier, Progrès",,0.000073,132,3,3,6,37738,37739,75477,5,0.37931,0.463636,1198.436159,0,0
8593103,"Satigny, temple",,0.00004,132,1,1,2,4210,6072,10282,4,0.4,0.520833,457.919048,0,0
8593104,"Satigny, Taboret",,0.000045,132,1,1,2,6072,6072,12144,3,0.5,0.611111,64.919048,0,0
8595026,"Meyrin, Maillard",,0.000175,132,3,4,7,38329,38330,76659,3,0.615385,0.729167,4786.080952,0,0
8593105,"Satigny, Terre Mousson",,0.000064,132,2,1,3,16666,16666,33332,8,0.198198,0.234253,919.64934,0,0
8593143,"Vernier, Bois-Chébé",,0.000028,132,1,1,2,21068,21072,42140,8,0.198198,0.234253,1427.76734,0,0
8593106,"Thônex, Jeandin",,0.000068,132,2,1,3,16959,16958,33917,11,0.149626,0.181132,1227.804029,0,0
8593113,"Thônex, Hôpital Trois-Chêne",,0.000093,132,3,2,5,71723,52246,123969,8,0.218579,0.277202,1408.94008,0,0
8593119,"Thônex, Mon-Idée",,0.000147,132,4,1,5,53638,34274,87912,3,0.5,0.583333,2012,0,0
8593120,"Thônex, Pierre à Bochet",,0.000136,132,1,2,3,34274,17737,52011,2,0.75,0.833333,1512,0,0
8593122,"Thônex, Sillons",,0.000069,132,1,1,2,17311,17310,34621,1,1,1,1,0,0
8593121,"Thônex, Plein-Sud",,0.000069,132,1,1,2,17311,17311,34622,2,0.666667,0.75,505,0,0
8593135,"Vandoeuvres, Mazettes",,0.000082,132,2,2,4,26627,26463,53090,7,0.255556,0.330849,2313.373713,0,0
8593198,"Vessy, Grand-Donzel",,0.00005,133,1,2,3,19873,19873,39746,6,0.306452,0.391228,115.2,0,0
8593125,"Troinex, Pont-de-Drize",,0.000032,120,1,1,2,18864,18865,37729,4,0.4,0.520833,376,0,0
8593126,"Troinex, Rivolette",,0.000038,120,1,1,2,18865,18865,37730,3,0.5,0.611111,285,0,0
8593127,"Troinex, Saussac",,0.000043,120,1,1,2,18865,18865,37730,2,0.666667,0.75,192,0,0
8593129,"Vandoeuvres, Crête",,0.000126,132,3,3,6,45786,45787,91573,9,0.207792,0.306486,2959.050325,0,0
8593130,"Vandoeuvres, De-Westerweller",,0.000047,132,1,1,2,13220,13220,26440,10,0.17033,0.224962,0,0,0
8593132,"Vandoeuvres, La Blonde",,0.000062,132,2,2,4,19364,19364,38728,9,0.193103,0.269912,2528.094816,0,0
8593133,"Vandoeuvres, Les Bougeries",,0.000073,132,2,2,4,32567,32565,65132,8,0.225,0.302601,2948.556667,0,0
8593134,"Vandoeuvres, Loveré",,0.000048,132,1,1,2,13220,13220,26440,8,0.210526,0.264038,48,0,0
8593136,"Vandoeuvres, Planta",,0.000068,132,2,1,3,19364,19158,38522,2,0.666667,0.75,814,0,0
8593148,"Vernier, Campanules",,0.000039,132,1,1,2,17311,17311,34622,8,0.226519,0.268786,41,0,0
8593150,"Vernier, Champ-Claude",,0.000092,132,3,2,5,124758,124755,249513,7,0.266234,0.324216,1744.519966,0,0
8593139,"Vernier, Avanchet",,0.000183,132,7,1,8,88664,88692,177356,6,0.266667,0.341667,1823.664615,0,0
8593147,"Vernier, CO Renard",,0.000034,132,1,1,2,17310,17311,34621,9,0.188341,0.222458,517,0,0
8593149,"Vernier, Canada",,0.000049,132,1,2,3,16666,16665,33331,6,0.292683,0.359722,943.49577,0,0
8593166,"Vernier, Parfumerie",,0.000024,132,1,1,2,21067,21073,42140,6,0.283951,0.331884,402.889596,0,0
8593177,"Vernier, village",,0.00009,132,2,4,6,120415,115620,236035,7,0.266667,0.439137,215.383295,0,0
8593178,"Vernier, Verseuse",,0.000037,132,1,1,2,17310,17311,34621,3,0.5,0.611111,10.97619,0,0
8593154,"Vernier, Lignon-Cité",,0.000121,132,5,3,8,122923,104725,227648,10,0.181347,0.278855,5378.672767,0,0
8593157,"Vernier, Ecu",,0.000045,132,1,1,2,14433,17311,31744,10,0.17,0.223331,0,0,0
8593170,"Vernier, Sellieres",,0.000044,132,2,1,3,17311,17311,34622,5,0.296296,0.383333,22,0,0
8593158,"Vernier, Floralies",,0.000039,132,2,1,3,57011,57015,114026,8,0.209459,0.263326,1664.459686,0,0
8593162,"Vernier, Libellules",,0.000047,132,1,2,3,17311,17311,34622,8,0.21831,0.29182,501.363243,0,0
8593159,"Vernier, Grand-Champ",,0.000084,132,2,2,4,71816,79235,151051,9,0.198795,0.276527,1584.363243,0,0
8595022,"Genève, Théâtre",,0.000297,132,9,1,10,91447,724,92171,1,1,1,424.75,0,0
8593167,"Vernier, Pont-Butin",,0.000047,132,1,1,2,61924,61912,123836,4,0.368421,0.452381,10,0,0
8593171,"Vernier, SIG Lignon",,0.000083,132,2,1,3,53098,53097,106195,4,0.368421,0.452381,2232.309524,0,0
8593176,"Vernier, marché",,0.000069,132,2,1,3,111110,111121,222231,8,0.220779,0.313936,330.489993,0,0
8593172,"Vernier, Sorbier",,0.000032,132,1,1,2,7372,7372,14744,9,0.189474,0.264308,22.709524,0,0
8593175,"Vernier, école",,0.000074,132,3,2,5,124758,124749,249507,7,0.257143,0.357937,2509.796525,0,0
8593173,"Vernier, Lignon-Tours",,0.000121,132,2,2,4,115009,86660,201669,3,0.5,0.611111,1696.309524,0,0
8593174,"Vernier, Usine à gaz",,0.000062,132,1,2,3,53099,53096,106195,3,0.555556,0.666667,570.97619,0,0
8593179,"Vernier, Via Monnet",,0.000061,132,2,2,4,28383,28383,56766,6,0.272727,0.383333,1208.935103,0,0
8593181,"Versoix, Lachenal",,0.000074,135,3,1,4,28043,28044,56087,13,0.151515,0.233788,8520,0,0
8593182,"Versoix, Argand",,0.000074,135,1,2,3,28044,27809,55853,12,0.169643,0.280056,8113,0,0
8593183,"Versoix, centre sportif",,0.000042,135,1,1,2,13485,13729,27214,11,0.182796,0.271337,3638,0,0
8593184,"Versoix, Colombières",,0.000042,135,1,1,2,14324,14319,28643,11,0.182796,0.271337,3638,0,0
8593185,"Versoix, Ecogia",,0.000083,135,2,2,4,28048,28053,56101,10,0.210526,0.336186,6880,0,0
8593186,"Versoix, La Scie",,0.000046,135,1,1,2,13729,13729,27458,13,0.142857,0.244626,2155,0,0
8593187,"Versoix, La Pelotière",,0.00005,135,1,1,2,13729,13728,27457,12,0.153846,0.258601,1736,0,0
8593188,"Versoix, Montfleury",,0.000053,135,1,1,2,13728,13290,27018,11,0.166667,0.274534,1315,0,0
8593189,"Pont-Céard, gare",,0.000056,135,1,1,2,13290,13049,26339,10,0.181818,0.292897,892,0,0
8593190,"Versoix, Port Choiseul",,0.000059,135,1,1,2,13049,13291,26340,9,0.2,0.31433,467,0,0
8593191,"Versoix, bourg",,0.000061,135,1,1,2,13291,13725,27016,8,0.222222,0.339732,40,0,0
8595664,"Versoix, stand de tir",,0.00005,135,1,1,2,14319,14323,28642,8,0.222222,0.339732,3456,0,0
8593192,"Veyrier, Bois-Gourmand",,0.000061,133,3,1,4,28090,28097,56187,6,0.295082,0.357407,3187.501093,0,0
8593200,"Veyrier, La Mouille",,0.000101,133,3,1,4,31443,27241,58684,6,0.295082,0.357407,1643.776767,0,0
8593193,"Veyrier, Boqueteaux",,0.000042,133,1,1,2,19871,19873,39744,8,0.203883,0.256519,309.2,0,0
8593194,"Vessy, Chemin Vert",,0.000048,120,1,1,2,18865,18865,37730,1,1,1,97,0,0
8593195,"Veyrier, Chemin des Bois",,0.000046,133,1,1,2,19873,19873,39746,7,0.243902,0.30131,213.2,0,0
8593210,"Veyrier, Pont de Sierne",,0.000099,133,2,3,5,68975,68975,137950,4,0.470588,0.614583,1109.548991,0,0
8593202,"Veyrier, Le Reposoir",,0.000047,133,1,2,3,27908,28096,56004,5,0.375,0.475,182.823737,0,0
8593203,"Veyrier, Les Quibières",,0.000097,133,4,1,5,40881,40872,81753,6,0.292683,0.366667,3119.361029,0,0
8593206,"Vessy, Muguets",,0.000054,133,1,1,2,19873,19873,39746,6,0.292683,0.366667,24,0,0
8593207,"Veyrier, Petit-Veyrier",,0.000159,133,3,2,5,61256,61263,122519,5,0.37931,0.487879,2792.211029,0,0
8593204,"Vessy, Marsillon",,0.000047,133,1,1,2,19873,19873,39746,8,0.205882,0.276956,938,0,0
8593205,"Vessy, Milière",,0.000051,133,1,1,2,19873,19873,39746,7,0.240741,0.310989,482,0,0
8593208,"Vessy, Pinchat-la-Tour",,0.000079,133,1,1,2,19873,19870,39743,4,0.4,0.520833,839.635775,0,0
8593209,"Vessy, Place Verte",,0.000078,133,1,1,2,19870,19873,39743,3,0.5,0.611111,367.635775,0,0
8593213,"Veyrier, Sierne",,0.000131,133,3,2,5,68976,34037,103013,3,0.555556,0.666667,2025.364225,0,0
8593211,"Veyrier, Rasses",,0.000075,133,2,2,4,28795,27906,56701,4,0.4375,0.559524,1856.815233,0,0
8593212,"Veyrier, village",,0.000071,133,2,1,3,27629,27819,55448,4,0.4,0.486111,0,0,0
8593214,"Vessy, Stand de Tir",,0.000133,133,2,1,3,47963,19871,67834,2,0.666667,0.75,962,0,0
8593216,"Vessy, Plateau",,0.000124,133,1,1,2,19871,9789,29660,1,1,1,482,0,0
8593250,"Horgen, Hüttenstrasse",,0.000078,63,3,1,4,3775,2657,6432,1,1,1,129,0,0
8593252,"Orpund, Byfang",,0.000068,87,2,2,4,26394,26661,53055,7,0.30303,0.459286,12830,0,0
8593253,"Orpund, Gottstatt",,0.00004,87,1,1,2,8959,8959,17918,1,1,1,1284,0,0
8593271,"Burgdorf, Grunerstrasse",,0.000152,45,2,1,3,11638,5240,16878,1,1,1,50.066667,0,0
8593269,"Oberburg, Geissrütti",,0.000108,45,1,1,2,11421,11421,22842,2,0.666667,0.75,22,0,0
8593267,"Lyssach, Bahnhof",,0.00003,45,1,1,2,4649,4509,9158,2,0.666667,0.75,83,0,0
8593268,"Oberburg, Brunnmattstrasse",,0.000114,45,3,1,4,11421,11421,22842,3,0.5,0.611111,114,0,0
8593272,"Sumiswald, Gammenthal",,0.000068,45,1,1,2,8825,8825,17650,2,0.666667,0.75,128,0,0
8593273,"Sumiswald, Griesbach",,0.000069,45,1,1,2,8825,8825,17650,1,1,1,65,0,0
8593275,"Bulle, Cimetière",,0.000039,13,1,1,2,28515,28515,57030,12,0.168498,0.220145,2331,0,0
8593276,"Bulle, Côte du Moulin",,0.000054,13,2,1,3,27600,26700,54300,12,0.165493,0.214574,285.5,0,0
8593282,"Bulle, St-Denis",,0.000085,13,3,4,7,54280,62185,116465,9,0.234568,0.339703,5696.966667,0,0
8593283,"Bulle, Pré-Vert",,0.000063,13,2,2,4,19874,27601,47475,9,0.205882,0.305518,1876.066667,0,0
8593287,"La Tour-de-Trême, Le Pra",,0.000035,13,1,1,2,25346,28753,54099,7,0.259259,0.332823,14,0,0
8593286,"La Tour-de-Trême, Le Closalet",,0.000029,13,1,1,2,41277,25346,66623,8,0.217391,0.285635,667,0,0
8593293,"Vuadens, St-Vincent",,0.000049,13,1,1,2,26700,26265,52965,1,1,1,571.333333,0,0
8593291,"Vuadens, gare",,0.000121,13,6,3,9,39792,38845,78637,7,0.276923,0.404233,6317.333333,0,0
8594243,"Rueyres-Treyfayes, chapelle",,0.000049,13,1,1,2,4283,4283,8566,7,0.232143,0.303297,13,0,0
8593292,"Vuadens, Le Dally",,0.000045,13,1,1,2,26700,26700,53400,2,0.666667,0.75,1255.333333,0,0
8595697,"Murten, Orientierungsschule",,0.000119,126,3,1,4,5458,2729,8187,2,0.666667,0.75,1210.666667,0,0
8593298,"Murten, Löwenberg Stöckli",,0.00003,126,1,1,2,31,31,62,4,0.384615,0.483333,1277.666667,0,0
8593317,"Biel/Bienne, Amthaus/Préfect.",,0.000069,87,2,1,3,23051,16318,39369,1,1,1,1250,0,0
8593335,"Biel/Bienne, Grünweg/Ch. Vert",,0.00013,87,4,3,7,105624,105741,211365,6,0.309524,0.402564,10410.5,0,0
8593356,"Biel/Bienne, Mösliacker/Pt-Mar",,0.000047,87,1,2,3,31624,31618,63242,6,0.294118,0.398889,30,0,0
8593357,"Biel/Bienne, Schüssinsel/Suze",,0.00011,87,4,2,6,105561,105742,211303,5,0.325581,0.421429,5667,0,0
8593323,"Biel/Bienne, Büttenbergstrasse",,0.000024,87,1,1,2,31132,31116,62248,8,0.201439,0.246003,1275,0,0
8593324,"Biel/Bienne, Rue Dunant",,0.000059,87,2,2,4,48443,48513,96956,4,0.454545,0.616667,6175.095238,0,0
8595606,"Biel/Bienne, Stadien/Stades",,0.00015,87,6,2,8,101326,50559,151885,1,1,1,1358.509524,0,0
8593327,"Biel/Bienne, Finkenweg/Pinsons",,0.000036,87,1,1,2,29758,29729,59487,5,0.333333,0.456667,6325,0,0
8593328,"Biel/Bienne, Forellenweg/Truit",,0.00004,87,1,2,3,17702,17702,35404,6,0.318182,0.492857,8988,0,0
8594163,"Meinisberg, Unterdorf",,0.000028,87,1,1,2,8851,8851,17702,6,0.285714,0.408333,0,0,0
8593336,"Biel/Bienne, Guido-Müller-Pl.",,0.000081,87,5,3,8,40815,40833,81648,5,0.358974,0.480952,8057.485714,0,0
8593338,"Biel/Bienne, Heideweg/Landes",,0.000037,87,1,2,3,43256,43256,86512,6,0.291667,0.375397,21,0,0
8593355,"Biel/Bienne, Bf Böz/gare Champ",,0.000095,87,4,3,7,43651,43648,87299,6,0.283333,0.404902,3308.833333,0,0
8593374,"Biel/Bienne, Spitalzentrum/CHB",,0.000069,87,2,3,5,60699,60238,120937,5,0.409091,0.568519,2546,0,0
8593380,"Biel/Bienne, Tschärisplatz/Cha",,0.000037,87,1,2,3,29550,7847,37397,5,0.368421,0.516667,7,0,0
8593339,"Biel/Bienne, Helvetiaplatz",,0.000072,87,3,3,6,61701,61684,123385,5,0.382353,0.502564,8937.014286,0,0
8593389,"Nidau, Schloss/Château",,0.000069,87,3,1,4,19592,19668,39260,5,0.333333,0.436111,0,0,0
8593337,"Biel/Bienne, Gurnigelstrasse",,0.00006,87,2,2,4,74953,74880,149833,7,0.25,0.328762,5152,0,0
8593340,"Biel/Bienne, Pavillonweg",,0.000031,87,1,1,2,29550,29549,59099,6,0.3125,0.403333,3778,0,0
8593346,"Biel/Bienne, Kloosweg/Ch. Clos",,0.000037,87,1,1,2,31150,31150,62300,6,0.3125,0.403333,10,0,0
8593341,"Biel/Bienne, Höheweg/Hte-Route",,0.000031,87,1,1,2,30949,31150,62099,7,0.255814,0.337229,1259,0,0
8593342,"Biel/Bienne, Hohlenweg/Creux",,0.000052,87,2,2,4,24446,24394,48840,3,0.545455,0.638889,7536,0,0
8593344,"Biel/Bienne, Kath. Kirche/Egl.",,0.000033,87,1,1,2,22633,22685,45318,3,0.5,0.566667,0,0,0
8593345,"Biel/Bienne, Klinik Linde/Til",,0.000061,87,2,3,5,24446,22633,47079,2,0.8,0.875,5032,0,0
8593351,"Biel/Bienne, Lienhardstrasse",,0.000028,87,1,1,2,7890,7890,15780,2,0.666667,0.75,0,0,0
8593352,"Biel/Bienne, Mahlenwald/Malv.",,0.000028,87,1,1,2,7889,7889,15778,2,0.666667,0.75,0,0,0
8593347,"Biel/Bienne, Kutterweg",,0.000037,87,1,1,2,31624,31624,63248,8,0.202381,0.267787,2578,0,0
8593349,"Biel/Bienne, Länggasse/Longue",,0.000038,87,1,1,2,38370,38370,76740,8,0.195876,0.259023,1291,0,0
8593350,"Biel/Bienne, Laubscherweg",,0.000042,87,1,1,2,31624,31624,63248,7,0.238806,0.310565,1305,0,0
8595995,"Biel/Bienne, Grenchenstrasse",,0.000038,87,1,1,2,2735,2488,5223,1,1,1,0,0,0
8593358,"Biel/Bienne, Mühlestr./Moulin",,0.000036,87,1,1,2,48455,48352,96807,3,0.444444,0.541667,3670.095238,0,0
8593362,"Biel/Bienne, Pilatusstrasse",,0.000076,87,3,1,4,22633,22685,45318,1,1,1,1261,0,0
8593365,"Biel/Bienne, Schiffländte/Déb.",,0.000042,87,1,1,2,29729,29798,59527,4,0.4,0.520833,5064,0,0
8593366,"Biel/Bienne, Schleusenweg/Eclu",,0.000058,87,1,1,2,43473,43474,86947,4,0.352941,0.444444,3984,0,0
8593368,"Biel/Bienne, Schlösslifeld/Cha",,0.00006,87,1,1,2,43474,43473,86947,3,0.454545,0.533333,2691,0,0
8593369,"Biel/Bienne, Gurzelen",,0.00009,87,3,2,5,63319,63247,126566,3,0.5,0.611111,7788,0,0
8593370,"Biel/Bienne, Schule Geyisried",,0.000049,87,1,1,2,62197,62259,124456,3,0.454545,0.533333,0,0,0
8593372,"Biel/Bienne, Schulen Linde/Til",,0.000046,87,1,1,2,29798,29773,59571,3,0.5,0.611111,3801,0,0
8593373,"Biel/Bienne, Seehofweg/Cl.-Lac",,0.00005,87,1,1,2,29773,29838,59611,2,0.666667,0.75,2536,0,0
8593376,"Biel/Bienne, Staufferstrasse",,0.000091,87,2,2,4,63309,62755,126064,2,0.666667,0.75,5200,0,0
8593382,"Biel/Bienne, Vorhölzli/Bois-Dv",,0.00005,87,1,1,2,62195,31135,93330,2,0.6,0.666667,0,0,0
8593379,"Biel/Bienne, Sydebusweg/Chaton",,0.00003,87,1,1,2,29550,29550,59100,6,0.296296,0.4,1263,0,0
8593384,"Biel/Bienne, Waldrain/Crêt-Bs",,0.000054,87,1,1,2,29838,29773,59611,1,1,1,1269,0,0
8593386,"Biel/Bienne, Zihlplatz/Thielle",,0.000092,87,2,2,4,31695,31624,63319,1,1,1,2604,0,0
8593514,Attinghausen Galliried,,0.000076,93,2,1,3,6564,6564,13128,2,0.666667,0.75,187.983333,0,0
8593525,"Langenthal, Mittelstrasse",,0.00006,88,1,1,2,13648,13648,27296,4,0.4,0.520833,300,0,0
8593526,"Langenthal, Blumenstrasse",,0.000062,88,1,1,2,13648,13648,27296,3,0.5,0.611111,228,0,0
8593527,"Langenthal, Rumimatte",,0.000064,88,1,1,2,13648,13648,27296,2,0.666667,0.75,154,0,0
8593528,"Lotzwil, Unterdorf",,0.000065,88,1,1,2,13648,6947,20595,1,1,1,78,0,0
8593536,"Liddes, Chapelle",,0.000049,104,1,1,2,1095,1095,2190,1,1,1,21,0,0
8593538,"Orsières, La Proz",,0.000093,104,2,1,3,2662,1395,4057,1,1,1,23,0,0
8593541,Nicole,,0.000048,48,1,1,2,52562,52562,105124,17,0.123397,0.157678,7205.7,0,0
8593543,"Cortaillod, Buffet d'un Tram",,0.000033,105,2,1,3,2523,3617,6140,2,0.666667,0.75,1020,0,0
8593544,"Cortaillod, Graviers",,0.000039,105,1,1,2,3617,2179,5796,1,1,1,511,0,0
8593547,Tombet,,0.000022,48,1,1,2,13626,13626,27252,16,0.148241,0.192134,723,0,0
8593549,Château,,0.000021,48,1,1,2,19568,19567,39135,14,0.111952,0.135905,2697.833333,0,0
8593550,Laténium,,0.000044,48,2,1,3,52934,52949,105883,15,0.101902,0.125337,7809.5,0,0
8593551,Port,,0.000048,48,1,1,2,52949,52948,105897,14,0.111952,0.135905,6874.5,0,0
8593552,Beaumont,,0.000029,48,1,1,2,19567,19568,39135,13,0.124361,0.149573,2032.833333,0,0
8593553,Rouges-Terres,,0.000052,48,1,1,2,52948,52949,105897,13,0.124361,0.149573,5937.5,0,0
8593555,"Marin, Village",,0.000139,48,2,1,3,75136,75112,150248,11,0.160633,0.195194,8223.833333,0,0
8593556,Marin Centre,,0.000129,48,1,2,3,75112,75125,150237,10,0.188679,0.24144,7257.833333,0,0
8593615,Sentier de la Gare,,0.000073,48,3,1,4,72420,72526,144946,12,0.171875,0.241867,3314.033333,0,0
8593558,"Neuchâtel, Serrières (bus)",,0.000035,48,3,1,4,48110,48110,96220,11,0.145329,0.184045,2163,0,0
8593560,Battieux,,0.000041,48,1,1,2,48110,48110,96220,10,0.165992,0.209737,1483,0,0
8593562,Tivoli,,0.000045,48,1,1,2,48110,48110,96220,9,0.194175,0.251429,801,0,0
8593611,Monruz,,0.000065,48,1,3,4,53321,42843,96164,7,0.268817,0.376762,1688.416667,0,0
8593570,Rosière,,0.000097,48,3,4,7,50341,50335,100676,7,0.270677,0.373942,21032.333333,0,0
8593571,Cheminée,,0.000042,48,2,1,3,24073,24074,48147,9,0.185185,0.241156,1785.033333,0,0
8593573,Av. des Alpes,,0.000035,48,1,2,3,24077,24077,48154,9,0.187166,0.260204,345.633333,0,0
8593567,Poudrières,,0.000051,48,1,1,2,52578,52582,105160,20,0.082192,0.131397,9812.5,0,0
8593568,Ch. des Valangines,,0.000028,48,2,1,3,24038,24077,48115,10,0.161435,0.212478,1035.633333,0,0
8593569,St-Nicolas MEN,,0.000054,48,1,1,2,52582,52583,105165,19,0.08742,0.139231,8809.5,0,0
8593574,Bas-de-la-Main,,0.000072,48,3,3,6,48149,48110,96259,8,0.220779,0.31362,826.283333,0,0
8593576,Marronniers,,0.000052,48,2,3,5,38247,38257,76504,7,0.258065,0.352976,2169.166667,0,0
8593580,Régional,,0.000066,48,3,3,6,48149,48109,96258,8,0.213793,0.309025,1073.5,0,0
8593581,Collège des Parcs,,0.000065,48,3,1,4,50269,40628,90897,7,0.241667,0.303284,12.5,0,0
8593582,Rue de la Côte,,0.000049,48,2,1,3,24037,24077,48114,7,0.241667,0.303284,64.166667,0,0
8593578,Bachelin,,0.000046,48,2,2,4,24038,24077,48115,8,0.211921,0.286347,37.75,0,0
8593579,Champ-Coco,,0.000057,48,1,1,2,52583,52584,105167,18,0.093458,0.149724,7804.5,0,0
8593584,Boine,,0.000143,48,4,5,9,64782,59675,124457,6,0.307692,0.433333,13231.133333,0,0
8593583,Prébarreau,,0.000059,48,1,1,2,52584,52585,105169,17,0.100515,0.165433,6797.5,0,0
8593585,Oriette,,0.000054,48,2,2,4,46013,48095,94108,2,0.75,0.833333,541.916667,0,0
8593613,Vignoble,,0.000069,48,2,2,4,42288,52519,94807,6,0.272727,0.350694,11950.578571,0,0
8593614,Cévenols,,0.000065,48,2,4,6,65871,65991,131862,5,0.328571,0.436957,10347.12619,0,0
8594872,St-Etienne,,0.000102,48,2,2,4,13274,12916,26190,5,0.375,0.547222,1636.5,0,0
8594873,Vernes,,0.000054,48,1,1,2,6907,6886,13793,5,0.333333,0.456667,0,0,0
8594874,"Corcelles NE, Place de la Gare",,0.000138,48,4,1,5,13604,13626,27230,4,0.4,0.520833,1411.866667,0,0
8593588,Louis-Favre,,0.000058,48,2,2,4,48033,48152,96185,1,1,1,1584.25,0,0
8594601,Port-Roulant,,0.000058,48,2,1,3,48148,46637,94785,1,1,1,2.666667,0,0
8593589,Numa-Droz,,0.000056,48,3,1,4,39108,39794,78902,16,0.104046,0.165299,1049,0,0
8593593,Matile 16,,0.000075,48,1,1,2,18743,18616,37359,2,0.666667,0.75,2252,0,0
8593595,Matile 34,,0.000074,48,1,1,2,18616,18616,37232,1,1,1,1127,0,0
8593596,Université,,0.000149,48,4,3,7,79391,80009,159400,14,0.123636,0.236039,13382.583333,0,0
8593608,"Neuchâtel,  Piscines",,0.000056,48,1,2,3,26313,26314,52627,2,0.75,0.833333,527.166667,0,0
8594600,Lycée D.-Rougemont,,0.000123,48,3,1,4,64861,13153,78014,2,0.666667,0.75,1188,0,0
8593598,Liserons,,0.000146,48,3,2,5,48378,48378,96756,17,0.115702,0.216507,7676.133333,0,0
8593602,Fahys,,0.000073,48,1,1,2,48320,48320,96640,17,0.112033,0.187488,0,0,0
8593599,Hôpital Pourtalès,,0.000053,48,1,1,2,53320,53322,106642,13,0.117424,0.165016,8330.416667,0,0
8593600,Maladière,,0.000053,48,1,1,2,26315,26313,52628,3,0.5,0.583333,1656.166667,0,0
8593601,Microcity,,0.000056,48,1,1,2,53322,53320,106642,12,0.128755,0.176049,7228.416667,0,0
8593603,CSEM/Bas-du-Mail,,0.000058,48,1,1,2,53320,53322,106642,11,0.142857,0.19015,6124.416667,0,0
8593604,Portes-Rouges,,0.000135,48,2,2,4,48378,48378,96756,16,0.121495,0.221498,5476.133333,0,0
8593612,Châble,,0.000069,48,1,2,3,48320,48324,96644,13,0.158621,0.261679,554.333333,0,0
8593617,Sous-les-Vignes,,0.000119,48,1,3,4,72394,72522,144916,10,0.235294,0.381448,1475.033333,0,0
8593605,Saars 17,,0.000061,48,1,1,2,53322,53322,106644,10,0.16092,0.209099,5018.416667,0,0
8593606,Saars 55,,0.000062,48,1,1,2,53322,53321,106643,9,0.184932,0.236493,3910.416667,0,0
8593607,Ste-Hélène,,0.000068,48,1,1,2,48320,48321,96641,15,0.128866,0.195683,2766.333333,0,0
8594598,Falaises,,0.000101,48,3,2,5,53305,49398,102703,3,0.571429,0.708333,3009.833333,0,0
8594599,Gouttes d'Or,,0.000054,48,1,1,2,49030,51341,100371,3,0.5,0.611111,0,0,0
8593609,Chemin des Mulets,,0.000064,48,1,1,2,53321,53321,106642,8,0.218487,0.281227,2800.416667,0,0
8593610,Favarge,,0.000069,48,1,1,2,48321,48320,96641,14,0.142012,0.217592,1661.333333,0,0
8594596,"Cormondrèche, Grand'Rue",,0.000088,48,3,2,5,52641,52621,105262,9,0.246377,0.364449,6080.559524,0,0
8593616,Gare Lac,,0.000128,48,2,1,3,75131,72394,147525,11,0.198113,0.284733,2627.033333,0,0
8593626,Blaise-Cendrars,,0.000023,134,2,2,4,22988,23025,46013,14,0.125523,0.171249,2657.5,0,0
8593627,Breguet,,0.000027,134,2,1,3,23255,22271,45526,14,0.122105,0.151292,468.5,0,0
8593684,"La Chaux-de-Fonds, Hôpital",,0.000083,134,2,2,4,46621,43820,90441,5,0.368421,0.516667,71,0,0
8593631,Forges,,0.000021,134,1,1,2,21290,21289,42579,13,0.136691,0.167823,1837.5,0,0
8593634,Tricentenaire,,0.000034,134,1,1,2,22271,22212,44483,13,0.136691,0.167823,85.5,0,0
8593635,Numaga,,0.000057,134,2,1,3,43501,44558,88059,12,0.155556,0.191548,1594,0,0
8593636,Succès,,0.000033,134,1,1,2,46690,46690,93380,12,0.155556,0.191548,3990,0,0
8593638,Cernil-Antoine,,0.00006,134,1,2,3,44558,44558,89116,11,0.180921,0.231581,1206,0,0
8593643,Ami-Girard,,0.000036,134,1,1,2,21532,21532,43064,11,0.178218,0.217351,0,0,0
8593639,Frameries,,0.000041,134,2,2,4,60134,60166,120300,12,0.178841,0.228673,1984.533333,0,0
8593640,Helvétie,,0.000029,134,1,1,2,44314,44315,88629,12,0.176768,0.217654,0,0,0
8593641,Villa Turque,,0.000039,134,1,2,3,46690,46662,93352,11,0.180921,0.231581,3422,0,0
8593642,"La Chaux-de-Fonds, Tête-de-Ran",,0.000016,134,1,1,2,6932,6932,13864,18,0.085075,0.115644,3066,0,0
8593644,Tourelles,,0.000024,134,1,1,2,6932,6932,13864,17,0.091354,0.12157,2684,0,0
8593645,Plaisance,,0.000032,134,1,1,2,6932,6932,13864,16,0.098743,0.12862,2300,0,0
8593648,Nord,,0.000027,134,1,1,2,23191,23191,46382,11,0.174497,0.209685,1250,0,0
8593650,Signal,,0.000038,134,1,1,2,6932,6932,13864,15,0.10757,0.137178,1914,0,0
8593653,Monbrillant,,0.000043,134,1,1,2,6932,6932,13864,14,0.118304,0.147828,1526,0,0
8593654,Abeille,,0.000063,134,2,1,3,44722,44701,89423,10,0.207317,0.253688,685,0,0
8593655,Ormes,,0.000053,134,3,2,5,21682,21679,43361,10,0.18315,0.233976,5233.333333,0,0
8593656,Bougillons,,0.000033,134,1,1,2,21042,21045,42087,10,0.180147,0.218343,0,0,0
8593657,Electrices,,0.000047,134,1,1,2,6932,6932,13864,13,0.131646,0.161501,1136,0,0
8593660,Point-du-jour,,0.000051,134,1,1,2,6932,6931,13863,12,0.148688,0.179795,744,0,0
8593663,Bois Pt Château,,0.0001,134,4,1,5,58537,58554,117091,10,0.202479,0.246016,1670,0,0
8593671,"La Chaux-de-Fonds, Sombaille",,0.000028,134,1,2,3,13560,13616,27176,10,0.185714,0.324664,661,0,0
8593673,1er août,,0.000023,134,1,1,2,6684,6684,13368,10,0.173913,0.268386,0,0,0
8593677,Beaux-Dimanches,,0.000076,134,3,2,5,23187,22941,46128,8,0.226667,0.299195,2228.233333,0,0
8593678,Théâtre,,0.00006,134,2,4,6,87649,85294,172943,7,0.275,0.378066,3026.833333,0,0
8593675,Conservatoire,,0.000059,134,3,1,4,58342,44916,103258,9,0.192982,0.288348,2005,0,0
8593676,Citadelle,,0.000061,134,1,1,2,44916,44940,89856,8,0.217391,0.313452,1352,0,0
8593679,Bel-Air,,0.000063,134,1,1,2,44940,44940,89880,7,0.25,0.347354,697,0,0
8593680,"La Chaux-de-Fonds, Patinoire",,0.000056,134,2,1,3,42947,22942,65889,8,0.196429,0.288203,768.866667,0,0
8593681,Chasseral,,0.000064,134,1,1,2,44940,44929,89869,6,0.296296,0.4,40,0,0
8593683,Versoix,,0.000041,134,2,2,4,43340,44758,88098,5,0.380952,0.514583,1364,0,0
8593682,Musées,,0.000028,134,1,1,2,11098,11143,22241,7,0.222222,0.312619,1598.7,0,0
8593686,Crêtets,,0.000058,134,1,1,2,22942,21760,44702,7,0.222222,0.312619,115.866667,0,0
8593687,Perret-Gentil,,0.000149,134,4,2,6,47776,45010,92786,3,0.571429,0.708333,2732,0,0
8593690,Prévoyance,,0.000074,134,1,1,2,1734,1529,3263,3,0.5,0.611111,0,0,0
8593688,Promenade,,0.000084,134,2,1,3,32903,11142,44045,6,0.257143,0.344444,1068.566667,0,0
8593689,Chapelle,,0.000024,134,1,1,2,10398,10399,20797,6,0.257143,0.344444,1254.433333,0,0
8593691,Cluse,,0.000031,134,1,1,2,10399,10400,20799,5,0.307692,0.389583,599.433333,0,0
8593695,Gibraltar,,0.000082,134,1,1,2,11142,11143,22285,5,0.307692,0.389583,410.566667,0,0
8593692,Pont,,0.000028,134,1,1,2,9614,9614,19228,4,0.4,0.520833,2644,0,0
8593693,F.-Courvoisier,,0.000041,134,2,2,4,55911,56076,111987,5,0.36,0.485185,5306,0,0
8593694,Parc des sports,,0.000138,134,2,1,3,44805,44875,89680,2,0.666667,0.75,1370,0,0
8593696,Forains,,0.000035,134,1,1,2,9614,9664,19278,3,0.5,0.611111,1986,0,0
8593697,Marais,,0.000028,134,1,1,2,9654,9654,19308,4,0.4,0.520833,1995,0,0
8593699,Etoile,,0.000028,134,1,1,2,46422,46432,92854,3,0.5,0.611111,1992,0,0
8593700,Pâquerette,,0.000128,134,1,1,2,44875,44866,89741,1,1,1,686,0,0
8593701,"La Chaux-de-Fonds, collège",,0.00004,134,1,1,2,9664,3952,13616,2,0.666667,0.75,1326,0,0
8593703,Esplanade,,0.000035,134,1,1,2,9654,9654,19308,3,0.5,0.611111,1334,0,0
8593704,M St-Hélier,,0.000035,134,1,1,2,46432,46436,92868,2,0.666667,0.75,1330,0,0
8593706,Etang,,0.00004,134,1,1,2,9654,9654,19308,2,0.666667,0.75,671,0,0
8593707,Prés-de-la-Ronde,,0.000045,134,1,1,2,3952,9652,13604,1,1,1,664,0,0
8593711,Chemin blanc,,0.000045,134,1,1,2,9654,9654,19308,1,1,1,6,0,0
8593708,L'Eplattenier,,0.00004,134,1,1,2,46436,46435,92871,1,1,1,666,0,0
8593713,Prés-Verts,,0.000059,134,1,2,3,21543,21543,43086,2,0.75,0.833333,2016,0,0
8593714,Combe-Perret,,0.000036,134,1,1,2,11143,11143,22286,2,0.666667,0.75,0,0,0
8593715,"La Chaux-de-Fonds, Cerisier",,0.000067,134,2,1,3,21543,21543,43086,1,1,1,674,0,0
8593716,Petits-Monts,,0.000011,134,0,1,1,0,18326,18326,8,0.236842,0.35754,0,0,0
8593717,"Le Locle, Jeanneret",,0.000041,134,3,2,5,17433,18096,35529,5,0.37037,0.486667,4826.41674,0,0
8593718,Ticino,,0.000028,134,1,1,2,1117,1117,2234,4,0.368421,0.452381,615,0,0
8593719,Fritillaires,,0.000028,134,1,3,4,16979,16979,33958,4,0.470588,0.614583,2993.41674,0,0
8593722,Billodes,,0.000043,134,2,2,4,8273,8273,16546,3,0.5,0.611111,625,0,0
8593723,Tertre,,0.000019,134,1,1,2,9160,9160,18320,5,0.333333,0.456667,0,0,0
8593720,"Le Locle, Malpierres",,0.00002,134,1,2,3,18326,18326,36652,7,0.275862,0.449107,8,0,0
8593721,Le Chalet,,0.000019,134,1,1,2,18226,18114,36340,7,0.25,0.370408,0,0,0
8593725,Corbusier,,0.000053,134,3,1,4,16979,16979,33958,4,0.4,0.520833,1160.41674,0,0
8593726,Tilleuls,,0.000036,134,2,1,3,18214,18326,36540,6,0.285714,0.408333,18,0,0
8593727,"Le Locle, Hôpital",,0.000041,134,1,1,2,18326,18326,36652,5,0.333333,0.456667,20,0,0
8593729,Jolimont,,0.000046,134,1,1,2,18326,18326,36652,4,0.4,0.520833,20,0,0
8593733,"Le Locle, collège",,0.00005,134,1,1,2,18326,18326,36652,3,0.5,0.611111,18,0,0
8593734,Etangs,,0.000027,134,2,2,4,17110,17110,34220,7,0.241935,0.356825,2046.819048,0,0
8593736,Primevères,,0.000022,134,1,1,2,9384,9381,18765,7,0.229508,0.310884,0,0,0
8593739,Daniel-JeanRichard,,0.000075,134,5,3,8,16820,18555,35375,4,0.451613,0.541667,4528.485714,0,0
8593744,Beau-Site,,0.000062,134,2,2,4,9836,10608,20444,4,0.444444,0.552083,1251.590476,0,0
8593741,Cardamines,,0.000028,134,1,1,2,9384,9384,18768,5,0.285714,0.355556,270.819048,0,0
8593743,Gentianes,,0.000035,134,1,1,2,9254,9254,18508,5,0.333333,0.411111,25,0,0
8593742,Fiottets,,0.000056,134,2,2,4,13424,18537,31961,4,0.366667,0.462121,1960.409524,0,0
8593745,Abattes,,0.000035,134,1,1,2,9283,9384,18667,3,0.5,0.583333,680.409524,0,0
8593747,Foyer,,0.000037,134,1,1,2,9283,9352,18635,3,0.5,0.583333,595.590476,0,0
8593746,Raya,,0.000027,134,1,1,2,6265,6265,12530,4,0.4,0.520833,1256,0,0
8593749,Georges-Perrenoud,,0.000034,134,1,1,2,6265,6265,12530,3,0.5,0.611111,631,0,0
8593756,"Nottwil, Eymatt SPZ",,0.000096,92,3,1,4,3625,1775,5400,2,0.666667,0.75,382,0,0
8593773,Les Bovets,,0.00008,4,1,1,2,6813,8002,14815,3,0.5,0.611111,459,0,0
8593774,La Faverge,,0.000079,4,1,1,2,8002,8002,16004,2,0.666667,0.75,308,0,0
8593775,Les Nicolets,,0.000078,4,1,1,2,8002,8002,16004,1,1,1,155,0,0
8593779,"Vufflens-la-Ville,grande salle",,0.000045,5,1,1,2,5079,5080,10159,4,0.416667,0.516667,15,0,0
8593780,"Vufflens-la-Ville, Cuvillard",,0.000024,5,1,1,2,2240,2240,4480,4,0.416667,0.516667,377.166667,0,0
8593781,"Vufflens-la-Ville, église",,0.00007,5,2,2,4,7320,7315,14635,3,0.571429,0.708333,291.166667,0,0
8594177,"Bussigny, Cocagne",,0.000092,5,2,1,3,40362,34193,74555,1,1,1,458,0,0
8593782,"Vufflens-la-Ville, gare",,0.000041,5,1,1,2,2238,2240,4478,2,0.666667,0.75,81.166667,0,0
8593869,"Chavannes-R., Glycines",,0.000204,5,3,4,7,97788,91445,189233,3,0.636364,0.761905,4001.833333,0,0
8593783,"L'Auberson, ch. du Carre",,0.000094,35,1,2,3,5854,5853,11707,2,0.75,0.833333,154,0,0
8593784,"L'Auberson, Les Sapins",,0.000051,35,1,1,2,2931,2931,5862,2,0.666667,0.75,0,0,0
8593795,"Belmont-s.-L., Chaffeises",,0.000021,10,1,1,2,27104,27680,54784,6,0.28,0.385714,2471,0,0
8593798,"Belmont-sur-Lausanne, Burenoz",,0.000029,10,1,1,2,27680,27679,55359,5,0.333333,0.436111,2124,0,0
8593806,"Belmont-sur-Lausanne, Rouvène",,0.000035,10,1,1,2,27679,27680,55359,4,0.416667,0.516667,1775,0,0
8593816,"Crissier, Marcolet",,0.000049,5,1,2,3,35833,35833,71666,3,0.555556,0.666667,2705,0,0
8593817,"Crissier, Feleire",,0.000032,5,1,1,2,27465,27465,54930,2,0.666667,0.75,1084,0,0
8594114,"Grenchen, Fichtenweg",,0.000064,127,3,3,6,14127,14127,28254,5,0.367089,0.435057,391.18254,0,0
8594122,"Grenchen, Jurastrasse",,0.00004,127,1,5,6,25187,25187,50374,6,0.352941,0.478472,2711.47619,0,0
8593842,"Bettlach, Allmend",,0.000037,127,2,3,5,6660,6660,13320,8,0.205263,0.288065,220.291667,0,0
8593902,"Bettlach, Bangertli",,0.000025,127,1,2,3,12655,12655,25310,7,0.232704,0.291248,91.541667,0,0
8594091,"Bettlach, Gummen",,0.000029,127,1,1,2,3330,3330,6660,8,0.194737,0.242825,37,0,0
8594092,"Bettlach, Hochhaus",,0.000056,127,3,4,7,17637,17619,35256,7,0.235294,0.320172,211.166667,0,0
8593850,"Pully, Caudoz",,0.000041,10,1,2,3,27680,27680,55360,3,0.571429,0.708333,1424,0,0
8595190,"Belmont-sur-Lausanne, Malavaux",,0.000028,10,1,1,2,13779,13778,27557,3,0.5,0.611111,0,0,0
8593864,"Bettlach, Ariston",,0.000025,127,1,1,2,11157,11157,22314,7,0.208589,0.246919,65.333333,0,0
8593866,"Chavannes-R., Préfaully",,0.000038,5,1,1,2,24781,24784,49565,5,0.321429,0.392593,318.833333,0,0
8593867,"Chavannes-R., Plaine",,0.000042,5,1,1,2,33598,33597,67195,5,0.321429,0.392593,983.166667,0,0
8594270,"Mex VD, Faraz",,0.000089,5,2,1,3,11789,5761,17550,1,1,1,41,0,0
8593870,"Borex, Le Chanelet",,0.000044,125,3,2,5,10765,10765,21530,4,0.416667,0.516667,177.666667,0,0
8593872,"Crassier, La Scie du Verger",,0.00003,125,1,1,2,10648,10645,21293,4,0.391304,0.462963,0,0,0
8593895,"Nyon, route du Boiron",,0.000059,125,3,1,4,28084,28075,56159,4,0.391304,0.462963,203.774242,0,0
8593871,"Crans VD, Les Landes",,0.000072,125,2,2,4,15109,15147,30256,6,0.283019,0.381111,526.333333,0,0
8595172,"Coppet, Les Marais",,0.000067,125,1,1,2,10450,83,10533,2,0.666667,0.75,58,0,0
8593876,"Nyon, ch. Valmont",,0.000038,125,2,1,3,28087,28087,56174,6,0.282609,0.351282,170.977273,0,0
8593878,"Nyon, Chantemerle",,0.00003,125,2,1,3,27290,27291,54581,6,0.296296,0.4,168,0,0
8593879,"Nyon, chemin de Bourgogne",,0.000036,125,1,2,3,27291,27291,54582,5,0.368421,0.516667,154,0,0
8593881,"Nyon, chemin des Plantaz",,0.000026,125,1,1,2,13537,13537,27074,5,0.333333,0.436111,0,0,0
8593888,"Nyon, Les Jouvencelles",,0.000063,125,3,3,6,28098,28098,56196,4,0.44,0.55303,600.142424,0,0
8593893,"Nyon, route de Divonne",,0.000029,125,1,2,3,14099,14097,28196,3,0.434783,0.516667,100.769697,0,0
8593883,"Nyon, chemin du Vallon",,0.000054,125,2,1,3,27511,27511,55022,4,0.363636,0.4375,112,0,0
8593884,"Nyon, chemin du Reposoir",,0.000049,125,2,1,3,27291,27291,54582,4,0.416667,0.516667,120,0,0
8593885,"Nyon, La Levratte",,0.000052,125,1,2,3,27291,27291,54582,3,0.571429,0.708333,100,0,0
8593886,"Nyon, La Paix",,0.000033,125,1,1,2,13754,13753,27507,2,0.666667,0.75,26,0,0
8593887,"Nyon, Le Groseillier",,0.000033,125,1,1,2,13537,13537,27074,2,0.666667,0.75,26,0,0
8593896,"Nyon, route du Stand",,0.000105,125,3,4,7,38837,38850,77687,3,0.571429,0.708333,291.440909,0,0
8593891,"Nyon, Marens",,0.000067,125,2,1,3,27290,13754,41044,1,1,1,28,0,0
8593901,"Nyon, Tattes d'Oie",,0.000051,125,2,2,4,14000,14001,28001,3,0.555556,0.666667,211.289394,0,0
8594847,"Nyon, Terre-Bonne",,0.000055,125,2,2,4,28086,28087,56173,2,0.666667,0.75,80.698485,0,0
8595174,"Crassier, Ferme du Château",,0.000033,125,1,1,2,10673,10674,21347,3,0.444444,0.541667,0,0,0
8593897,"Nyon, rte de l'Etraz",,0.000057,125,2,2,4,27503,27422,54925,2,0.666667,0.75,72.5,0,0
8593899,"Nyon, rue St-Jean",,0.000035,125,1,1,2,13490,13484,26974,2,0.6,0.666667,0,0,0
8594161,"Gland, Mont Blanc sud",,0.000049,125,2,1,3,8238,7860,16098,2,0.6,0.666667,92.5,0,0
8594097,"Bettlach, Mathys",,0.000023,127,1,1,2,5580,5580,11160,7,0.213793,0.248157,0,0,0
8593903,"Bettlach, Bergstrasse",,0.000021,127,1,1,2,3330,3330,6660,9,0.166667,0.206057,26,0,0
8593982,"Vevey, Bergère",,0.000066,12,1,1,2,7623,7623,15246,1,1,1,22,0,0
8594010,"Montagny-p.-Yv., Chamard poste",,0.000034,35,1,2,3,18731,18797,37528,11,0.142857,0.200519,2888,0,0
8594011,"Montagny-p.-Yv., Clos Lucens",,0.000025,35,1,1,2,9929,9929,19858,11,0.139442,0.177677,0,0,0
8594012,"Montagny-p.-Yv., La Brinaz",,0.000047,35,2,1,3,18797,18774,37571,10,0.157407,0.195296,1512,0,0
8594013,"Montagny-près-Yverdon, Chamard",,0.000051,35,1,1,2,18774,18797,37571,9,0.181319,0.220034,821,0,0
8594027,"Yverdon, Y-Parc/Galilée",,0.00012,35,5,4,9,39943,39936,79879,6,0.306122,0.406667,11428.690476,0,0
8594024,"Yverdon, Les Chaînettes",,0.000041,35,2,2,4,23168,23169,46337,7,0.25,0.317989,1623.433333,0,0
8594025,"Yverdon, Maison Blanche",,0.000048,35,2,2,4,23133,23133,46266,6,0.288889,0.360897,136.695238,0,0
8594026,"Yverdon, Moulins Dessus",,0.000049,35,2,2,4,23169,22793,45962,6,0.308642,0.384,781.988095,0,0
8594028,"Yverdon, Pierre de Savoie",,0.000036,35,1,1,2,10089,10090,20179,6,0.260417,0.316,0,0,0
8594043,"Yverdon-les-Bains, La Plaine",,0.000099,35,3,6,9,41872,41893,83765,4,0.425532,0.554167,2898.840476,0,0
8594037,"Yverdon-les-Bains, Cheminet",,0.000071,35,1,3,4,20117,20151,40268,5,0.358491,0.444737,1390.288095,0,0
8594052,"Yverdon, Riants-Fleurs",,0.000042,35,1,2,3,9182,9183,18365,4,0.382353,0.461538,137.680952,0,0
8594056,"Yverdon, Pont du Buron",,0.000052,35,2,2,4,35378,35379,70757,4,0.382353,0.461538,2913.111905,0,0
8594030,"Yverdon, rue de Chamblon",,0.00007,35,2,1,3,20153,20117,40270,6,0.273973,0.325833,2109.288095,0,0
8594042,"Yverdon-les-Bains, La Marive",,0.000097,35,5,2,7,18066,18149,36215,5,0.313433,0.389683,450.342857,0,0
8594035,"Yverdon-les-Bains, Bellevue",,0.00006,35,3,2,5,18349,18350,36699,6,0.257576,0.35,2548.078571,0,0
8594046,"Yverdon-les-Bains, cimetière",,0.000032,35,1,2,3,21016,21016,42032,4,0.382353,0.461538,133.4,0,0
8594040,"Yverdon-les-Bains, hôpital",,0.000056,35,2,1,3,20942,21016,41958,6,0.274194,0.338235,2781.235714,0,0
8594041,"Yverdon-les-Bains, La Colline",,0.000037,35,1,1,2,9183,9182,18365,5,0.291667,0.35,852.680952,0,0
8594044,"Yverdon-les-Bains, La Sallaz",,0.000073,35,2,3,5,29841,29920,59761,5,0.355556,0.465625,2104.902381,0,0
8594053,"Yverdon-les-Bains, Mujon",,0.000087,35,3,1,4,18150,15478,33628,4,0.416667,0.516667,21.42381,0,0
8594047,"Yverdon-les-Bains, St-Georges",,0.000044,35,2,1,3,18798,17468,36266,4,0.363636,0.416667,98.9,0,0
8594054,"Yverdon-les-Bains, Philosophes",,0.000119,35,3,2,5,18978,18994,37972,3,0.571429,0.708333,1394,0,0
8595065,"Yverdon, Y-Parc/Pythagore",,0.000101,35,2,2,4,29844,26917,56761,2,0.75,0.833333,1712,0,0
8594063,"Schüpfen, Bundkofen",,0.000052,87,1,1,2,82,82,164,4,0.4,0.520833,5012,0,0
8594064,"Schüpfen, Schlattweg",,0.000055,87,1,1,2,82,82,164,3,0.5,0.611111,3762,0,0
8594065,"Schüpfen, Schwanden",,0.000058,87,1,1,2,82,82,164,2,0.666667,0.75,2510,0,0
8594066,"Suberg, Kosthofen",,0.00006,87,1,1,2,82,82,164,1,1,1,1256,0,0
8594089,"Nidau, Bahnhof",,0.000148,87,5,1,6,41093,32551,73644,4,0.416667,0.516667,6330,0,0
8594090,"Bettlach, Buchenweg",,0.000025,127,1,1,2,12641,12641,25282,6,0.25,0.291919,151.333333,0,0
8594093,"Bettlach, Hof",,0.000033,127,2,1,3,3322,3330,6652,2,0.666667,0.75,56,0,0
8594094,"Bettlach, Hübeli",,0.000023,127,1,1,2,3320,3330,6650,2,0.666667,0.75,4,0,0
8594111,"Grenchen, Dammstrasse",,0.00005,127,1,3,4,7062,7062,14124,6,0.292453,0.365591,72.3,0,0
8594115,"Grenchen, Flurstrasse Nord",,0.000048,127,3,1,4,22127,21754,43881,5,0.305263,0.352299,64.133333,0,0
8594116,"Grenchen, Friedhof",,0.000046,127,1,3,4,23203,23203,46406,5,0.341176,0.416092,56.095455,0,0
8594098,"Bettlach, Räbacher",,0.000059,127,2,1,3,6660,3330,9990,1,1,1,32,0,0
8594099,"Bettlach, Riedstrasse",,0.000053,127,3,1,4,12655,12655,25310,6,0.263158,0.300556,266.833333,0,0
8594109,"Grenchen, Bellevue",,0.000063,127,4,2,6,12301,12301,24602,6,0.295238,0.351075,343.596429,0,0
8594107,"Grenchen, Am Weinberg",,0.000046,127,4,1,5,7059,7062,14121,7,0.231884,0.275298,79.3,0,0
8594108,"Grenchen, Bahnhof Nord Eterna",,0.000041,127,4,1,5,23203,23203,46406,6,0.26087,0.303333,66.095455,0,0
8594110,"Grenchen, Brüel",,0.000028,127,1,1,2,4846,4846,9692,11,0.1625,0.254276,140,0,0
8594147,"Grenchen, Veilchenstrasse",,0.00014,127,2,1,3,7062,7062,14124,2,0.666667,0.75,2602,0,0
8594113,"Grenchen, Eigerweg",,0.000035,127,1,1,2,4846,4846,9692,10,0.179104,0.271858,124,0,0
8594121,"Grenchen, Industrie Zentrum",,0.000136,127,5,4,9,43361,43361,86722,5,0.373134,0.469333,14481.716558,0,0
8594123,"Grenchen, Karl Mathy",,0.00006,127,3,3,6,15262,15262,30524,5,0.344262,0.435714,1302.97316,0,0
8594128,"Grenchen, Lingeriz 60",,0.000091,127,3,3,6,24696,24503,49199,5,0.358491,0.459649,1406.261147,0,0
8594129,"Grenchen, Lingeriz 91",,0.000037,127,1,3,4,12352,12352,24704,7,0.317073,0.468681,42.6421,0,0
8594134,"Grenchen, Postplatz Süd",,0.000048,127,3,2,5,15433,15561,30994,7,0.309524,0.43022,14012.771429,0,0
8594124,"Grenchen, Kastels Grenchen",,0.000057,127,2,2,4,12544,12544,25088,6,0.333333,0.41,3967.024567,0,0
8594127,"Grenchen, Lingeriz 4",,0.000046,127,3,1,4,12344,12344,24688,6,0.273973,0.331667,138.055519,0,0
8594125,"Grenchen, Lebernstrasse",,0.00004,127,1,1,2,4846,4846,9692,9,0.2,0.293543,106,0,0
8594126,"Grenchen, Leuzigenstrasse",,0.000045,127,1,1,2,4846,4846,9692,8,0.227273,0.321786,86,0,0
8594132,"Grenchen, N. Wengi-Strasse",,0.000049,127,1,1,2,4846,4846,9692,7,0.264706,0.362169,64,0,0
8594136,"Grenchen, Rebhalde",,0.000065,127,1,1,2,12532,1493,14025,7,0.282051,0.372078,16.333333,0,0
8594135,"Grenchen, Rebgasse",,0.000064,127,3,1,4,12532,12532,25064,8,0.235294,0.316766,1341.333333,0,0
8594139,"Grenchen, Ringstrasse",,0.000084,127,3,1,4,12641,5390,18031,3,0.5,0.611111,112.333333,0,0
8594145,"Grenchen, Standweg",,0.000068,127,1,1,2,7062,1672,8734,3,0.5,0.611111,3843.666667,0,0
8594141,"Grenchen, Schmelzirain",,0.000198,127,7,3,10,25179,17144,42323,5,0.411765,0.611905,9257.666667,0,0
8594142,"Grenchen, Schönegg",,0.000067,127,1,1,2,7062,7062,14124,4,0.4,0.520833,5196.666667,0,0
8594146,"Grenchen, Storchengasse",,0.00013,127,4,1,5,17226,1942,19168,1,1,1,104.490476,0,0
8594149,"Grenchen, Weinbergstrasse",,0.00016,127,3,1,4,12452,7062,19514,1,1,1,1361,0,0
8595687,"Olten, Südwest",,0.000067,94,1,2,3,14676,14676,29352,2,0.75,0.833333,181.008333,0,0
8594157,"Wil SG, Höhenstrasse",,0.000118,20,2,1,3,28143,28143,56286,1,1,1,232,0,0
8594164,"Meinisberg, Niesenstrasse",,0.000051,87,2,1,3,17702,17702,35404,5,0.333333,0.456667,6430,0,0
8594165,"Safnern, Gürweg",,0.000055,87,1,1,2,17702,17702,35404,4,0.4,0.520833,5148,0,0
8594167,"Safnern, Moosweg",,0.000057,87,1,1,2,17702,17702,35404,3,0.5,0.611111,3864,0,0
8594168,"Safnern, Industriestrasse",,0.00006,87,1,1,2,17702,17702,35404,2,0.666667,0.75,2578,0,0
8594169,"Orpund, Zumbach",,0.000062,87,1,1,2,17702,17702,35404,1,1,1,1290,0,0
8594173,"Olten, Wilerfeld",,0.000037,94,1,1,2,15037,15023,30060,5,0.315789,0.422222,282,0,0
8594174,"Starrkirch-Wil, Landhaus",,0.000043,94,1,1,2,15023,15023,30046,4,0.384615,0.483333,146,0,0
8594186,"Wallisellen, Haldenstrasse",,0.000038,107,1,1,2,6858,6859,13717,4,0.4,0.520833,657,0,0
8594188,"Wallisellen, Schulhaus Bürgli",,0.000075,107,2,1,3,13716,6858,20574,2,0.666667,0.75,1318,0,0
8594189,"Wallisellen, Säntisstrasse",,0.000074,107,1,1,2,6858,6858,13716,1,1,1,660,0,0
8594199,"Seuzach, Mörsburgstrasse",,0.000211,68,5,1,6,10238,3609,13847,1,1,1,214,0,0
8594200,Inselspital,,0.000078,44,3,1,4,9995,10030,20025,1,1,1,1280,0,0
8594203,"Bottenwil, Vorstatt",,0.000046,94,1,1,2,7170,3941,11111,1,1,1,243,0,0
8594205,"Buchs SG, Aeuli",,0.000069,73,1,1,2,12682,12682,25364,3,0.454545,0.533333,6342,0,0
8594209,"Albonago, Gradinata",,0.000057,102,2,1,3,11818,11818,23636,4,0.4,0.486111,468,0,0
8594212,"Breganzona, Biogno",,0.000044,102,1,1,2,8627,8627,17254,4,0.4,0.520833,1716,0,0
8594213,"Breganzona, Camara Medi",,0.000049,102,1,1,2,8627,8627,17254,3,0.5,0.611111,1290,0,0
8594214,"Breganzona, Pianazzo",,0.000052,102,1,1,2,8627,8627,17254,2,0.666667,0.75,862,0,0
8594215,"Breganzona, Camara Scuole",,0.000055,102,1,1,2,8627,8627,17254,1,1,1,432,0,0
8594217,"Breganzona, Via Casale",,0.000035,102,2,2,4,8628,8628,17256,2,0.75,0.833333,1197,0,0
8594285,"Cureglia, Rotonda",,0.000146,102,4,1,5,18477,1988,20465,1,1,1,295.848052,0,0
8594222,"Lugano, Moncucco Clinica",,0.000026,102,1,1,2,4330,4330,8660,1,1,1,400,0,0
8594227,"Ruvigliana, Parco S. Michele",,0.000081,102,1,1,2,11818,11818,23636,1,1,1,443,0,0
8594240,"Epagny, Croix-Blanche",,0.000036,13,1,1,2,852,872,1724,3,0.5,0.611111,2010,0,0
8594241,"Le Pâquier-Montbarry, gare",,0.000041,13,1,1,2,872,852,1724,2,0.666667,0.75,1342,0,0
8594242,"Romanens, laiterie",,0.000045,13,1,1,2,4283,4283,8566,8,0.2,0.272194,685,0,0
8594245,"La Tour-de-Trême, Ronclina",,0.000046,13,1,1,2,852,440,1292,1,1,1,672,0,0
8594246,"Vaulruz, Croix-Verte",,0.000087,13,2,1,3,12145,11987,24132,6,0.27907,0.352778,2364,0,0
8594248,"Vuisternens-dt-Romont, village",,0.000084,13,5,2,7,16282,12619,28901,4,0.45,0.546296,3967.161905,0,0
8594388,"Maules, village",,0.000047,13,1,1,2,4229,4229,8458,6,0.296296,0.4,151.5,0,0
8594252,"Kilchberg ZH, Breitloo",,0.00004,130,1,1,2,3288,3288,6576,2,0.666667,0.75,70,0,0
8594267,"St. Gallen, Haselstrasse",,0.000049,71,2,1,3,24726,24726,49452,4,0.4,0.520833,1873,0,0
8594268,"St. Gallen, Rosenbüchel",,0.000053,71,1,1,2,24726,24726,49452,3,0.5,0.611111,942,0,0
8595470,"Olten, Fachhochschule",,0.00008,94,2,1,3,30530,30049,60579,2,0.666667,0.75,109.533333,0,0
8595911,"Trimbach, Hagmatt",,0.000056,94,2,1,3,32213,13546,45759,2,0.666667,0.75,39.333333,0,0
8594304,"Würenlos, Altwiesen",,0.00009,22,1,1,2,5314,5314,10628,6,0.285714,0.408333,3636,0,0
8594305,"Würenlos, Bahnhofplatz",,0.000087,22,1,1,2,5314,5314,10628,5,0.333333,0.456667,3035,0,0
8594306,"Würenlos, Brunnenweg",,0.000085,22,1,1,2,5314,5314,10628,4,0.4,0.520833,2432,0,0
8594307,"Würenlos, Lärchenweg",,0.000083,22,1,1,2,5314,5314,10628,3,0.5,0.611111,1827,0,0
8594308,"Würenlos, Limmatbrücke",,0.000082,22,1,1,2,5314,5314,10628,2,0.666667,0.75,1220,0,0
8594309,"Würenlos, Spycher",,0.00008,22,1,1,2,5314,5314,10628,1,1,1,611,0,0
8594335,"Visp, Pomona West",,0.000164,40,4,1,5,7039,7039,14078,2,0.666667,0.75,206,0,0
8594343,"Nidau, Ruferheim",,0.000137,87,1,2,3,32551,32554,65105,3,0.571429,0.708333,5068,0,0
8594344,"Port, Moosgasse",,0.000069,87,1,1,2,15460,15561,31021,3,0.5,0.611111,0,0,0
8594345,"St. Gallen, Einstein",,0.00004,71,3,1,4,21666,20254,41920,9,0.204082,0.307897,1950,0,0
8594346,"St. Gallen, Stiftsbezirk",,0.000045,71,1,1,2,20254,18816,39070,8,0.230769,0.339021,1024,0,0
8594348,"St. Gallen, Athletik Zentrum",,0.000085,71,3,2,5,29803,22693,52496,6,0.318182,0.492857,6566,0,0
8594354,"Wittenbach, Abacus-Platz",,0.000061,71,1,1,2,22460,21492,43952,1,1,1,5,0,0
8594349,"St. Gallen, Spitalstrasse",,0.000047,71,1,1,2,22460,22460,44920,6,0.285714,0.408333,4695,0,0
8594350,"St. Gallen, Lindenhof",,0.000051,71,1,1,2,22460,22460,44920,5,0.333333,0.456667,3761,0,0
8594351,"St. Gallen, Lindentalstrasse",,0.000054,71,1,1,2,22460,18860,41320,4,0.4,0.520833,2825,0,0
8594352,"St. Gallen, Bruggwaldpark",,0.000057,71,1,1,2,18860,22460,41320,3,0.5,0.611111,1887,0,0
8594353,"St. Gallen, Bruggwald",,0.000059,71,1,1,2,22460,22460,44920,2,0.666667,0.75,947,0,0
8594371,"Lenk, Laubbärgli",,0.000027,23,1,1,2,1583,1583,3166,6,0.285714,0.408333,23,0,0
8594390,"Aarau, Aarenau",,0.000075,57,2,1,3,11849,11849,23698,4,0.416667,0.516667,142.5,0,0
8594929,"Aarau, Kasinopark",,0.000203,57,6,1,7,2993,2993,5986,1,1,1,110,0,0
8594392,"Suhr, Gemeindehaus",,0.000082,57,2,1,3,17068,17068,34136,2,0.6,0.666667,128.5,0,0
8594418,"Chur, Fürstenwaldstrasse",,0.00003,109,1,1,2,6806,6610,13416,6,0.241135,0.276961,34,0,0
8594432,"Chur, Obere Au P&R",,0.000024,109,1,1,2,14688,14674,29362,7,0.235955,0.292517,68,0,0
8594421,"Chur, Güterstrasse",,0.000073,109,2,6,8,30257,29380,59637,4,0.418919,0.510753,202.285714,0,0
8594442,"Chur, Rossboden",,0.000027,109,1,2,3,14713,14716,29429,5,0.339286,0.409649,485.665686,0,0
8594407,"Chur, Bodmer",,0.000024,109,1,1,2,5382,5382,10764,13,0.146552,0.227333,1923,0,0
8594408,"Chur, Bondastrasse",,0.000037,109,2,2,4,10143,10371,20514,7,0.238095,0.295893,4816.5,0,0
8594410,"Chur, Cadonaustrasse",,0.000031,109,1,4,5,45025,45025,90050,8,0.272109,0.365923,4843,0,0
8594411,"Chur, Calunastrasse",,0.000033,109,2,2,4,19289,22499,41788,7,0.237805,0.29707,979.166667,0,0
8594409,"Chur, Bürgerheim",,0.000024,109,1,1,2,41533,45025,86558,9,0.218085,0.268012,6726,0,0
8594424,"Chur, Kantonsspital GR",,0.000059,109,4,1,5,48166,45421,93587,5,0.285714,0.339583,7375.219048,0,0
8594448,"Chur, Splügenstrasse",,0.000063,109,2,2,4,44967,44967,89934,6,0.344828,0.478333,37,0,0
8594426,"Chur, Industriestrasse",,0.000037,109,1,2,3,14428,15209,29637,6,0.298851,0.367308,26,0,0
8594417,"Chur, Fürstenwald",,0.000023,109,1,1,2,6610,6806,13416,7,0.198864,0.231565,1933,0,0
8594419,"Chur,Grischunaweg FHGR",,0.000067,109,4,2,6,30036,29378,59414,5,0.308411,0.362626,4010.285714,0,0
8594420,"Chur, Grossbruggerweg",,0.000039,109,1,1,2,14428,15307,29735,5,0.301887,0.342708,0,0,0
8594428,"Chur, Lochertstrasse",,0.000058,109,4,3,7,27173,27200,54373,6,0.3125,0.397333,7447.319048,0,0
8594430,"Chur, Meierweg",,0.000027,109,1,3,4,14377,14377,28754,6,0.32,0.410417,2.933333,0,0
8594431,"Chur, Obere Au",,0.000061,109,4,4,8,29474,29995,59469,5,0.383333,0.47971,2061.719048,0,0
8594443,"Chur, Rätusstrasse",,0.00004,109,3,3,6,28095,28095,56190,4,0.439024,0.513889,8300.67521,0,0
8594445,"Chur, Schule Quader",,0.000108,109,5,4,9,72140,72167,144307,3,0.52,0.615385,5911.315476,0,0
8594427,"Chur, Kreuzspital",,0.000067,109,2,2,4,45485,44967,90452,4,0.375,0.45,5474.219048,0,0
8594423,"Chur, Ringstrasse FHGR",,0.000031,109,2,1,3,14944,14428,29372,7,0.236842,0.282451,1939,0,0
8594425,"Chur, Krematorium",,0.000051,109,2,1,3,10839,10850,21689,11,0.180723,0.27577,15414,0,0
8594434,"Chur, Plantaweg",,0.000086,109,5,2,7,10915,10901,21816,4,0.424242,0.494048,2948.575,0,0
8594429,"Chur, Meiersboden",,0.000054,109,1,2,3,10850,10863,21713,10,0.205882,0.336593,13503,0,0
8594433,"Chur, Planaterrastrasse",,0.000034,109,1,1,2,5160,5158,10318,10,0.19403,0.285562,0,0,0
8594435,"Chur, Plessurfall",,0.000063,109,2,1,3,10861,10863,21724,9,0.222222,0.326025,9675,0,0
8594437,"Chur, Rabiosabrücke",,0.000064,109,1,2,3,10863,10863,21726,8,0.261905,0.413745,7758,0,0
8594439,"Chur, Reichsgasse",,0.000038,109,1,1,2,5160,5158,10318,8,0.243902,0.355119,0,0,0
8594440,"Chur, Sommeraustr. Rossboden",,0.000038,109,2,2,4,27561,28085,55646,6,0.294118,0.3775,3408.832353,0,0
8595593,"Chur, Quader Center",,0.000487,109,1,1,2,97746,13364,111110,3,0.5,0.611111,2455.335294,0,0
8594446,"Chur, Sonnenbergstrasse",,0.000034,109,1,1,2,22468,22468,44936,7,0.275,0.364502,0,0,0
8594981,"Chur, Salvatorenstrasse",,0.000047,109,3,3,6,28435,26709,55144,2,0.8,0.875,6778.333333,0,0
8594982,"Chur, Medienhaus",,0.000041,109,2,2,4,11579,13373,24952,2,0.75,0.833333,14.333333,0,0
8595001,"Chur, Boletta",,0.000042,109,2,1,3,26710,13340,40050,2,0.666667,0.75,0,0,0
8595635,"Chur, Medienhaus/Rossboden",,0.000451,109,3,1,4,15482,14716,30198,2,0.666667,0.75,1273.333333,0,0
8594451,"Chur, Turnhalle Sand",,0.000041,109,1,1,2,5160,5158,10318,6,0.285714,0.408333,1977,0,0
8594453,"Etoy, Grosses-Terres",,0.000076,5,2,1,3,9463,6259,15722,2,0.666667,0.75,139.452381,0,0
8594455,"Mendrisio, S. Martino",,0.000211,99,3,1,4,29283,17972,47255,1,1,1,208,0,0
8594463,"Chur, Fondeiweg",,0.000043,109,1,1,2,10973,10360,21333,6,0.285714,0.408333,1956,0,0
8594501,"Leukerbad, City",,0.000021,40,1,1,2,3171,3171,6342,9,0.2,0.31433,92,0,0
8594502,"Leukerbad, Schulen",,0.000029,40,1,1,2,3171,3171,6342,8,0.222222,0.339732,77,0,0
8594503,"Leukerbad, Gemmi-Bahnen",,0.000036,40,1,1,2,3171,3171,6342,7,0.25,0.370408,60,0,0
8594504,"Leukerbad, La Bohème",,0.000041,40,1,1,2,3171,3171,6342,6,0.285714,0.408333,41,0,0
8594506,"Leukerbad, Obere Maressen",,0.000061,40,2,1,3,6340,3169,9509,4,0.4,0.520833,112,0,0
8594507,"Leukerbad, Lärchenwald",,0.000062,40,1,1,2,3169,3169,6338,3,0.5,0.611111,87,0,0
8594508,"Leukerbad, Torrent-Bahnen",,0.000064,40,1,1,2,3169,3169,6338,2,0.666667,0.75,60,0,0
8594509,"Leukerbad, Bristol",,0.000065,40,1,1,2,3169,3169,6338,1,1,1,31,0,0
8594539,"Wetzikon ZH, Kastellstrasse",,0.000044,84,2,1,3,2640,2640,5280,4,0.4,0.520833,2136,0,0
8594540,"Wetzikon ZH, Motorenstrasse",,0.000048,84,1,1,2,2640,2640,5280,3,0.5,0.611111,1605,0,0
8594541,"Wetzikon ZH, Schönau",,0.000052,84,1,1,2,2640,2640,5280,2,0.666667,0.75,1072,0,0
8594542,"Wetzikon ZH, Uster-/Weststr.",,0.000055,84,1,1,2,2640,2640,5280,1,1,1,537,0,0
8594544,"Ecuvillens, Route de Posieux",,0.000118,126,2,1,3,18584,2539,21123,4,0.4,0.520833,2880,0,0
8594587,Tennis,,0.000053,134,2,2,4,1908,2671,4579,3,0.571429,0.708333,1274,0,0
8594588,Joux-Pelichet,,0.000034,134,1,1,2,1336,1336,2672,3,0.5,0.611111,0,0,0
8594590,"Altstätten SG, Ergeten",,0.00005,73,1,1,2,890,890,1780,2,0.666667,0.75,3104,0,0
8594591,"Altstätten SG, Breite",,0.000053,73,1,1,2,890,743,1633,1,1,1,1553,0,0
8594597,"Hauterive NE, poste",,0.000131,48,3,1,4,48381,48360,96741,1,1,1,1174,0,0
8594602,Riveraine,,0.000181,48,3,1,4,26689,13162,39851,1,1,1,1180,0,0
8594607,"Sierre, Bonne Eau",,0.000107,39,2,2,4,18014,18014,36028,10,0.185567,0.298501,4965,0,0
8594608,"Sierre, Glariers",,0.000056,39,1,1,2,16534,16534,33068,9,0.195122,0.262822,3969,0,0
8594609,"Sierre, Les Tours",,0.000059,39,1,1,2,16534,16534,33068,8,0.227273,0.296746,3644,0,0
8594610,"Sierre, Potence",,0.000061,39,1,1,2,16534,16534,33068,7,0.27451,0.354252,3317,0,0
8594617,"Sierre, Roussier",,0.000038,39,1,1,2,8281,8281,16562,2,0.666667,0.75,79,0,0
8594613,"Noës, Champsabé",,0.000056,39,1,1,2,1480,1480,2960,1,1,1,334,0,0
8595130,"Sierre, Ile Falcon",,0.000061,39,2,1,3,16535,16208,32743,1,1,1,10,0,0
8594615,"Sierre, Hôtel de Ville/gare",,0.000074,39,3,3,6,24256,24256,48512,5,0.387097,0.516667,3416.066667,0,0
8594624,"Sierre, Muraz Ecole",,0.000051,39,1,1,2,8088,8088,16176,3,0.5,0.611111,12,0,0
8594616,"Sierre, Pilette",,0.000032,39,1,1,2,8281,8281,16562,3,0.5,0.611111,423,0,0
8594620,"Sierre, Piscine Guillamo",,0.000032,39,1,1,2,7889,8088,15977,7,0.25,0.370408,1384,0,0
8594621,"Sierre, Maison Rose",,0.000038,39,1,1,2,8088,8088,16176,6,0.285714,0.408333,1044,0,0
8594622,"Sierre, Tservetta",,0.000043,39,1,1,2,8088,8088,16176,5,0.333333,0.456667,702,0,0
8594623,"Sierre, Muraz Riondaz",,0.000048,39,1,1,2,8088,8088,16176,4,0.4,0.520833,358,0,0
8594625,"Sierre, Muraz Funi",,0.000075,39,2,1,3,16174,8086,24260,2,0.666667,0.75,593.066667,0,0
8594630,"Sierre, Maison Rouge",,0.000026,39,2,1,3,16223,16223,32446,3,0.5,0.611111,132,0,0
8594631,"Sierre, Devin",,0.000033,39,1,1,2,16223,16223,32446,2,0.666667,0.75,90,0,0
8594632,"Sierre, Itagne",,0.000039,39,1,1,2,16223,16223,32446,1,1,1,46,0,0
8594633,"Sierre, Petit Lac",,0.000031,39,2,1,3,2829,1992,4821,2,0.666667,0.75,65,0,0
8594639,"Lajoux JU, Le Bois des Joux",,0.000176,1,4,1,5,4410,2710,7120,1,1,1,70,0,0
8594643,"Uetikon am See,Binzigerstrasse",,0.000028,84,1,1,2,2135,2135,4270,2,0.666667,0.75,36,0,0
8594644,"Uetikon am See, Forbüelstrasse",,0.000035,84,1,1,2,2135,2135,4270,1,1,1,19,0,0
8594688,"Les Collons, Trabanta",,0.000128,39,2,1,3,1383,1383,2766,9,0.2,0.31433,2184,0,0
8594689,"Les Masses, centre",,0.00012,39,1,1,2,1383,1383,2766,8,0.222222,0.339732,1828,0,0
8594690,"Les Masses, Chémô",,0.000113,39,1,1,2,1383,1383,2766,7,0.25,0.370408,1470,0,0
8594691,"Les Masses, Darbelenne",,0.000107,39,1,1,2,1383,1383,2766,6,0.285714,0.408333,1110,0,0
8594692,"Les Masses, Ferme Pédagogique",,0.000102,39,1,1,2,1383,1383,2766,5,0.333333,0.456667,748,0,0
8594693,"Les Masses, La Brecca",,0.000097,39,1,1,2,1383,1383,2766,4,0.4,0.520833,384,0,0
8594694,"Crans-s.-S., Crans Forest",,0.000016,39,1,1,2,8944,8944,17888,7,0.27907,0.361905,148,0,0
8594695,"Crans-s.-S., Dent-Blanche",,0.000018,39,1,1,2,725,725,1450,6,0.259259,0.37381,256,0,0
8594696,"Crans-s.-S., Devins",,0.000026,39,1,1,2,725,725,1450,5,0.3,0.413889,134,0,0
8594697,"Crans-s.-S., Les Ehripis",,0.00005,39,3,2,5,8924,8924,17848,7,0.26087,0.351455,796,0,0
8594700,"Crans-s.-S., Plans Mayens",,0.000033,39,1,1,2,725,725,1450,4,0.357143,0.466667,10,0,0
8594698,"Crans-s.-S., Maroz",,0.000032,39,1,1,2,4299,4299,8598,6,0.285714,0.359722,169,0,0
8594703,"Crans-s.-S., Sport Club",,0.000061,39,2,1,3,5350,4625,9975,3,0.444444,0.541667,363,0,0
8594711,"Montana, Clinique Lucernoise",,0.000084,39,3,1,4,7374,1287,8661,1,1,1,82.833333,0,0
8594712,"Montana, Grand Signal",,0.000046,39,2,1,3,4299,4299,8598,4,0.4,0.520833,620,0,0
8594713,"Montana, Lac Moubra",,0.000084,39,2,2,4,5366,5366,10732,1,1,1,304,0,0
8594716,"Montana, Primeroses",,0.000047,39,1,1,2,4625,4625,9250,1,1,1,0,0,0
8594717,"Montana, Résidence Forêt",,0.00005,39,1,1,2,4299,4299,8598,3,0.5,0.611111,468,0,0
8594718,"Montana, Vermala Soleil",,0.000053,39,1,1,2,4299,4299,8598,2,0.666667,0.75,314,0,0
8594719,"Montana, Vermala Centre",,0.000056,39,1,1,2,4299,4299,8598,1,1,1,158,0,0
8594722,"Haltikon, Kapelle",,0.000082,91,1,1,2,6113,6125,12238,2,0.666667,0.75,738,0,0
8594776,"Bad Ragaz, Casino",,0.000051,73,1,1,2,29,29,58,6,0.285714,0.408333,2911.248366,0,0
8594780,"Hägendorf, Halbrüti",,0.000086,94,3,1,4,14406,14409,28815,1,1,1,143,0,0
8594781,"Givisiez, rte Stephan",,0.000171,126,4,1,5,59333,49243,108576,2,0.6,0.666667,4322.378788,0,0
8594784,"Boltigen, Garstatt",,0.000048,13,1,1,2,1952,1952,3904,6,0.285714,0.408333,966,0,0
8594785,"Grubenwald, Cholplatz",,0.000052,13,1,1,2,1952,1952,3904,5,0.333333,0.456667,810,0,0
8594786,"Zweisimmen, Spitz Mannried",,0.000055,13,1,1,2,1952,1952,3904,4,0.4,0.520833,652,0,0
8594787,"Zweisimmen, Burg Mannried",,0.000058,13,1,1,2,1952,1952,3904,3,0.5,0.611111,492,0,0
8594788,"Zweisimmen, Forellensee",,0.00006,13,1,1,2,1952,1952,3904,2,0.666667,0.75,330,0,0
8594846,"Nottwil, Oberdorf",,0.000093,92,1,1,2,1775,875,2650,1,1,1,192,0,0
8595202,"Nyon, Terre-Bonne sud",,0.000061,125,2,1,3,10765,10764,21529,2,0.6,0.666667,28.928788,0,0
8595596,"Nyon, Fontaine",,0.000068,125,3,2,5,28099,28087,56186,2,0.75,0.833333,154.872727,0,0
8594848,"Lenk, Mühleweidli",,0.000048,23,2,1,3,1867,1965,3832,7,0.228571,0.341964,240,0,0
8594849,"Lenk, Innere Bleiken",,0.000052,23,1,1,2,1965,1965,3930,6,0.259259,0.37381,217,0,0
8594850,"Lenk, Reitzentrum",,0.000055,23,1,1,2,1965,1965,3930,5,0.3,0.413889,192,0,0
8594851,"Lenk, Äussere Bleiken",,0.000058,23,1,1,2,1965,1965,3930,4,0.357143,0.466667,165,0,0
8594852,"Lenk, Schadauli",,0.00006,23,1,1,2,1965,1965,3930,3,0.444444,0.541667,136,0,0
8594853,"Lenk, Lischmatte",,0.000062,23,1,1,2,1965,1965,3930,2,0.6,0.666667,105,0,0
8594854,"Lenk, Honeggli",,0.000063,23,1,2,3,1965,1965,3930,1,1,1,72,0,0
8594855,"Lenk, Waldrand",,0.000038,23,1,1,2,1337,78,1415,1,1,1,0,0,0
8594856,"Rizenbach, Lerchenhubel",,0.000067,126,2,1,3,5821,5821,11642,8,0.222222,0.339732,1365,0,0
8594861,"Auvernier, gare",,0.000062,48,2,1,3,12975,12975,25950,8,0.244444,0.345563,5131.928571,0,0
8594870,Perreuses,,0.000104,48,4,2,6,13296,13274,26570,6,0.333333,0.49375,3980.5,0,0
8594871,Sources,,0.000055,48,1,1,2,6330,6330,12660,6,0.304348,0.421429,0,0,0
8594875,Cimetière,,0.000153,48,2,1,3,13726,13622,27348,3,0.5,0.611111,3549,0,0
8594877,Fornachon,,0.000141,48,1,1,2,13622,13411,27033,2,0.666667,0.75,2368,0,0
8594878,Placeules,,0.00013,48,1,1,2,13411,12917,26328,1,1,1,1185,0,0
8594890,"Ecublens VD, Montaney",,0.000038,5,1,1,2,30661,30667,61328,1,1,1,557,0,0
8594905,"Kreuzlingen, Kantonsschule",,0.000098,65,2,1,3,5235,614,5849,1,1,1,234,0,0
8594919,"Lenk, Höhe",,0.000034,23,1,1,2,4271,4271,8542,1,1,1,24,0,0
8594923,"Boltigen, Eschi Dorf",,0.000062,13,1,1,2,1952,1952,3904,1,1,1,166,0,0
8594926,Stücki,,0.000204,2,3,1,4,19863,8238,28101,1,1,1,304,0,0
8594931,"Adelboden, Hotel Alpina",,0.000035,43,1,1,2,3464,3464,6928,1,1,1,37,0,0
8594986,"Chavannes-R., Berges",,0.000054,5,1,1,2,33596,33598,67194,1,1,1,580,0,0
8594991,"Maules, bif",,0.000086,13,2,2,4,12091,11987,24078,5,0.368421,0.516667,1393,0,0
8594992,"Sâles, Joretta",,0.000048,13,1,1,2,7758,7862,15620,5,0.333333,0.436111,0,0,0
8594994,Pratteln Bahnhof Nord,,0.000098,2,3,3,6,10135,21612,31747,5,0.392857,0.533333,1188,0,0
8595149,Aegelmatt,,0.000039,2,1,1,2,6818,6818,13636,5,0.344828,0.42,0,0,0
8595150,Altersheim,,0.000071,2,2,3,5,15032,15032,30064,4,0.473684,0.601852,499.5,0,0
8594996,"Ibach, Seilerstrasse",,0.000115,91,5,2,7,7071,8143,15214,1,1,1,672,0,0
8594998,"Weggis, Lindenweg",,0.000061,91,1,1,2,2260,2260,4520,9,0.2,0.31433,789,0,0
8595004,"Lausanne, Entre-Bois",,0.000029,10,2,1,3,26012,26514,52526,1,1,1,518,0,0
8595008,"Anières, Bassy",,0.000046,132,1,1,2,13054,13054,26108,3,0.5,0.611111,1227,0,0
8595009,"Anières, Courson",,0.00005,132,1,1,2,13054,13054,26108,2,0.666667,0.75,820,0,0
8595010,"Anières, mairie",,0.000053,132,1,1,2,13054,13054,26108,1,1,1,411,0,0
8595011,"Avusy, Creux-du-Loup",,0.000054,132,2,1,3,13657,8709,22366,1,1,1,465,0,0
8595028,"Meyrin, mairie",,0.000048,132,1,1,2,21017,21015,42032,3,0.5,0.583333,0,0,0
8595040,"Satigny, Bourdigny-Dessous",,0.000087,132,2,1,3,11925,5853,17778,2,0.666667,0.75,42,0,0
8595029,"Meyrin, gare",,0.000089,132,2,2,4,26407,26397,52804,2,0.75,0.833333,1824,0,0
8595031,"Meyrin, Prulay",,0.000049,132,1,1,2,21006,20996,42002,1,1,1,609,0,0
8595035,"Plan-les-Ouates, Champ-Carré",,0.000117,132,5,1,6,39285,19018,58303,1,1,1,486,0,0
8595037,"Plan-les-Ouates, Pré-Jardinier",,0.000048,132,1,1,2,11539,11539,23078,1,1,1,468,0,0
8595041,"Satigny, Pré-Bouvier",,0.000122,132,2,1,3,11921,11921,23842,1,1,1,610,0,0
8595054,"Orbe, Couronne",,0.000078,35,1,3,4,13189,13126,26315,5,0.409091,0.568519,2416,0,0
8595057,"Orbe, La Croix",,0.000033,35,1,1,2,5252,5252,10504,3,0.5,0.611111,0,0,0
8595055,"Orbe, Dame",,0.000033,35,1,1,2,2619,2610,5229,4,0.4,0.520833,910,0,0
8595060,"Orbe, Penchèvre",,0.000039,35,1,1,2,2610,2681,5291,3,0.5,0.611111,610,0,0
8595061,"Orbe, Plamont",,0.000061,35,2,1,3,10507,5255,15762,2,0.666667,0.75,608,0,0
8595062,"Orbe, route de Valeyres",,0.000063,35,1,1,2,5255,5255,10510,1,1,1,305,0,0
8595063,"Orbe, rue Neuve",,0.000044,35,1,1,2,2681,2681,5362,2,0.666667,0.75,308,0,0
8595066,"Yverdon, chemin de la Chèvre",,0.000054,35,1,1,2,18013,8791,26804,1,1,1,768,0,0
8595204,"Champvent, Le Battoir",,0.00006,35,1,1,2,6254,6255,12509,1,1,1,0,0,0
8595073,"Dietlikon, Fuchshalde",,0.000024,129,1,2,3,5886,5886,11772,5,0.36,0.485185,36,0,0
8595074,"Dietlikon, Hinentalstrasse",,0.000021,129,1,1,2,5650,5650,11300,5,0.333333,0.420833,0,0,0
8595075,"Dietlikon, In Lampitzäckern",,0.000039,129,2,2,4,5886,5886,11772,4,0.4375,0.559524,38,0,0
8595076,"Dietlikon, Klimmweg",,0.000027,129,1,2,3,3061,3296,6357,4,0.461538,0.597222,6,0,0
8595077,"Dietlikon, Lettenstrasse",,0.000039,129,2,2,4,5886,5886,11772,3,0.555556,0.666667,22.5,0,0
8595078,"Dietlikon, Lindenstrasse",,0.000039,129,2,2,4,3296,3296,6592,3,0.571429,0.708333,6.5,0,0
8595081,"Dietlikon, Zentrum",,0.000098,129,3,2,5,25987,6120,32107,1,1,1,986,0,0
8595128,"Dietlikon, Pünten",,0.000053,129,1,1,2,3061,3061,6122,1,1,1,0,0,0
8595090,"Avry-sur-Matran, Les Agges",,0.000082,126,3,2,5,22987,5329,28316,1,1,1,3812,0,0
8595121,"Bulle, Industrie",,0.00007,13,2,1,3,13529,13529,27058,3,0.5,0.611111,1998,0,0
8595123,"Bulle, Les Mosseires",,0.00007,13,1,1,2,13529,13529,27058,2,0.666667,0.75,1334,0,0
8595125,"Bulle, Prila",,0.000071,13,1,1,2,13529,13529,27058,1,1,1,668,0,0
8595133,"Lugano, Università",,0.000259,102,3,1,4,111350,42367,153717,2,0.666667,0.75,872,0,0
8595134,"Lugano, Via Beltramina",,0.000231,102,1,1,2,42367,42367,84734,1,1,1,437,0,0
8595136,Wankdorfbrücke,,0.000121,44,3,1,4,11750,11750,23500,4,0.416667,0.516667,1967.533333,0,0
8595144,"Frutigen, Landi",,0.000065,43,2,1,3,9732,10207,19939,2,0.666667,0.75,114,0,0
8595145,"Frutigen, Tropenhaus",,0.000066,43,1,1,2,10207,10207,20414,1,1,1,58,0,0
8595147,"Cheseaux-s.-Lausanne,Châtelard",,0.000032,5,1,1,2,8368,8368,16736,1,1,1,542,0,0
8595153,Zentrum Grüssen,,0.000059,2,2,2,4,19276,19276,38552,4,0.454545,0.616667,382.5,0,0
8595152,Friedhof Blözen,,0.000031,2,1,1,2,1399,1399,2798,2,0.666667,0.75,222,0,0
8595156,Rosenmatt,,0.000056,2,2,2,4,13633,13633,27266,3,0.571429,0.708333,226.5,0,0
8595155,Meierhofweg,,0.000037,2,1,1,2,1399,1399,2798,1,1,1,112,0,0
8595701,Rührbergweg,,0.00006,2,2,1,3,19276,12696,31972,3,0.5,0.611111,110.5,0,0
8595157,"Vordemwald, Fischerweg",,0.000046,94,1,1,2,7172,7172,14344,4,0.4,0.520833,729,0,0
8595158,"Vordemwald, Grubenweg",,0.00005,94,1,1,2,7172,7172,14344,3,0.5,0.611111,489,0,0
8595159,"Rothrist, Gländ",,0.000053,94,1,1,2,7172,7172,14344,2,0.666667,0.75,247,0,0
8595167,"Teuffenthal, Dorf",,0.000037,43,2,1,3,685,690,1375,1,1,1,251,0,0
8595171,"Coppet, chemin des Rannaux",,0.000066,125,2,1,3,10451,10450,20901,3,0.5,0.611111,128,0,0
8595175,"Eysins, Petit-Eysins",,0.000056,125,2,1,3,10290,10289,20579,1,1,1,26,0,0
8595188,"Sool, alter Löwen",,0.000033,128,1,1,2,3241,3241,6482,1,1,1,119,0,0
8595191,"Pully,Centre Sportif Rochettaz",,0.000052,10,2,1,3,27679,27680,55359,2,0.666667,0.75,716,0,0
8595192,"Pully, Ruisselet",,0.000055,10,1,1,2,27680,13901,41581,1,1,1,359,0,0
8595194,Bureau Communal,,0.000036,49,1,1,2,995,999,1994,6,0.285714,0.408333,1506,0,0
8595195,Le Joratel,,0.000042,49,1,1,2,999,999,1998,5,0.333333,0.456667,1009,0,0
8595196,V-Ch-les-Brandt,,0.000046,49,1,1,2,999,999,1998,4,0.4,0.520833,510,0,0
8595213,"Echandens, collège",,0.000121,5,4,5,9,50653,50658,101311,3,0.666667,0.791667,2077.416667,0,0
8595214,"Bussigny, Bosquet",,0.000031,5,1,1,2,16657,16626,33283,4,0.375,0.458333,0,0,0
8595216,"Bussigny, gare sud",,0.000083,5,3,3,6,36429,34300,70729,2,0.8,0.875,1237.466667,0,0
8595218,"Lonay, gare",,0.000031,5,1,2,3,16035,16031,32066,2,0.75,0.833333,0,0,0
8595217,"Bussigny, Vallon",,0.000034,5,1,1,2,17643,17638,35281,2,0.666667,0.75,0,0,0
8595223,"St-Sulpice VD, Parc Scient.",,0.000082,5,1,1,2,33940,33940,67880,1,1,1,477,0,0
8595225,"Choulex, Champ-Dollon",,0.000067,133,1,1,2,5947,5948,11895,1,1,1,479,0,0
8595226,"Choulex, Jurets",,0.000069,132,1,1,2,19158,19158,38316,1,1,1,408,0,0
8595263,"Kempten, Pfadacher",,0.000133,84,4,1,5,2163,2041,4204,2,0.666667,0.75,1092,0,0
8595264,"Kempten, Schornäglen",,0.000124,84,1,1,2,2041,1607,3648,1,1,1,547,0,0
8595266,"Wetzikon ZH, Zentrum",,0.000063,84,3,1,4,6284,2755,9039,1,1,1,543,0,0
8595369,"Gams, Golfplatz",,0.000128,73,2,1,3,7527,7527,15054,1,1,1,2144,0,0
8595371,"Grabs, Geriäls",,0.00007,73,1,2,3,12682,12682,25364,2,0.666667,0.75,4233,0,0
8595372,"Grabs, Mühlbachstrasse",,0.000041,73,1,1,2,6338,6338,12676,2,0.6,0.666667,0,0,0
8595376,"Oberriet SG, Kobelwald",,0.000061,73,2,2,4,7101,7101,14202,3,0.571429,0.708333,978,0,0
8595381,"Walenstadt, Rathausplatz",,0.000104,124,3,2,5,11903,6428,18331,2,0.75,0.833333,75,0,0
8595383,"Walenstadt, Hafen",,0.000058,124,1,1,2,6209,6209,12418,1,1,1,1,0,0
8595382,"Walenstadt, Fürscht",,0.000055,124,1,1,2,6209,6209,12418,2,0.666667,0.75,26,0,0
8595388,"Algetshausen, Dorf",,0.00007,20,2,1,3,9537,9537,19074,2,0.666667,0.75,388,0,0
8595389,"Henau, Oberberg",,0.00007,20,1,1,2,9537,9537,19074,1,1,1,195,0,0
8595409,"Orbe, Les Moulins",,0.000127,35,2,1,3,22706,20572,43278,1,1,1,804,0,0
8595410,"Orbe, route de Chavornay",,0.000048,35,1,1,2,2681,2600,5281,1,1,1,4,0,0
8595416,Beringen Bahnhof,,0.00002,66,1,2,3,4101,4167,8268,6,0.30303,0.44,50,0,0
8595419,Beringen Oberdorf,,0.000027,66,1,1,2,4000,4000,8000,6,0.266667,0.3625,8,0,0
8595417,Beringen Brandplatz,,0.000019,66,1,1,2,4000,4000,8000,7,0.230769,0.328836,6,0,0
8595420,Beringen Rauhergete,,0.000042,66,2,1,3,4167,4167,8334,5,0.318182,0.409524,56,0,0
8595423,Guntmadingen Dorf,,0.000047,66,1,1,2,4167,3468,7635,4,0.4,0.486111,54,0,0
8595442,"Rorschach, Friedau",,0.000154,72,3,1,4,34231,13442,47673,2,0.666667,0.75,1178,0,0
8595443,"Rorschach, Mühletobelstrasse",,0.000142,72,1,1,2,13442,13442,26884,1,1,1,590,0,0
8595444,Füllinsdorf Ebene,,0.00018,2,2,2,4,28369,22531,50900,2,0.75,0.833333,340.257143,0,0
8595459,"Dussnang, Brückenwaage",,0.000047,20,1,1,2,2747,2747,5494,1,1,1,50,0,0
8595481,"Küssnacht, Rotenhofstrasse",,0.000081,91,1,1,2,6125,6113,12238,1,1,1,370,0,0
8595484,"Visp, Schwimmbad",,0.00015,40,1,1,2,7039,7039,14078,1,1,1,104,0,0
8595502,"Crans VD, Châtillon",,0.000125,125,3,1,4,7710,83,7793,1,1,1,79,0,0
8595516,"Crissier, Mongevon",,0.000038,5,1,1,2,27465,27465,54930,1,1,1,543,0,0
8595521,"Lausanne, Bourdonnette nord",,0.000054,5,1,1,2,39415,39335,78750,2,0.666667,0.75,1160,0,0
8595522,"Diesbach GL, Hauptstrasse",,0.000036,128,1,1,2,1269,1185,2454,1,1,1,145,0,0
8595529,Barzheim Dorf,,0.000113,66,3,1,4,2408,1203,3611,2,0.666667,0.75,138,0,0
8595530,Barzheim Junkholz,,0.000107,66,1,1,2,1203,1203,2406,1,1,1,70,0,0
8595534,"Renens VD, piscine",,0.000057,5,1,1,2,39335,39412,78747,1,1,1,581,0,0
8595539,"Widnau, Bünteli",,0.000066,73,1,1,2,13682,13682,27364,1,1,1,107,0,0
8595541,"Weggis, Kastanienweg",,0.000063,91,1,1,2,2260,2260,4520,8,0.222222,0.339732,427,0,0
8595557,"Heimberg, Aarhölzliweg",,0.000109,43,2,1,3,2159,2159,4318,6,0.285714,0.39375,3264,0,0
8595558,"Heimberg, Bahnhof",,0.000103,43,1,2,3,2159,2159,4318,5,0.35,0.504762,2863,0,0
8595559,"Heimberg, Buechwaldstrasse",,0.000055,43,1,1,2,1079,1079,2158,5,0.315789,0.422222,0,0,0
8595560,"Heimberg, Dornhalde",,0.000101,43,2,1,3,2159,2159,4318,4,0.384615,0.483333,2055,0,0
8595561,"Heimberg, Lädeli",,0.000097,43,1,1,2,2159,2159,4318,3,0.5,0.583333,1648,0,0
8595562,"Heimberg, Laueligrabenweg",,0.000093,43,1,2,3,2159,2159,4318,2,0.75,0.833333,1239,0,0
8595563,"Heimberg, Riedackerstrasse",,0.000051,43,1,1,2,1079,1079,2158,2,0.666667,0.75,0,0,0
8595564,"Heimberg, Sportzentrum",,0.000094,43,2,1,3,2159,2159,4318,1,1,1,415,0,0
8595591,"Chur, Alexanderplatz",,0.00056,109,10,1,11,115013,97746,212759,4,0.4,0.520833,4570.335294,0,0
8595600,Meielen Süd,,0.000071,44,2,1,3,3264,3264,6528,2,0.666667,0.75,2656,0,0
8595604,Oberzollikofen,,0.000071,44,1,1,2,3264,3264,6528,1,1,1,1329,0,0
8595610,"Chevilly, Fontaines",,0.000084,5,2,1,3,4454,4455,8909,3,0.5,0.611111,138,0,0
8595620,"Lenk, Gutenbrunnen",,0.000056,23,2,1,3,1715,1715,3430,4,0.4,0.520833,100,0,0
8595621,"Lenk, Gütsch",,0.000058,23,1,1,2,1715,1715,3430,3,0.5,0.611111,78,0,0
8595622,"Lenk, Lehn",,0.00006,23,1,1,2,1715,1715,3430,2,0.666667,0.75,54,0,0
8595623,"Lenk, Port",,0.000062,23,1,1,2,1715,1715,3430,1,1,1,28,0,0
8595627,"Weggis, Blauweidweg",,0.000091,91,2,1,3,4625,2038,6663,6,0.285714,0.408333,2238,0,0
8595628,"Weggis, Rigistrasse",,0.000088,91,1,1,2,2038,2260,4298,5,0.333333,0.456667,1870,0,0
8595629,"Weggis, Riedsortegg",,0.000086,91,1,1,2,2260,2225,4485,4,0.4,0.520833,1500,0,0
8595630,"Weggis, Lorbeerweg",,0.000084,91,1,1,2,2225,2260,4485,3,0.5,0.611111,1128,0,0
8595631,"Weggis, Lützelaustrasse",,0.000082,91,1,1,2,2260,2260,4520,2,0.666667,0.75,754,0,0
8595632,"Weggis, Buchenweg",,0.000081,91,1,1,2,2260,2260,4520,1,1,1,378,0,0
8595647,"Apples, Fondation Baud",,0.000033,5,1,1,2,4800,4628,9428,1,1,1,59,0,0
8595649,"L'Isle, gare",,0.000134,5,3,1,4,5064,3750,8814,1,1,1,119,0,0
8595654,Neunkirch Bahnhof,,0.000055,66,2,1,3,6441,6441,12882,1,1,1,53,0,0
8595663,"Versoix, Canal de Versoix",,0.000046,135,1,1,2,14324,14319,28643,9,0.2,0.31433,3879,0,0
8595665,"Versoix, Collège du Léman",,0.000105,135,2,1,3,28048,14325,42373,7,0.25,0.370408,3073,0,0
8595666,"Versoix, Saint-Loup",,0.0001,135,1,1,2,14325,14319,28644,6,0.285714,0.408333,2640,0,0
8595667,"Versoix, Richelien",,0.000096,135,1,1,2,14319,14317,28636,5,0.333333,0.456667,2205,0,0
8595668,"Versoix,Observatoire de Genève",,0.000093,135,1,1,2,14317,14325,28642,4,0.4,0.520833,1768,0,0
8595669,"Sauverny, Combes Chapuis",,0.00009,135,1,1,2,14325,14325,28650,3,0.5,0.611111,1329,0,0
8595670,"Sauverny, douane",,0.000087,135,1,1,2,14325,14319,28644,2,0.666667,0.75,888,0,0
8595671,"Sauverny, Martinet",,0.000085,135,1,1,2,14319,14255,28574,1,1,1,445,0,0
8595673,"Meinier, Essert",,0.000053,132,1,1,2,6095,6095,12190,1,1,1,360,0,0
8595679,"Münchenwiler, Bahnhof",,0.000111,126,2,1,3,5947,2482,8429,6,0.285714,0.408333,6976.333333,0,0
8595680,"Courgevaux, village",,0.000105,126,1,1,2,2482,2482,4964,5,0.333333,0.456667,5228.333333,0,0
8595681,"Courlevon, Dorf",,0.0001,126,1,1,2,2482,2482,4964,4,0.4,0.520833,3478.333333,0,0
8595686,"Olten, Rötzmattweg",,0.000066,94,3,1,4,14289,14676,28965,3,0.5,0.583333,298.008333,0,0
8595690,"Grenilles, village",,0.000111,126,1,1,2,2539,2548,5087,3,0.5,0.611111,2163,0,0
8595691,"Posat, village",,0.000105,126,1,1,2,2548,2548,5096,2,0.666667,0.75,1444,0,0
8595692,"Magnedens, village",,0.0001,126,1,1,2,2548,2548,5096,1,1,1,723,0,0
8595700,"Kriessern, Schützenwiese",,0.000093,73,3,1,4,7323,7337,14660,1,1,1,490,0,0
8595702,Chästeli,,0.000085,2,2,1,3,13633,6815,20448,2,0.666667,0.75,228,0,0
8595703,Rütscheten,,0.000084,2,1,1,2,6815,6815,13630,1,1,1,115,0,0
8595710,"Rümlang, Ifangstrasse",,0.000098,85,3,1,4,5459,4934,10393,2,0.666667,0.75,2832,0,0
8595711,"Rümlang, Chilestieg",,0.000094,85,1,1,2,4934,2640,7574,1,1,1,1417,0,0
8595724,"Chur, Kleinbruggen",,0.000475,109,5,1,6,30821,28742,59563,1,1,1,2125,0,0
8595728,"Grandvaux, Genevrey",,0.000123,10,1,1,2,2033,2033,4066,2,0.666667,0.75,1342,0,0
8595729,"Grandvaux, gare sud",,0.000116,10,1,1,2,2033,2033,4066,1,1,1,672,0,0
8595871,"St. Gallen, Schuppisstrasse",,0.000081,71,2,1,3,19989,19989,39978,1,1,1,941,0,0
8595879,"Murten, Museum",,0.00015,126,3,1,4,3007,3007,6014,1,1,1,1764,0,0
8595881,"Davos Dischma, Gadmen",,0.000027,131,1,1,2,1145,1145,2290,1,1,1,1414,0,0
8595933,"Lausanne, Parc Musée Olympique",,0.000036,10,1,1,2,29265,29258,58523,6,0.285714,0.408333,2766,0,0
8595934,"Lausanne, Siège du CIO",,0.000041,10,1,1,2,29258,29264,58522,5,0.333333,0.456667,2310,0,0
8595935,"Lausanne, Stade de Coubertin",,0.000046,10,1,1,2,29264,29266,58530,4,0.4,0.520833,1852,0,0
8595936,"Lausanne, Tour Haldimand-Lac",,0.00005,10,1,1,2,29266,29259,58525,3,0.5,0.611111,1392,0,0
8595937,"Lausanne, sports UNIL-EPFL",,0.000053,10,1,1,2,29259,29265,58524,2,0.666667,0.75,930,0,0
8595938,"Lausanne, Vidy-Port",,0.000056,10,1,1,2,29265,29264,58529,1,1,1,466,0,0
8595950,"Dardagny, Malval-Chapelle",,0.000099,120,2,1,3,11288,11281,22569,1,1,1,397,0,0
8595964,"Port, Bellevue",,0.000128,87,2,1,3,32655,32489,65144,2,0.666667,0.75,2538,0,0
8595965,"Port, Lindenweg",,0.000119,87,1,1,2,32489,32489,64978,1,1,1,1270,0,0
8595979,"Vex, le Croux",,0.000184,39,2,1,3,4551,4551,9102,2,0.666667,0.75,742,0,0
8595980,"Vex, Les Prasses d'en haut",,0.000168,39,1,1,2,4551,3297,7848,1,1,1,372,0,0
8595987,"Olten, Solothurnerstrasse",,0.000188,94,4,1,5,44570,14677,59247,1,1,1,150,0,0
8596009,"Raron, Industrie",,0.000048,40,2,1,3,5376,5376,10752,1,1,1,101,0,0
8596055,"Châbles FR, Béthanie",,0.000048,13,1,1,2,4868,4911,9779,1,1,1,324,0,0
8596059,"Romont FR, école primaire",,0.000098,13,3,1,4,643,498,1141,1,1,1,291.666667,0,0
8596061,"Le Châtelard FR, Pra Mottau",,0.000092,13,1,1,2,5896,5896,11792,2,0.666667,0.75,1440,0,0
8596062,"Le Châtelard FR, La Molleyre",,0.000089,13,1,1,2,5896,5896,11792,1,1,1,721,0,0
8596065,"Vuisternens-dt-Romont, foyer",,0.000119,13,3,2,5,12808,4258,17066,3,0.571429,0.708333,1873.671429,0,0
8596070,"La Neirigue, village",,0.000054,13,2,1,3,1314,623,1937,1,1,1,3,0,0
8596068,"Sommentier, Abri PC",,0.000081,13,2,1,3,4135,4134,8269,2,0.6,0.666667,1392,0,0
8596079,Bifang,,0.000051,66,1,2,3,3468,3468,6936,3,0.555556,0.666667,50,0,0
8596105,Rain,,0.000039,66,1,1,2,1683,1683,3366,3,0.5,0.611111,3,0,0
8596080,Neuweg,,0.000032,66,1,1,2,1683,1683,3366,4,0.4,0.520833,11,0,0
8596101,"Le Locle, gare/centre ville",,0.000561,134,17,1,18,101718,54,101772,1,1,1,712,0,0
8596106,Belvedere,,0.000065,66,2,1,3,3468,1785,5253,2,0.666667,0.75,26,0,0
8596107,Oberstieg,,0.000066,66,1,1,2,1785,1785,3570,1,1,1,14,0,0
8500016,Basel St. Johann,,0.000012,9,1,0,1,11443,0,11443,0,0,0,0,0,0
8500240,Olten RB,,0.000031,9,1,0,1,60,0,60,0,0,0,0,0,0
8500188,Bonfol,,0.000035,9,1,0,1,8033,0,8033,0,0,0,0,0,0
8500268,Grandval,,0.000061,9,1,0,1,9092,0,9092,0,0,0,0,0,0
8518690,Niederbipp Industrie,,0.000123,9,2,0,2,36797,0,36797,0,0,0,0,0,0
8500294,Balsthal,,0.000033,9,1,0,1,13729,0,13729,0,0,0,0,0,0
8517131,Pratteln Salina Raurica,,0.000051,9,2,0,2,21226,0,21226,0,0,0,0,0,0
8519077,St-Cergue Les Cheseaux,,0.000094,4,2,0,2,9451,0,9451,0,0,0,0,0,0
8501096,Bière,,0.000046,4,1,0,1,17084,0,17084,0,0,0,0,0,0
8501099,L'Isle,,0.000057,4,1,0,1,4125,0,4125,0,0,0,0,0,0
8518452,Prilly-Malley,,0.000083,4,5,0,5,28961,0,28961,0,0,0,0,0,0
8530783,Chez-le-Maître-Ecoles,,0.000058,4,1,0,1,9860,0,9860,0,0,0,0,0,0
8587727,Les Ripes,,0.000091,3,3,0,3,21993,0,21993,0,0,0,0,0,0
8530262,St-Eloi,,0.000036,4,1,0,1,4701,0,4701,0,0,0,0,0,0
8530261,Bois-de-Chexbres,,0.000073,4,2,0,2,7001,0,7001,0,0,0,0,0,0
8501371,Caux,,0.000085,4,1,0,1,8727,0,8727,0,0,0,0,0,0
8501725,Versmont,,0.000072,4,2,0,2,9887,0,9887,0,0,0,0,0,0
8501578,Orsières,,0.000052,4,2,0,2,12334,0,12334,0,0,0,0,0,0
8501580,Etiez,,0.000035,4,1,0,1,8755,0,8755,0,0,0,0,0,0
8515296,Brig Bahnhofplatz,,0.000125,28,5,0,5,15045,0,15045,0,0,0,0,0,0
8583808,"Clèbes (Nendaz), Le Fio",,0.000094,39,5,0,5,2377,0,2377,0,0,0,0,0,0
8502122,Kölliken Oberdorf,,0.00004,9,1,0,1,16642,0,16642,0,0,0,0,0,0
8502199,Schöftland,,0.000077,9,1,0,1,34206,0,34206,0,0,0,0,0,0
8502219,Oberrüti,,0.000055,9,1,0,1,19235,0,19235,0,0,0,0,0,0
8517377,Bibenlos-Sonnenhof,,0.000076,9,2,0,2,34891,0,34891,0,0,0,0,0,0
8518459,Steinhausen Rigiblick,,0.000027,9,3,0,3,19363,0,19363,0,0,0,0,0,0
8503099,Sihlau,,0.000081,7,2,0,2,33233,0,33233,0,0,0,0,0,0
8503299,Hurden,,0.000036,9,2,0,2,17363,0,17363,0,0,0,0,0,0
8503240,Linthal Braunwaldbahn,,0.000067,9,1,0,1,10235,0,10235,0,0,0,0,0,0
8589548,"Engi, Landesplattenberg",,0.000086,128,2,0,2,9416,0,9416,0,0,0,0,0,0
8503293,Grüenfeld,,0.000031,9,1,0,1,20391,0,20391,0,0,0,0,0,0
8503319,Niederweningen,,0.000052,9,1,0,1,19318,0,19318,0,0,0,0,0,0
8503415,Rümikon AG,,0.000044,9,1,0,1,17955,0,17955,0,0,0,0,0,0
8518243,Beringerfeld,,0.000025,9,1,0,1,23619,0,23619,0,0,0,0,0,0
8518924,Neuhausen Rheinfall,,0.000025,9,1,0,1,19598,0,19598,0,0,0,0,0,0
8516176,Klingnau,,0.000142,9,4,0,4,22237,0,22237,0,0,0,0,0,0
8516219,Mellingen Heitersberg,,0.000091,9,4,0,4,13519,0,13519,0,0,0,0,0,0
8503529,Würenlos,,0.000046,9,1,0,1,18864,0,18864,0,0,0,0,0,0
8595523,"Elm, Büelstafel",,0.000041,128,1,0,1,852,0,852,0,0,0,0,0,0
8504040,Corseaux-Cornalles,,0.000049,4,1,0,1,9114,0,9114,0,0,0,0,0,0
8519133,Fribourg/Freiburg Poya,,0.000282,11,5,0,5,22602,0,22602,0,0,0,0,0,0
8504288,Buttes,,0.000037,11,1,0,1,16252,0,16252,0,0,0,0,0,0
8530263,Yverdon-les-Bains William Barbey,,0.000063,4,1,0,1,11154,0,11154,0,0,0,0,0,0
8504317,Le Locle-Col-des-Roches,,0.000039,11,1,0,1,3118,0,3118,0,0,0,0,0,0
8504321,La Chaux-de-Fonds Les Forges,,0.000039,11,1,0,1,19163,0,19163,0,0,0,0,0,0
8504355,Magglingen/Macolin,,0.000029,136,2,0,2,6724,0,6724,0,0,0,0,0,0
8530260,Le Locle Le Chalet,,0.000048,11,1,0,1,10139,0,10139,0,0,0,0,0,0
8518749,Lyss Grien,,0.000065,11,2,0,2,9553,0,9553,0,0,0,0,0,0
8596056,"St. Silvester, Fifermoos",,0.000086,126,2,0,2,7605,0,7605,0,0,0,0,0,0
8516353,Baldegg Kloster,,0.000021,9,1,0,1,17670,0,17670,0,0,0,0,0,0
8517336,Luzern Verkehrshaus,,0.000082,9,3,0,3,19300,0,19300,0,0,0,0,0,0
8517519,Stabio,,0.000021,28,1,0,1,17265,0,17265,0,0,0,0,0,0
8518475,Mendrisio S. Martino,,0.000085,28,3,0,3,30189,0,30189,0,0,0,0,0,0
8587321,"Schöfflisdorf-O'weningen, Bhf.",,0.000049,79,2,0,2,4097,0,4097,0,0,0,0,0,0
8505374,Monte Generoso Vetta,,0.000044,28,1,0,1,2199,0,2199,0,0,0,0,0,0
8505599,Verigo,,0.000093,15,1,0,1,926,0,926,0,0,0,0,0,0
8507230,"Rivera, Passo del Ceneri",,0.000017,102,1,0,1,3246,0,3246,0,0,0,0,0,0
8573086,"Amsteg, St. Anton",,0.000048,93,1,0,1,1436,0,1436,0,0,0,0,0,0
8506009,Saland,,0.000031,9,1,0,1,19495,0,19495,0,0,0,0,0,0
8506044,Winterthur Töss,,0.00005,9,1,0,1,19362,0,19362,0,0,0,0,0,0
8506049,Dachsen,,0.000082,9,1,0,1,19523,0,19523,0,0,0,0,0,0
8588122,Landschlacht,,0.000079,18,2,0,2,18908,0,18908,0,0,0,0,0,0
8506198,Tägerwilen Dorf,,0.000053,18,1,0,1,34975,0,34975,0,0,0,0,0,0
8516218,Winterthur Hegi,,0.000096,18,1,0,1,19833,0,19833,0,0,0,0,0,0
8506351,Ruderbach,,0.000035,18,1,0,1,12514,0,12514,0,0,0,0,0,0
8506400,Sandbüchel,,0.000053,18,1,0,1,7827,0,7827,0,0,0,0,0,0
8506389,Alter Zoll,,0.000059,18,1,0,1,6539,0,6539,0,0,0,0,0,0
8506506,"St. Stephan, Lengebrand",,0.000063,19,1,0,1,1190,0,1190,0,0,0,0,0,0
8573225,"Embrach, Oberdorf",,0.000031,107,2,0,2,8689,0,8689,0,0,0,0,0.000013,0
8516154,Bern Brünnen Westside,,0.000038,11,1,0,1,34699,0,34699,0,0,0,0,0,0
8507095,Schwarzwasserbrücke,,0.000068,11,1,0,1,17949,0,17949,0,0,0,0,0,0
8507169,Interlaken West (See),,0.000086,21,2,0,2,1399,0,1399,0,0,0,0,0,0
8507560,Winteregg,,0.000028,137,1,0,1,11439,0,11439,0,0,0,0,0,0
8507552,Brandegg,,0.000032,11,1,0,1,8008,0,8008,0,0,0,0,0,0
8507555,Wengwald,,0.000038,11,2,0,2,17058,0,17058,0,0,0,0,0,0
8507493,Interlaken West,,0.000057,11,1,0,1,18475,0,18475,0,0,0,0,0,0
8595380,"Unterterzen, Bahnhof",,0.000062,124,3,0,3,20805,0,20805,0,0,0,0,0,0
8571409,"Riggisberg, Abegg-Stiftung",,0.000026,44,1,0,1,247,0,247,0,0,0,0,0,0
8508055,Unterzollikofen,,0.000043,11,1,0,1,29572,0,29572,0,0,0,0,0,0
8589198,Worbboden,,0.000043,11,1,0,1,34567,0,34567,0,0,0,0,0,0
8508071,Schönbühl Shoppyland,,0.000113,11,1,0,1,34768,0,34768,0,0,0,0,0,0
8508103,Rothrist,,0.000044,9,1,0,1,15747,0,15747,0,0,0,0,0,0
8594258,Langenthal Industrie Nord,,0.000056,9,1,0,1,18105,0,18105,0,0,0,0,0,0
8508272,Sumiswald-Grünen,,0.000071,11,2,0,2,18372,0,18372,0,0,0,0,0,0
8516354,Wolhusen Weid,,0.00012,9,1,0,1,17338,0,17338,0,0,0,0,0,0
8508329,Brienz West,,0.000095,11,2,0,2,9215,0,9215,0,0,0,0,0,0
8516351,Kriens Mattenhof,,0.000146,9,6,0,6,42754,0,42754,0,0,0,0,0,0
8508352,Brienzer Rothorn,,0.000028,24,1,0,1,1532,0,1532,0,0,0,0,0,0
8508379,Iseltwald (See),,0.000057,25,1,0,1,1211,0,1211,0,0,0,0,0,0
8508458,Alpnachstad PB,,0.000028,26,1,0,1,2990,0,2990,0,0,0,0,0,0
8508503,Alpnachstad (See),,0.000105,27,1,0,1,781,0,781,0,0,0,0,0,0
8508504,Meggenhorn,,0.000105,27,1,0,1,268,0,268,0,0,0,0,0,0
8580011,"Flüeli-Ranft, Allmend",,0.000054,62,2,0,2,2716,0,2716,0,0,0,0,0,0
8582984,"Messen, Dorfplatz",,0.000085,87,4,0,4,2215,0,2215,0,0,0,0,0,0
8509269,Sagliains,,0.000122,28,3,0,3,17459,0,17459,0,0,0,0,0,0
8509157,Arosa,,0.000052,28,1,0,1,8371,0,8371,0,0,0,0,0,0
8519370,Bernina Diavolezza,,0.000126,28,2,0,2,7541,0,7541,0,0,0,0,0,0
8509418,Mühlehorn,,0.000117,28,1,0,1,9524,0,9524,0,0,0,0,0,0
8574573,"Vadura, Abzw. Bläs",,0.000056,109,2,0,2,4986,0,4986,0,0,0,0,0,0
8574678,"Tamins, Oberdorf",,0.000012,109,1,0,1,225,0,225,0,0,0,0,0,0
8574516,"Ramosch, Fermada",,0.000029,29,2,0,2,3174,0,3174,0,0,0,0,0,0
8575098,"Morissen, Cuschnaus",,0.000045,78,2,0,2,3409,0,3409,0,0,0,0,0,0
8588460,"Gersau, Brand",,0.000069,91,1,0,1,3185,0,3185,0,0,0,0,0,0
8572939,"Stans, Pilatuswerke",,0.000021,90,1,0,1,1675,0,1675,0,0,0,0,0,0
8510200,"Düdingen, Chännelmatt",,0.000032,126,1,0,1,7491,0,7491,0,0,0,0,0,0
8516350,Buchrain,,0.000069,9,1,0,1,19799,0,19799,0,0,0,0,0,0
8516271,Steinach,,0.000041,18,1,0,1,19588,0,19588,0,0,0,0,0,0
8517142,Lancy-Bachet,,0.000082,4,2,0,2,38630,0,38630,0,0,0,0,0,0
8519685,Aarau Torfeld,,0.000078,9,1,0,1,33093,0,33093,0,0,0,0,0,0
8517527,Zug Casino,,0.000071,9,1,0,1,16793,0,16793,0,0,0,0,0,0
8519306,St. Gallen Güterbahnhof,,0.000096,18,1,0,1,25332,0,25332,0,0,0,0,0,0
8518963,Solothurn Allmend,,0.000039,11,1,0,1,19169,0,19169,0,0,0,0,0,0
8530225,Le Stand,,0.000075,11,1,0,1,8775,0,8775,0,0,0,0,0,0
8595488,Gümligen Bahnhof,,0.00008,44,4,0,4,26365,0,26365,0,0,0,0,0,0
8530334,La Médettaz,,0.00007,4,1,0,1,10246,0,10246,0,0,0,0,0,0
8593467,Pont de Fayot,,0.0001,4,1,0,1,9253,0,9253,0,0,0,0,0,0
8530614,Furka DFB,,0.000039,28,1,0,1,144,0,144,0,0,0,0,0,0
8595245,Areuse Littorail,,0.000067,31,1,0,1,21440,0,21440,0,0,0,0,0,0
8530790,Sorengo Laghetto,,0.000062,14,1,0,1,31021,0,31021,0,0,0,0,0,0
8530801,Aareschlucht Ost (Bahn),,0.000067,11,1,0,1,4650,0,4650,0,0,0,0,0,0
8578808,"St. Pelagiberg, Kurhaus",,0.000075,121,2,0,2,3804,0,3804,0,0,0,0,0,0
8583896,"Pizy, village",,0.000109,32,2,0,2,804,0,804,0,0,0,0,0,0
8583710,"St-Livres, grande salle",,0.000038,5,2,0,2,5618,0,5618,0,0,0,0,0,0
8582737,"Cossonay, La Condémine",,0.000033,5,2,0,2,7421,0,7421,0,0,0,0,0,0
8595650,"Montricher, Grand Faubourg",,0.000083,33,3,0,3,6376,0,6376,0,0,0,0,0,0
8570162,"Pompaples, La Colline",,0.000043,5,1,0,1,4196,0,4196,0,0,0,0,0,0
8584678,"Vaulion, collège",,0.000032,34,1,0,1,270,0,270,0,0,0,0,0,0
8570225,"Romainmôtier, Les Portes",,0.000038,34,1,0,1,2159,0,2159,0,0,0,0,0,0
8583673,"Daillens, Les Montets",,0.000039,35,1,0,1,3783,0,3783,0,0,0,0,0,0
8578927,"Palézieux, zone ind. En Grivaz",,0.00002,13,1,0,1,700,0,700,0,0,0,0,0,0
8581898,"Villarsel-le-Gibloux, Bugnon",,0.000058,13,2,0,2,2242,0,2242,0,0,0,0,0,0
8596072,"Lugnorre, école",,0.000047,126,2,0,2,2975,0,2975,0,0,0,0,0,0
8570615,"Plambuit, Hameau",,0.000058,103,1,0,1,325,0,325,0,0,0,0,0,0
8575219,"Bex, Servanne",,0.00005,103,2,0,2,460,0,460,0,0,0,0,0,0
8581558,"St-Maurice VS, Midi",,0.000064,37,2,0,2,1292,0,1292,0,0,0,0,0,0
8580527,"Savièse, Chervignine",,0.000043,39,1,0,1,29,0,29,0,0,0,0,0,0
8582963,"Luc (Ayent), Les Râches",,0.000092,39,3,0,3,4085,0,4085,0,0,0,0,0,0
8582614,"Fey (Nendaz), Le Dinto",,0.000103,39,2,0,2,499,0,499,0,0,0,0,0,0
8570923,"La Sage, Prafleuri",,0.000066,39,1,0,1,179,0,179,0,0,0,0,0,0
8581724,"Visp, Forsthaus",,0.000143,40,5,0,5,5934,0,5934,0,0,0,0,0,0
8580927,"Köniz, Bahnhof",,0.00006,44,3,0,3,4702,0,4702,0,0,0,0,0,0
8584748,"Lüterswil, Mehrzweckhalle",,0.000035,87,2,0,2,211,0,211,0,0,0,0,0,0
8588907,"Rüegsbach, Oberrinderbach",,0.000051,45,2,0,2,7023,0,7023,0,0,0,0,0,0
8595141,"Huttwil, Feuerwehrmagazin",,0.000026,45,1,0,1,236,0,236,0,0,0,0,0,0
8582258,"Gadmen, Tällibahn",,0.0001,114,2,0,2,2589,0,2589,0,0,0,0,0,0
8584586,"Innertkirchen, Kraftwerk (Bus)",,0.000059,114,2,0,2,1890,0,1890,0,0,0,0,0,0
8590116,Belp Greulebach,,0.000017,100,1,0,1,6427,0,6427,0,0,0,0,0,0
8571650,"Hinterfultigen, Sonnhalde",,0.000056,44,1,0,1,2521,0,2521,0,0,0,0,0,0
8571657,"Wattenwil, Grundbach",,0.000042,43,1,0,1,1662,0,1662,0,0,0,0,0,0
8582070,"Riggisberg, Beissern",,0.000155,126,4,0,4,6452,0,6452,0,0,0,0,0,0
8571737,Utzigen,,0.000038,47,1,0,1,7437,0,7437,0,0,0,0,0,0
8579894,"Enggistein, Dorf",,0.000098,100,2,0,2,8147,0,8147,0,0,0,0,0,0
8582597,"Lützelflüh-Goldbach,alte Hueti",,0.000082,100,2,0,2,2215,0,2215,0,0,0,0,0,0
8583814,"Saignelégier, Bellevue",,0.000085,1,2,0,2,1426,0,1426,0,0,0,0,0,0
8583786,"Sornetan, Le Pichoux",,0.000115,1,2,0,2,1862,0,1862,0,0,0,0,0,0
8583308,"Réclère, Les Grottes",,0.00005,51,1,0,1,376,0,376,0,0,0,0,0,0
8582986,"Fontenais, les Rochets",,0.000059,50,2,0,2,5880,0,5880,0,0,0,0,0,0
8583311,"Röschenz, In der Eich",,0.000036,54,1,0,1,748,0,748,0,0,0,0,0,0
8583300,"Metzerlen, Burgstrasse",,0.000057,54,1,0,1,1154,0,1154,0,0,0,0,0,0
8580942,"Liesberg, Bebrunnenmatten",,0.000129,54,3,0,3,5632,0,5632,0,0,0,0,0,0
8581849,"Laufen, Stedtli",,0.0001,54,3,0,3,6204,0,6204,0,0,0,0,0,0
8582142,"Ormalingen, Zwischbach",,0.000091,55,2,0,2,3879,0,3879,0,0,0,0,0,0
8572312,"Zeglingen, Oberdorf",,0.000088,55,1,0,1,5046,0,5046,0,0,0,0,0,0
8572324,"Ramiswil, Alpenblick",,0.000047,94,1,0,1,937,0,937,0,0,0,0,0,0
8572460,"Zeihen, Dorf",,0.000051,57,1,0,1,6055,0,6055,0,0,0,0,0,0
8572488,"Rüfenach AG, Schulhaus",,0.000052,57,1,0,1,5937,0,5937,0,0,0,0,0,0
8582955,"Villigen, Gemeindehaus",,0.000052,57,2,0,2,8035,0,8035,0,0,0,0,0,0
8580326,"Würenlingen, Bachstrasse",,0.000081,57,4,0,4,6700,0,6700,0,0,0,0,0,0
8581749,"Brugg AG, Bahnhof/Campus",,0.000138,22,5,0,5,24855,0,24855,0,0,0,0,0.00003,0
8581109,"Kleindöttingen, Schwächeler",,0.000115,57,3,0,3,10997,0,10997,0,0,0,0,0,0
8572650,"Schlossrued, Pfaffenbergstr.",,0.000041,59,1,0,1,4602,0,4602,0,0,0,0,0,0
8590161,"Aarburg, Stadtgarten",,0.000107,94,2,0,2,20160,0,20160,0,0,0,0,0,0
8579699,"Langnau bei Reiden, Feld",,0.000044,94,1,0,1,7597,0,7597,0,0,0,0,0,0
8580333,"Zofingen, Untere Brühlstrasse",,0.000046,94,1,0,1,3358,0,3358,0,0,0,0,0,0
8593493,"Strengelbach, Kath. Kirche",,0.000085,94,2,0,2,5426,0,5426,0,0,0,0,0,0
8595512,"Rothrist, Breitenpark",,0.000157,94,3,0,3,15004,0,15004,0,0,0,0,0,0
8582522,"Eiken, Industriezone Rütti",,0.000026,57,1,0,1,657,0,657,0,0,0,0,0,0
8581976,"Dagmersellen, Industriepark",,0.000077,59,3,0,3,8332,0,8332,0,0,0,0,0,0
8581591,Chappelbodenbrücke,,0.000079,92,2,0,2,2895,0,2895,0,0,0,0,0,0
8583236,"Sörenberg, Höchistrasse",,0.000108,92,3,0,3,3167,0,3167,0,0,0,0,0,0
8580597,"Stansstad, Schule",,0.000078,62,2,0,2,3350,0,3350,0,0,0,0,0,0
8582755,"Knutwil, Dorf",,0.000077,59,3,0,3,4878,0,4878,0,0,0,0,0,0
8583562,"Sempach Stadt, Hültschern",,0.000286,59,6,0,6,17061,0,17061,0,0,0,0,0,0
8573190,"Baar, Bahnmatt",,0.000058,115,1,0,1,1987,0,1987,0,0,0,0,0,0
8580722,Oerlingen,,0.000024,66,1,0,1,4004,0,4004,0,0,0,0,0,0
8580296,"Oberneunforn, Langmüli",,0.000026,65,1,0,1,4237,0,4237,0,0,0,0,0,0
8576750,"Freienstein, Friedhof Federen",,0.000026,107,1,0,1,8035,0,8035,0,0,0,0,0,0
8582751,"Riedt bei Neerach, Storchen",,0.000045,107,1,0,1,260,0,260,0,0,0,0,0,0
8594552,"Dielsdorf, Ruchwiesen",,0.000047,107,2,0,2,4721,0,4721,0,0,0,0,0.000009,0
8582826,"Diessenhofen, Landi",,0.000061,65,2,0,2,7042,0,7042,0,0,0,0,0,0
8594733,"Frauenfeld, Kantonsschule",,0.000033,65,1,0,1,117,0,117,0,0,0,0,0,0
8573434,"Rheinau, Galgenbuck",,0.000041,66,1,0,1,6009,0,6009,0,0,0,0,0,0
8573438,Truttikon,,0.000033,66,1,0,1,4004,0,4004,0,0,0,0,0,0
8582052,"Schloss Laufen, Rheinfall",,0.000051,66,2,0,2,3390,0,3390,0,0,0,0,0,0
8583869,"Russikon, Dorf",,0.000037,84,1,0,1,6171,0,6171,0,0,0,0,0,0
8590655,"Horgen, Panorama/CS",,0.000043,63,2,0,2,420,0,420,0,0,0,0,0,0
8586294,"Les Mosses, village",,0.000109,36,1,0,1,831,0,831,0,0,0,0,0,0
8583830,"Humlikon, Dorfplatz",,0.000078,68,3,0,3,9075,0,9075,0,0,0,0,0,0
8582622,"Einsiedeln,Altersheim Langrüti",,0.000022,69,1,0,1,2135,0,2135,0,0,0,0,0,0
8573799,"Innerthal, Staumauer",,0.000049,67,1,0,1,4205,0,4205,0,0,0,0,0,0
8591867,"Gossau SG, Ulmenstrasse",,0.000088,71,3,0,3,16476,0,16476,0,0,0,0,0,0
8573990,"Mühlrüti, Dorf",,0.000054,70,1,0,1,5371,0,5371,0,0,0,0,0,0
8573998,"Mosnang, Dietenwil",,0.000059,70,1,0,1,4974,0,4974,0,0,0,0,0,0
8574046,"Ennetbühl, Schiltmoos",,0.000042,73,1,0,1,2871,0,2871,0,0,0,0,0,0
8580393,"St-Martin VS, Liez",,0.000051,39,2,0,2,247,0,247,0,0,0,0,0,0
8581840,"Walzenhausen, Almendsberg",,0.000139,72,2,0,2,989,0,989,0,0,0,0,0,0
8581030,"Bächli, Harzenmoos",,0.000067,71,1,0,1,2226,0,2226,0,0,0,0,0,0
8574235,"Waldkirch, Fillisweid",,0.000048,71,1,0,1,2609,0,2609,0,0,0,0,0,0
8585182,"Gommiswald, Schulhaus",,0.000066,67,2,0,2,1660,0,1660,0,0,0,0,0,0
8574479,"Uetliburg SG, Giegen",,0.000031,67,1,0,1,5841,0,5841,0,0,0,0,0,0
8583511,"Benken SG, Schönau",,0.000066,67,2,0,2,5003,0,5003,0,0,0,0,0,0
8574541,"Guarda, cumün",,0.000028,138,1,0,1,4697,0,4697,0,0,0,0,0,0
8574665,"Vaz/Obervaz, Zorten",,0.000061,131,1,0,1,4005,0,4005,0,0,0,0,0,0
8581818,"Tschlin, Terza Storta",,0.000035,74,1,0,1,1588,0,1588,0,0,0,0,0,0
8581480,"Flums, Kirchplatz",,0.000037,124,1,0,1,318,0,318,0,0,0,0,0,0
8581991,"Poschiavo, Curtinell",,0.000058,76,1,0,1,287,0,287,0,0,0,0,0,0
8579821,"Necker, Grütli",,0.000096,97,2,0,2,4680,0,4680,0,0,0,0,0,0
8583426,"Disentis/Mustér, Salaplauna",,0.000072,108,2,0,2,2004,0,2004,0,0,0,0,0,0
8595909,"St. Moritz Bad, Hallenbad",,0.000236,30,10,0,10,21058,0,21058,0,0,0,0,0,0
8582063,"Promontogno, Punt Spizarun",,0.00005,77,1,0,1,78,0,78,0,0,0,0,0,0
8575100,"Degen, Rampa",,0.000048,78,1,0,1,1206,0,1206,0,0,0,0,0,0
8581568,"Luven, Sut vitg",,0.000029,110,1,0,1,1195,0,1195,0,0,0,0,0,0
8582418,"Gravesano, Vallone",,0.000222,102,6,0,6,9322,0,9322,0,0,0,0,0,0
8575402,"Vernate, Villa Bischoff",,0.000048,81,1,0,1,8221,0,8221,0,0,0,0,0,0
8580676,"Bogno, Magnan",,0.000092,80,1,0,1,6279,0,6279,0,0,0,0,0,0
8580749,"Vergeletto, Funivia Salei",,0.000063,101,2,0,2,1134,0,1134,0,0,0,0,0,0
8581163,"Gerra (Gambarogno), Stazione",,0.00007,108,1,0,1,7826,0,7826,0,0,0,0,0,0
8575568,"S. Abbondio, Paese",,0.000074,108,1,0,1,2938,0,2938,0,0,0,0,0,0
8575572,"Scaiano, Paese",,0.000054,108,1,0,1,2922,0,2922,0,0,0,0,0,0
8577354,"Campora, Valle",,0.000049,99,2,0,2,3839,0,3839,0,0,0,0,0,0
8575667,"Fornasette, Dogana Svizzera",,0.000052,81,1,0,1,12148,0,12148,0,0,0,0,0,0
8575697,"Airolo, Centro Sportivo",,0.000038,108,1,0,1,1948,0,1948,0,0,0,0,0,0
8583567,"Chironico, Area Boulder",,0.000039,108,1,0,1,4253,0,4253,0,0,0,0,0,0
8581302,"Faido, Centro Scolastico",,0.000105,108,3,0,3,1264,0,1264,0,0,0,0,0,0
8575767,"Serpiano, Ostello Alpino",,0.000041,99,1,0,1,568,0,568,0,0,0,0,0,0
8580066,"Muggio, Camasciora",,0.000064,99,1,0,1,1891,0,1891,0,0,0,0,0,0
8591686,"Villaz-St-Pierre, village",,0.000065,126,3,0,3,2391,0,2391,0,0,0,0,0,0
8583309,"Concise, village",,0.000101,35,3,0,3,8847,0,8847,0,0,0,0,0,0
8579922,"Broglio, Somprei",,0.000076,101,1,0,1,3641,0,3641,0,0,0,0,0,0
8583076,"Sonlerto, Bolla (Bavona)",,0.000064,101,1,0,1,1227,0,1227,0,0,0,0,0,0
8575886,Piano di Peccia,,0.000047,101,1,0,1,1668,0,1668,0,0,0,0,0,0
8581751,"Cerentino, Bivio Corsopra",,0.00005,82,1,0,1,2796,0,2796,0,0,0,0,0,0
8583722,"Campo (VMaggia), Chiesa",,0.000059,82,1,0,1,1335,0,1335,0,0,0,0,0,0
8594339,"Illnau, Dorfplatz",,0.000162,84,3,0,3,8954,0,8954,0,0,0,0,0,0
8595706,"Effretikon, Weiherstrasse",,0.000074,84,3,0,3,5397,0,5397,0,0,0,0,0,0
8595538,"Tagelswangen, Herdlen",,0.000017,84,1,0,1,950,0,950,0,0,0,0,0,0
8588735,"Grafstal, Engelacher",,0.00011,84,5,0,5,25882,0,25882,0,0,0,0,0,0
8583115,"Glattfelden, Staltigstrasse",,0.000061,83,1,0,1,14164,0,14164,0,0,0,0,0,0
8583315,"Mühleberg, Steinriesel",,0.00006,44,1,0,1,2109,0,2109,0,0,0,0,0,0
8588533,"Uerikon, Rietlirain",,0.00005,8,1,0,1,2934,0,2934,0,0,0,0,0,0
8594257,"Dürnten, Lättenmoos",,0.000037,8,1,0,1,20078,0,20078,0,0,0,0,0,0
8594538,"Rüti ZH, Waldau",,0.000074,67,2,0,2,5144,0,5144,0,0,0,0,0,0
8587410,"Hinwil, Ringwil",,0.000055,84,1,0,1,1424,0,1424,0,0,0,0,0,0
8594731,"Wetzikon ZH, Bahnhof Süd",,0.000163,84,4,0,4,19217,0,19217,0,0,0,0,0,0
8589106,"Volketswil, Zimikon",,0.00011,84,3,0,3,40757,0,40757,0,0,0,0,0,0
8576149,Dättlikon,,0.000039,107,1,0,1,7867,0,7867,0,0,0,0,0,0
8581566,"Rehetobel, Nasen",,0.000115,71,3,0,3,6144,0,6144,0,0,0,0,0,0
8591109,"Zürich, Chinagarten",,0.000083,86,2,0,2,25717,0,25717,0,0,0,0,0,0
8587005,Gundetswil,,0.000047,68,2,0,2,720,0,720,0,0,0,0,0,0
8595143,"Otelfingen, Landstrasse",,0.000028,107,1,0,1,14884,0,14884,0,0,0,0,0,0
8595356,"Buchs ZH, Furttalstrasse",,0.000023,107,1,0,1,5153,0,5153,0,0,0,0,0,0
8576277,"Buchs ZH, Industrie",,0.000034,107,1,0,1,11437,0,11437,0,0,0,0,0,0
8581129,"Urnäsch, Dürrenbach",,0.00006,73,1,0,1,1088,0,1088,0,0,0,0,0,0
8596003,"Dielsdorf, Gesundheitszentrum",,0.000047,107,1,0,1,14745,0,14745,0,0,0,0,0,0
8576296,"Wasterkingen, Gemeindehaus",,0.00003,68,2,0,2,10116,0,10116,0,0,0,0,0,0
8592308,"Adelboden, Chäli",,0.00007,43,2,0,2,5612,0,5612,0,0,0,0,0,0
8588615,"Spiez, Kronenplatz",,0.000095,43,4,0,4,6616,0,6616,0,0,0,0,0,0
8581762,"Hindelbank, Brunnenhof",,0.00004,44,2,0,2,4696,0,4696,0,0,0,0,0,0
8588582,"Thun, Spital",,0.000078,43,3,0,3,2426,0,2426,0,0,0,0,0,0
8576621,"Aeschlen, Abzweigung Bleiken",,0.000061,100,1,0,1,660,0,660,0,0,0,0,0,0
8595480,"Wangelen, Wendeplatz",,0.000074,43,1,0,1,268,0,268,0,0,0,0,0,0
8588491,"Tschingel, Förstner-Kehr",,0.000237,43,2,0,2,1140,0,1140,0,0,0,0,0,0
8587421,"Seftigen, Bahnhof",,0.000048,43,2,0,2,1377,0,1377,0,0,0,0,0,0
8589947,"Wiedlisbach, Kirchgasse",,0.000145,88,2,0,2,6948,0,6948,0,0,0,0,0,0
8593531,"Langenthal Süd, Bahnhof",,0.000074,88,2,0,2,16716,0,16716,0,0,0,0,0,0
8576958,"Aadorf, Matthofstrasse",,0.000055,65,1,0,1,8830,0,8830,0,0,0,0,0,0
8595543,Wankdorf Bahnhof Nord,,0.000055,44,2,0,2,6669,0,6669,0,0,0,0,0,0
8594260,Kreuzweg,,0.000097,44,4,0,4,4923,0,4923,0,0,0,0,0,0
8588623,Mattstetten,,0.000052,89,2,0,2,4787,0,4787,0,0,0,0,0,0
8579700,"Finsterwald LU, Entlematt",,0.000075,92,1,0,1,2298,0,2298,0,0,0,0,0,0
8587728,"Ebnet (Entlebuch), Sageli",,0.000059,92,2,0,2,1907,0,1907,0,0,0,0,0,0
8589864,Root Wilweg,,0.000209,90,6,0,6,58709,0,58709,0,0,0,0,0,0
8588509,"Ettiswil, Schloss Wyher",,0.000095,92,2,0,2,3275,0,3275,0,0,0,0,0,0
8591901,Flüelen Usserdorf,,0.000247,93,5,0,5,24993,0,24993,0,0,0,0,0,0
8592421,"Seewen SZ, Rösslimatt",,0.000115,91,4,0,4,15454,0,15454,0,0,0,0,0,0
8594497,"Oftringen, Neuquartier",,0.000087,94,2,0,2,16413,0,16413,0,0,0,0,0,0
8588113,"Morschach, Wil",,0.00005,91,1,0,1,16019,0,16019,0,0,0,0,0,0
8583358,"Etoy, collège Les Communaux",,0.000025,5,1,0,1,571,0,571,0,0,0,0,0,0
8588183,"Vuissens, Les Forges",,0.000037,13,2,0,2,4214,0,4214,0,0,0,0,0,0
8588861,"Estavayer-le-Lac, Tuillière",,0.000112,13,2,0,2,6627,0,6627,0,0,0,0,0,0
8583762,"Teufen AR, Stofel",,0.000045,71,1,0,1,71,0,71,0,0,0,0,0,0
8596121,"Bouloz, Les Esserts",,0.000185,13,2,0,2,4747,0,4747,0,0,0,0,0,0
8577717,"Granges (Veveyse), Le Battiau",,0.00004,13,1,0,1,8749,0,8749,0,0,0,0,0,0
8577738,"Pringy, La Loue",,0.000025,13,1,0,1,4264,0,4264,0,0,0,0,0,0
8588864,"Corbières, le Vanel",,0.000063,13,2,0,2,12834,0,12834,0,0,0,0,0,0
8588866,"Boltigen, Schüpfboden",,0.000044,13,1,0,1,2346,0,2346,0,0,0,0,0,0
8588596,"Treyvaux, Rafour",,0.000069,126,2,0,2,1543,0,1543,0,0,0,0,0,0
8595536,"Gletterens, lac",,0.000111,126,3,0,3,4719,0,4719,0,0,0,0,0,0
8595193,"Düdingen, Briegli",,0.000047,126,2,0,2,10358,0,10358,0,0,0,0,0,0
8587241,"Le Mouret, Praroman",,0.000032,126,1,0,1,6203,0,6203,0,0,0,0,0,0
8594918,"Hägendorf, Weinhalden",,0.000096,94,3,0,3,5528,0,5528,0,0,0,0,0,0
8578056,"Olten, Amthausquai",,0.000037,94,1,0,1,2728,0,2728,0,0,0,0,0,0
8594311,"Trimbach, Brückenstrasse",,0.00003,94,1,0,1,2977,0,2977,0,0,0,0,0,0
8594925,EuroAirport Cargo,,0.000029,2,2,0,2,16810,0,16810,0,0,0,0,0,0
8589400,Bubendorf Industrie Süd,,0.000121,2,3,0,3,39840,0,39840,0,0,0,0,0,0
8594312,Schleitheim Poststrasse,,0.000041,66,2,0,2,3774,0,3774,0,0,0,0,0,0
8587928,Osterfingen Lindenhof,,0.000053,95,1,0,1,7682,0,7682,0,0,0,0,0,0
8587015,"Brülisau, Kastenbahn",,0.00004,96,1,0,1,5444,0,5444,0,0,0,0,0,0
8588492,"Gebertingen, Abzw. Schulstrasse",,0.000087,67,3,0,3,7317,0,7317,0,0,0,0,0,0
8589221,"St. Gallenkappel, Kronenwiese",,0.00014,67,2,0,2,14149,0,14149,0,0,0,0,0,0
8596099,"Ebnat, Acker",,0.000173,97,3,0,3,11562,0,11562,0,0,0,0,0,0
8589928,"Wil SG, Zürcherstrasse",,0.00008,20,2,0,2,12639,0,12639,0,0,0,0,0,0
8588978,"Eschlikon TG, Bahnhof Süd",,0.000118,20,3,0,3,22491,0,22491,0,0,0,0,0,0
8578657,Barmelweid,,0.000051,57,1,0,1,3876,0,3876,0,0,0,0,0,0
8579862,"Gebenstorf, Vogelsang",,0.000025,22,1,0,1,6841,0,6841,0,0,0,0,0.000001,0
8578810,"Glis, Poststrasse",,0.000073,40,1,0,1,4670,0,4670,0,0,0,0,0,0
8583559,"Rekingen AG, Rainächer",,0.000057,98,1,0,1,2272,0,2272,0,0,0,0,0,0
8595946,"Wiezikon b. S., Widenacker",,0.000045,20,1,0,1,2006,0,2006,0,0,0,0,0,0
8591479,Piansecco,,0.000063,108,1,0,1,643,0,643,0,0,0,0,0,0
8588140,Pian Geirett,,0.000024,108,1,0,1,197,0,197,0,0,0,0,0,0
8588141,Diga di Luzzone/Ristorante,,0.000024,108,1,0,1,142,0,142,0,0,0,0,0,0
8578867,"Ponto Valentino, Fontana",,0.000058,108,1,0,1,5362,0,5362,0,0,0,0,0,0
8587120,Intragna Stazione (bus),,0.000036,101,1,0,1,428,0,428,0,0,0,0,0,0
8580195,"Klus, Maiacker",,0.000048,94,1,0,1,3787,0,3787,0,0,0,0,0,0
8578945,Münsingen Schöneggweg,,0.000024,100,1,0,1,1930,0,1930,0,0,0,0,0,0
8579020,Badi,,0.000033,100,1,0,1,540,0,540,0,0,0,0,0,0
8579014,Schlossmatt,,0.000035,100,1,0,1,3732,0,3732,0,0,0,0,0,0
8579065,"Val-d'Illiez, Crosets-Chapelle",,0.000036,0,1,0,1,327,0,327,0,0,0,0,0,0
8579067,"Champoussin, télésiège",,0.000042,0,1,0,1,235,0,235,0,0,0,0,0,0
8579840,"Gimel, En Péry-Béliaux",,0.000032,32,1,0,1,4592,0,4592,0,0,0,0,0,0
8579087,Kapellenweg,,0.000033,100,1,0,1,5659,0,5659,0,0,0,0,0,0
8583458,"Aubonne, Pré-Baulan",,0.000037,32,1,0,1,107,0,107,0,0,0,0,0,0
8579132,"Ollon VD, bif. rte d'Antagnes",,0.000058,103,1,0,1,1734,0,1734,0,0,0,0,0,0
8587713,"Niederried b.I'laken, Wendepl",,0.000031,43,1,0,1,655,0,655,0,0,0,0,0,0
8580336,"Oberdorf BL, Schulhaus",,0.000048,2,1,0,1,71,0,71,0,0,0,0,0,0
8596092,"La Rippe, Tranchepied",,0.000069,125,2,0,2,2016,0,2016,0,0,0,0,0,0
8589089,"Fiesch, Dorf",,0.000066,16,2,0,2,2827,0,2827,0,0,0,0,0,0
8589090,"Fiesch, Moos",,0.000044,16,1,0,1,3206,0,3206,0,0,0,0,0,0
8594721,"Sierre, Ste-Croix",,0.000123,39,4,0,4,12392,0,12392,0,0,0,0,0,0
8594715,"Montana, Plumachit",,0.000032,39,2,0,2,2209,0,2209,0,0,0,0,0,0
8583312,"Seewen SO, Musikautomaten",,0.000061,53,1,0,1,328,0,328,0,0,0,0,0,0
8583695,"Les Taillères, bif. L'Ecrenaz",,0.000032,49,1,0,1,1594,0,1594,0,0,0,0,0,0
8588817,Sous la Lisière,,0.000058,48,3,0,3,16790,0,16790,0,0,0,0,0,0
8595200,"Travers, Verger",,0.000194,49,2,0,2,1028,0,1028,0,0,0,0,0,0
8583231,"Sugnens, village",,0.000049,35,2,0,2,1494,0,1494,0,0,0,0,0,0
8583396,"Villars-Mendraz, Petite Route",,0.000049,13,2,0,2,1549,0,1549,0,0,0,0,0,0
8583075,"Mauren FL, Ziel",,0.000149,73,2,0,2,6162,0,6162,0,0,0,0,0,0
8583791,"Yvonand, gare",,0.000094,13,3,0,3,3141,0,3141,0,0,0,0,0,0
8583253,"Bussigny-sur-Oron, La Resse",,0.000032,13,1,0,1,1106,0,1106,0,0,0,0,0,0
8595379,"Sargans, Bahnhof Süd",,0.000127,73,3,0,3,14839,0,14839,0,0,0,0,0,0
8583405,"Lostallo, nord",,0.000122,109,2,0,2,1641,0,1641,0,0,0,0,0,0
8595715,"Mollis, Vorderdorf",,0.000199,106,2,0,2,4095,0,4095,0,0,0,0,0,0
8579980,"Häggenschwil, Täschlihus",,0.000053,71,1,0,1,5021,0,5021,0,0,0,0,0,0
8579982,"Waldkirch, Gemeindehaus",,0.000068,71,1,0,1,9046,0,9046,0,0,0,0,0,0
8591776,"Grabs, Amasis",,0.000075,73,1,0,1,3428,0,3428,0,0,0,0,0,0
8581468,"Oberwilen, Mätteli",,0.000071,62,1,0,1,3421,0,3421,0,0,0,0,0,0
8582703,"Guggisberg, Multernboden",,0.000099,126,3,0,3,1331,0,1331,0,0,0,0,0,0
8582004,"Sta. Maria in Calanca, Posta",,0.000083,17,3,0,3,2962,0,2962,0,0,0,0,0,0
8580181,"Etzgen, Dorf",,0.00009,57,1,0,1,5730,0,5730,0,0,0,0,0,0
8583610,"Sarn, Sendas",,0.000036,109,1,0,1,3302,0,3302,0,0,0,0,0,0
8582959,"Hinterrhein, Tälialp",,0.000031,109,1,0,1,530,0,530,0,0,0,0,0,0
8581053,"Luzein, Schermen",,0.000095,112,1,0,1,3649,0,3649,0,0,0,0,0,0
8580384,"Oberwald VS, Dorf",,0.000094,108,1,0,1,257,0,257,0,0,0,0,0,0
8587027,Vico Morcote,,0.000053,102,2,0,2,5967,0,5967,0,0,0,0,0,0
8581946,"Hüttwilen, Oberdorf",,0.000025,65,1,0,1,1609,0,1609,0,0,0,0,0,0
8583737,"Eschenz, Mettlen",,0.000025,65,1,0,1,8070,0,8070,0,0,0,0,0,0
8580487,"Ennenda, Wiese/Salem",,0.00004,106,2,0,2,4795,0,4795,0,0,0,0,0,0
8591001,"Winterthur, Stäffelistrasse",,0.000116,68,3,0,3,13209,0,13209,0,0,0,0,0,0
8580346,"Wohlen AG, Haldenschulen",,0.00004,115,1,0,1,933,0,933,0,0,0,0,0.000005,0
8580357,"Wohlen AG, Bünzmattschulen",,0.000037,115,1,0,1,1906,0,1906,0,0,0,0,0,0
8580743,"Lauterbrunnen, Schützenbach",,0.000052,43,1,0,1,7076,0,7076,0,0,0,0,0,0
8580843,"Wohlen AG, Freiämterstrasse",,0.000108,115,1,0,1,2064,0,2064,0,0,0,0,0,0
8580392,Ladstafel,,0.000055,108,1,0,1,508,0,508,0,0,0,0,0,0
8583763,"Les Haudères, Les Juttes",,0.000061,39,1,0,1,1349,0,1349,0,0,0,0,0,0
8582421,"Carì, Prodör",,0.000057,108,2,0,2,561,0,561,0,0,0,0,0,0
8580471,"Romont FR, Bicubic",,0.000065,13,2,0,2,15961,0,15961,0,0,0,0,0,0
8583446,"Möhlin, Efeuweg",,0.000112,2,4,0,4,2655,0,2655,0,0,0,0,0,0
8583632,"Euthal, Alte Festung",,0.000156,69,3,0,3,13851,0,13851,0,0,0,0,0,0
8583503,"Schaan, Industriestrasse",,0.000064,73,2,0,2,2805,0,2805,0,0,0,0,0,0
8581016,"Benken SG, Röten",,0.000038,67,1,0,1,5292,0,5292,0,0,0,0,0,0
8594402,"Wald ZH, Niederholz",,0.000039,67,1,0,1,857,0,857,0,0,0,0,0,0
8581910,Müliacher,,0.000079,100,3,0,3,3456,0,3456,0,0,0,0,0,0
8581108,"Sulz AG, Roos",,0.000064,57,1,0,1,3465,0,3465,0,0,0,0,0,0
8583030,"Essertines-s.-Yv., Gde Salle",,0.000061,35,1,0,1,5809,0,5809,0,0,0,0,0,0
8580611,"Ganterschwil, Grund",,0.000037,70,1,0,1,12821,0,12821,0,0,0,0,0,0
8583522,"Rueun, Gula",,0.000099,110,2,0,2,4710,0,4710,0,0,0,0,0,0
8583865,"Savièse, La Tsatonire",,0.000051,39,1,0,1,30,0,30,0,0,0,0,0,0
8582528,"Rietheim, Bahnhof",,0.000086,98,2,0,2,493,0,493,0,0,0,0,0,0
8582062,PZM West,,0.000035,100,1,0,1,3728,0,3728,0,0,0,0,0,0
8580735,"St-Luc, Chemin des Caïds",,0.000058,39,1,0,1,2336,0,2336,0,0,0,0,0,0
8581298,"Vouvry, Les Bovairons",,0.000054,103,1,0,1,1147,0,1147,0,0,0,0,0,0
8582265,"Premploz, Saladin",,0.000045,38,1,0,1,2159,0,2159,0,0,0,0,0,0
8580900,"Fenalet-sur-Bex, Grande Salle",,0.000061,103,1,0,1,519,0,519,0,0,0,0,0,0
8581756,"Odogno, Piana",,0.000032,102,1,0,1,7940,0,7940,0,0,0,0,0,0
8583612,"Falera, Chintguns",,0.000143,110,2,0,2,3510,0,3510,0,0,0,0,0,0
8583243,"Ittenthal, Rüttiweg",,0.000106,57,2,0,2,3644,0,3644,0,0,0,0,0,0
8583725,"Vallamand-Dessous, Garinettes",,0.000081,126,2,0,2,1832,0,1832,0,0,0,0,0,0
8582021,"Altikon, Herten",,0.000051,64,1,0,1,2678,0,2678,0,0,0,0,0,0
8583773,"Turbenthal, Usserdorfweg",,0.000063,84,1,0,1,1090,0,1090,0,0,0,0,0,0
8595733,Seltisberg Verwaltung MZH,,0.000045,2,1,0,1,17972,0,17972,0,0,0,0,0,0
8586339,"Conthey, rue du Collège",,0.000042,39,2,0,2,90,0,90,0,0,0,0,0,0
8581308,"Bremgarten AG, Meyerhof",,0.000041,85,1,0,1,6051,0,6051,0,0,0,0,0.000428,0
8581547,"Uster, Herracher",,0.00009,84,2,0,2,18906,0,18906,0,0,0,0,0,0
8583443,"Pignia, Dorf",,0.000103,109,2,0,2,1217,0,1217,0,0,0,0,0,0
8583760,"Waltenschwil, Zentrum",,0.00004,115,2,0,2,2572,0,2572,0,0,0,0,0.001097,0
8580899,"Auenstein, Wiweg",,0.000092,58,1,0,1,2070,0,2070,0,0,0,0,0,0
8582609,"Glarus, Pfrundhaus",,0.000038,106,1,0,1,4794,0,4794,0,0,0,0,0,0
8582878,"Verdabbio, Paese",,0.000033,17,1,0,1,2136,0,2136,0,0,0,0,0,0
8581735,"Dicken b Dgh, Schwindel",,0.000051,20,1,0,1,3379,0,3379,0,0,0,0,0,0
8583835,"Büren SO, Gemeindehaus",,0.000065,2,1,0,1,441,0,441,0,0,0,0,0,0
8582607,"Wildensbuch, Dorf",,0.000053,66,1,0,1,3241,0,3241,0,0,0,0,0,0
8582407,"Mastrils, Höf",,0.000091,109,2,0,2,1625,0,1625,0,0,0,0,0,0
8594370,"Locarno, Piazza Stazione",,0.000289,101,7,0,7,113626,0,113626,0,0,0,0,0,0
8582404,"Lüchingen, Wannelocher",,0.000038,73,1,0,1,1464,0,1464,0,0,0,0,0,0
8581093,"Triesenberg, Balischguad",,0.000057,73,1,0,1,1114,0,1114,0,0,0,0,0,0
8583251,"Gamprin, Stelzagass",,0.000068,73,2,0,2,2550,0,2550,0,0,0,0,0,0
8582665,"Malbun, Schneeflucht",,0.000063,73,1,0,1,1691,0,1691,0,0,0,0,0,0
8581645,"Beatenberg, Schorren",,0.000075,43,2,0,2,4817,0,4817,0,0,0,0,0,0
8581041,"Igis, Schulhaus",,0.000023,109,1,0,1,4095,0,4095,0,0,0,0,0,0
8595594,"Chur, Turnerwiese",,0.000157,109,3,0,3,21862,0,21862,0,0,0,0,0,0
8583204,"Feusisberg, Alterszentrum",,0.000085,113,1,0,1,9723,0,9723,0,0,0,0,0,0
8583789,"Vernamiège, Les Prixes",,0.000125,39,3,0,3,1975,0,1975,0,0,0,0,0,0
8582741,"Jonschwil, Oberbettenau",,0.000041,20,1,0,1,13579,0,13579,0,0,0,0,0,0
8583711,"Schwarzenberg LU, Ried",,0.000066,90,1,0,1,3194,0,3194,0,0,0,0,0,0
8581168,"Breil/Brigels, Crestas",,0.000062,110,1,0,1,1209,0,1209,0,0,0,0,0,0
8581599,"Valendas, Carstulien",,0.000076,110,2,0,2,2491,0,2491,0,0,0,0,0,0
8584829,"Schiers, Ottenacher",,0.000074,112,2,0,2,988,0,988,0,0,0,0,0,0
8581190,"Lantsch/Lenz, Sudem Vischnanca",,0.000021,131,1,0,1,3623,0,3623,0,0,0,0,0,0
8583618,"Flawil, Bahnhofstrasse",,0.0001,20,2,0,2,9779,0,9779,0,0,0,0,0,0
8583031,"Scheid, Plazza",,0.00007,111,1,0,1,748,0,748,0,0,0,0,0,0
8584738,"Hörhausen, Reutenen",,0.000045,65,1,0,1,223,0,223,0,0,0,0,0,0
8585242,"Saas-Grund, Schulhaus",,0.000083,41,1,0,1,1739,0,1739,0,0,0,0,0,0
8583636,"Boussens, Chevrine",,0.000061,5,1,0,1,3669,0,3669,0,0,0,0,0,0
8590025,"Bern, Güterbahnhof",,0.000079,44,2,0,2,32841,0,32841,0,0,0,0,0,0
8581387,"Niederscherli, Halten",,0.000057,44,1,0,1,3422,0,3422,0,0,0,0,0,0
8581528,"Sarnen, Bitzighofen",,0.000091,62,1,0,1,4189,0,4189,0,0,0,0,0,0
8581584,"Oberdorf NW, Schulhausstrasse",,0.000058,62,1,0,1,5445,0,5445,0,0,0,0,0,0
8587680,"Uster, Gschwaderstrasse",,0.000058,84,1,0,1,18489,0,18489,0,0,0,0,0,0
8587010,"Uster, Pfannenstielstrasse",,0.000043,84,1,0,1,19307,0,19307,0,0,0,0,0,0
8581548,"Uster, Poststrasse",,0.000051,84,1,0,1,13960,0,13960,0,0,0,0,0,0
8581748,"Habkern, Städeli",,0.000051,43,1,0,1,3221,0,3221,0,0,0,0,0,0
8581866,"Müstair, cunfin",,0.000104,30,2,0,2,3743,0,3743,0,0,0,0,0,0
8583868,"Buchegg, Schloss/Dorf",,0.000092,87,2,0,2,2485,0,2485,0,0,0,0,0,0
8595695,"Altbüron, Linden",,0.000112,94,1,0,1,2464,0,2464,0,0,0,0,0,0
8595251,"Weisstannen, Schulhaus",,0.000057,73,1,0,1,6893,0,6893,0,0,0,0,0,0
8582420,"Bad Ragaz, Sportplatz",,0.000072,109,1,0,1,4668,0,4668,0,0,0,0,0,0
8583337,"Frauenfeld, Huben",,0.000069,65,1,0,1,6112,0,6112,0,0,0,0,0,0
8581624,"Hägglingen, Huematten",,0.000063,115,1,0,1,1953,0,1953,0,0,0,0,0,0
8583200,"Cousset, centre sportif",,0.000068,116,3,0,3,733,0,733,0,0,0,0,0,0
8583558,"Muri AG, Grüth",,0.000056,115,2,0,2,4562,0,4562,0,0,0,0,0,0
8596115,"Schönenberg ZH, Dorfhuus",,0.000125,63,6,0,6,8429,0,8429,0,0,0,0,0,0
8581688,"Sternenberg, Kirche",,0.000053,84,1,0,1,3058,0,3058,0,0,0,0,0,0
8581766,"Gnosca, Rifugio Animali",,0.000051,108,1,0,1,8071,0,8071,0,0,0,0,0,0
8583665,"Visp, Friedhof",,0.000111,40,2,0,2,2721,0,2721,0,0,0,0,0,0
8581743,"Quinto, Scruengo Paese",,0.000045,108,1,0,1,2916,0,2916,0,0,0,0,0,0
8594913,"Kreuzlingen, Neudorfstrasse",,0.000103,65,2,0,2,7999,0,7999,0,0,0,0,0,0
8581897,"Münsingen, Lindenweg",,0.000033,100,1,0,1,4501,0,4501,0,0,0,0,0,0
8581894,"Gordola, Gaggiole Sopra",,0.000046,101,1,0,1,11569,0,11569,0,0,0,0,0,0
8583818,"Eglisau, Städtli",,0.000057,68,2,0,2,9120,0,9120,0,0,0,0,0,0
8587333,"Eglisau, Viehmarkt",,0.000026,68,1,0,1,1409,0,1409,0,0,0,0,0,0
8581814,"Escholzmatt, Riedgasse",,0.000091,61,1,0,1,6201,0,6201,0,0,0,0,0,0
8582105,"Balzers, Gagoz",,0.000044,73,1,0,1,2589,0,2589,0,0,0,0,0,0
8588287,"Mauren FL, Kirche",,0.000085,73,2,0,2,2268,0,2268,0,0,0,0,0,0
8583552,"Melchtal, Turrenbach",,0.000098,62,1,0,1,1552,0,1552,0,0,0,0,0,0
8581884,"Wohlen AG, Planzer",,0.000054,115,1,0,1,4279,0,4279,0,0,0,0,0,0
8583793,"Nuolen, Ochsenboden",,0.000183,67,2,0,2,6315,0,6315,0,0,0,0,0,0
8582589,"Vielbringen, Moosacker",,0.000155,100,1,0,1,2706,0,2706,0,0,0,0,0,0
8582403,"Bercher, 7 Fontaines",,0.000056,13,1,0,1,617,0,617,0,0,0,0,0,0
8583211,"Cronay, Le Crêt",,0.000056,13,1,0,1,5112,0,5112,0,0,0,0,0,0
8583400,"Peyres-Possens, Les Tuilières",,0.000056,13,1,0,1,2558,0,2558,0,0,0,0,0,0
8583483,"Prévondavaux, village",,0.000056,13,1,0,1,2461,0,2461,0,0,0,0,0,0
8584515,"Baulmes, Cul de Villars",,0.000077,35,1,0,1,1322,0,1322,0,0,0,0,0,0
8582808,"Märstetten, Muggenwinggel",,0.000078,65,1,0,1,4580,0,4580,0,0,0,0,0,0
8581984,"Isone, Gròssa",,0.000058,102,1,0,1,6671,0,6671,0,0,0,0,0,0
8584819,"Unterbach BE, Trutzenmeder",,0.000032,114,1,0,1,134,0,134,0,0,0,0,0,0
8585199,"Schattenhalb, Schulhaus",,0.000051,114,1,0,1,71,0,71,0,0,0,0,0,0
8582003,"Brig, Wehrmannskapelle",,0.000172,40,1,0,1,796,0,796,0,0,0,0,0,0
8582196,"Islikon, Zentrum",,0.000069,65,1,0,1,6780,0,6780,0,0,0,0,0,0
8583429,"Payerne, Moulin à Pigeon",,0.000096,13,2,0,2,2682,0,2682,0,0,0,0,0,0
8582594,"Sauges, La Fontanette",,0.000087,35,1,0,1,1132,0,1132,0,0,0,0,0,0
8582569,"Guggisberg, Kirchhalten",,0.000057,126,1,0,1,1984,0,1984,0,0,0,0,0,0
8583212,"Merzligen, Grossackerweg",,0.000089,87,1,0,1,1729,0,1729,0,0,0,0,0,0
8582940,"St-Ursanne, l'écluse",,0.000097,52,1,0,1,7724,0,7724,0,0,0,0,0,0
8583512,"Sempach Station, Seefeld",,0.00003,90,1,0,1,4717,0,4717,0,0,0,0,0,0
8582122,"Ennetmoos, Abz. Vorsässstrasse",,0.000042,62,1,0,1,2141,0,2141,0,0,0,0,0,0
8583671,"Coeuve, Le Crêt",,0.000079,50,3,0,3,5264,0,5264,0,0,0,0,0,0
8582666,"Mutten, Dorfmitte",,0.000068,109,1,0,1,1350,0,1350,0,0,0,0,0,0
8583557,"Hörhausen, Käsereistrasse",,0.000063,65,1,0,1,2530,0,2530,0,0,0,0,0,0
8582211,"Uetendorf, Thunstrasse",,0.000053,43,1,0,1,988,0,988,0,0,0,0,0,0
8582202,"Palézieux, En Plan",,0.000097,13,2,0,2,3217,0,3217,0,0,0,0,0,0
8594636,"Sierre, Sous-Géronde",,0.00006,39,2,0,2,16426,0,16426,0,0,0,0,0,0
8594635,"Sierre, Oasis",,0.000118,39,3,0,3,11167,0,11167,0,0,0,0,0,0
8590107,"Wabern, Bächtelen",,0.000056,44,1,0,1,6062,0,6062,0,0,0,0,0,0
8582242,"Oberegg AI, Honegg",,0.000063,73,1,0,1,1071,0,1071,0,0,0,0,0,0
8590435,"Oensingen, Bahnhof Süd",,0.000058,94,2,0,2,18524,0,18524,0,0,0,0,0,0
8583685,"Muri AG, Dorf",,0.000063,115,1,0,1,3095,0,3095,0,0,0,0,0,0
8583246,"Vérossaz, Rosaire",,0.000068,37,1,0,1,1066,0,1066,0,0,0,0,0,0
8582531,"Torgon, village",,0.000087,103,1,0,1,1469,0,1469,0,0,0,0,0,0
8583657,"Porrentruy, Fbg St. Germain",,0.000086,50,2,0,2,5237,0,5237,0,0,0,0,0,0
8583411,"Grüsch, Usserfeld",,0.000061,75,1,0,1,1386,0,1386,0,0,0,0,0,0
8583556,"Fajauna, bi Däschers",,0.000047,112,1,0,1,1848,0,1848,0,0,0,0,0,0
8582417,"Sessa, Sotto Chiesa",,0.000094,81,1,0,1,9108,0,9108,0,0,0,0,0,0
8583885,"Villars-Burquin, Les Oches",,0.000074,35,1,0,1,950,0,950,0,0,0,0,0,0
8582437,"Schaan, Rossfeld/Obergass",,0.000052,73,1,0,1,767,0,767,0,0,0,0,0,0
8582529,"Bremgarten AG, Zufikerstrasse",,0.000047,85,1,0,1,2618,0,2618,0,0,0,0,0.000516,0
8582595,"Bad Ragaz, Tamina Therme",,0.000073,109,1,0,1,995,0,995,0,0,0,0,0,0
8583655,"Bad Zurzach, Regibad",,0.00005,98,1,0,1,321,0,321,0,0,0,0,0,0
8582538,"Les Brenets, Parc des Pargots",,0.000049,118,1,0,1,2606,0,2606,0,0,0,0,0,0
8582719,"Zweilütschinen, Bahnhof",,0.000068,43,1,0,1,332,0,332,0,0,0,0,0,0
8583867,"Charmey (Gruyère), télécabine",,0.000066,13,1,0,1,1449,0,1449,0,0,0,0,0,0
8582626,"Einsiedeln, Wäni",,0.000041,69,1,0,1,2134,0,2134,0,0,0,0,0,0
8582943,"Einsiedeln, Steinauerstrasse",,0.00009,69,2,0,2,6405,0,6405,0,0,0,0,0,0
8582636,"Einsiedeln, Horgenberg",,0.000043,69,1,0,1,4419,0,4419,0,0,0,0,0,0
8583099,"Däniken, Hogenweid",,0.000035,119,1,0,1,1929,0,1929,0,0,0,0,0,0
8587522,"Brünigen, Gnoll",,0.000132,114,3,0,3,1522,0,1522,0,0,0,0,0,0
8583761,"Oberglatt ZH, Pistenende",,0.000113,107,1,0,1,10331,0,10331,0,0,0,0,0,0
8582680,"Biasca, Via ai Grotti",,0.000068,108,1,0,1,4826,0,4826,0,0,0,0,0,0
8582700,"Wila, Zentrum",,0.000051,84,1,0,1,5563,0,5563,0,0,0,0,0,0
8583543,"Muraz (Collombey), Pré Court",,0.000173,103,1,0,1,4609,0,4609,0,0,0,0,0,0
8583227,"Uesslingen, Berlingerhof",,0.00006,65,1,0,1,4537,0,4537,0,0,0,0,0,0
8586439,"Riddes, rte Cantonale",,0.000154,39,2,0,2,443,0,443,0,0,0,0,0,0
8582749,"Boll, Schlossstrasse",,0.000048,47,1,0,1,3360,0,3360,0,0,0,0,0,0
8583731,"Birmensdorf ZH, Landikon Dorf",,0.000067,85,2,0,2,1381,0,1381,0,0,0,0,0.000662,0
8587007,"Menziken, Altersh. Falkenstein",,0.000038,59,1,0,1,4297,0,4297,0,0,0,0,0,0
8583304,"Bure, Mairie",,0.000058,50,1,0,1,6455,0,6455,0,0,0,0,0,0
8583706,"Oberkirch LU, Terra Alta",,0.00004,59,2,0,2,4247,0,4247,0,0,0,0,0,0
8583363,"Ottenbach, Geeren",,0.000035,115,1,0,1,2944,0,2944,0,0,0,0,0,0
8582793,"Gampelen, Gürle",,0.000117,117,1,0,1,1229,0,1229,0,0,0,0,0,0
8583102,"Himmelried, Kastelhöhe",,0.000067,53,1,0,1,1114,0,1114,0,0,0,0,0,0
8587558,"Krattigen, Oertlimatt",,0.000076,43,1,0,1,502,0,502,0,0,0,0,0,0
8583531,"Realta, Industriezone",,0.000064,109,1,0,1,367,0,367,0,0,0,0,0,0
8587676,"Rhäzüns, Bahnhof",,0.000064,109,1,0,1,3390,0,3390,0,0,0,0,0,0
8586414,"Evolène, centre scolaire",,0.000041,39,1,0,1,81,0,81,0,0,0,0,0,0
8583851,"Roveredo GR, CRS",,0.000042,108,1,0,1,241,0,241,0,0,0,0,0,0
8583239,"S. Antonino, Monda",,0.000088,108,1,0,1,17320,0,17320,0,0,0,0,0,0
8583703,"Bellinzona, Cast.Sasso Corbaro",,0.000066,108,1,0,1,7505,0,7505,0,0,0,0,0,0
8583029,"Ravecchia, Von Mentlen",,0.00005,108,1,0,1,23962,0,23962,0,0,0,0,0,0
8583045,"Lyss, Industrie Süd",,0.000046,87,1,0,1,896,0,896,0,0,0,0,0,0
8583042,"Lyss, Rainweg",,0.000079,87,1,0,1,929,0,929,0,0,0,0,0,0
8587662,"Lungern, Dorfkapelle",,0.000074,92,1,0,1,244,0,244,0,0,0,0,0,0
8591769,"Riedholz, Bei den Weihern",,0.000095,56,3,0,3,5729,0,5729,0,0,0,0,0,0
8583314,"Forel-sur-Lucens, Dessous",,0.00007,13,1,0,1,1428,0,1428,0,0,0,0,0,0
8595614,"Tägerwilen, Ruet",,0.000109,65,1,0,1,4614,0,4614,0,0,0,0,0,0
8583235,"Willisau, Zehntenplatz",,0.000068,59,1,0,1,450,0,450,0,0,0,0,0,0
8583776,"Lavertezzo, Monda",,0.00005,101,1,0,1,8355,0,8355,0,0,0,0,0,0
8583245,"Törbel, Chämbricheer",,0.000088,40,1,0,1,3142,0,3142,0,0,0,0,0,0
8587706,"Naters, Massa-Wildi",,0.000083,40,2,0,2,8441,0,8441,0,0,0,0,0,0
8583272,"Sion, Gravelone",,0.000041,39,1,0,1,1050,0,1050,0,0,0,0,0,0
8583436,"Hofstetten SO, Milchhüsli",,0.000096,54,2,0,2,7216,0,7216,0,0,0,0,0,0
8583302,"Villars-le-Terroir, Le Buron",,0.000046,35,1,0,1,2567,0,2567,0,0,0,0,0,0
8584745,"Fregiécourt, école",,0.000076,50,1,0,1,5549,0,5549,0,0,0,0,0,0
8583419,"Sion, St-Guérin Ouest",,0.000058,39,1,0,1,106,0,106,0,0,0,0,0,0
8583719,"Monthey, place centrale",,0.00005,103,2,0,2,545,0,545,0,0,0,0,0,0
8583394,"Brig, Aletschstrasse",,0.00005,40,1,0,1,3708,0,3708,0,0,0,0,0,0
8583403,"Lussery-Villars,pl. de Lussery",,0.000029,5,1,0,1,874,0,874,0,0,0,0,0,0
8583417,"Unterseen, Wellenacher",,0.000069,43,1,0,1,3609,0,3609,0,0,0,0,0,0
8583484,"Marchissy, Les Raisses",,0.000096,125,1,0,1,3668,0,3668,0,0,0,0,0,0
8584723,"Zinal, télécabine",,0.000105,39,1,0,1,302,0,302,0,0,0,0,0,0
8583442,"Bad Zurzach, Schlüsselstrasse",,0.000038,98,1,0,1,872,0,872,0,0,0,0,0,0
8584785,"Flamatt, Chrummatt",,0.000056,126,2,0,2,704,0,704,0,0,0,0,0,0
8586268,"Mezzovico, S. Mamete",,0.000064,102,1,0,1,12850,0,12850,0,0,0,0,0,0
8583860,"Gilly, Condémines",,0.000066,32,2,0,2,5431,0,5431,0,0,0,0,0,0
8583741,"Cadenazzo, Chiesa",,0.000137,108,1,0,1,16235,0,16235,0,0,0,0,0,0
8583480,"Agra, Rondelli",,0.000055,102,1,0,1,11774,0,11774,0,0,0,0,0,0
8583494,"Stans, Spichermatt",,0.000045,62,1,0,1,3730,0,3730,0,0,0,0,0,0
8583497,"La Neuveville, collège",,0.000073,117,1,0,1,637,0,637,0,0,0,0,0,0
8583709,"Montet (Vully), La Fenette",,0.000037,126,1,0,1,2939,0,2939,0,0,0,0,0,0
8583529,"Willerzell, Gasse",,0.000064,69,1,0,1,1579,0,1579,0,0,0,0,0,0
8583546,"Horboden, Sporthalle",,0.00008,46,1,0,1,872,0,872,0,0,0,0,0,0
8583581,"Oensingen, Sternenplatz",,0.00006,94,1,0,1,3100,0,3100,0,0,0,0,0,0
8583772,"Rafz, Friedhof",,0.00006,68,1,0,1,5937,0,5937,0,0,0,0,0,0
8583617,"Flawil, Birkenstrasse",,0.000041,20,1,0,1,2955,0,2955,0,0,0,0,0,0
8583619,"Flawil, Alpsteinstrasse",,0.000057,20,1,0,1,11192,0,11192,0,0,0,0,0,0
8583669,"Netstal, Bahnhof",,0.000078,106,1,0,1,4834,0,4834,0,0,0,0,0,0
8583675,"Giubiasco, Golena",,0.000039,108,1,0,1,24468,0,24468,0,0,0,0,0,0
8583691,"Arbedo, Via Orbello",,0.000088,108,1,0,1,18588,0,18588,0,0,0,0,0,0
8583821,"Rolle, centre ville",,0.000102,32,1,0,1,2631,0,2631,0,0,0,0,0,0
8583744,"Fideris, Rüfi",,0.000076,112,1,0,1,3626,0,3626,0,0,0,0,0,0
8583829,"Cudrefin, Le Moulin",,0.000041,126,1,0,1,2699,0,2699,0,0,0,0,0,0
8583728,"Bözberg, Unterer Hafen",,0.00007,57,1,0,1,5465,0,5465,0,0,0,0,0,0
8593786,"Ste-Croix, av. des Gittaz",,0.000154,35,2,0,2,6974,0,6974,0,0,0,0,0,0
8583855,"Rifferswil, Hausmatte",,0.000085,115,2,0,2,3160,0,3160,0,0,0,0,0,0
8583771,"Pfäffikon ZH, Rainstrasse",,0.000038,84,1,0,1,7305,0,7305,0,0,0,0,0,0
8583804,"Gland, Perron/Riant-Coteau",,0.000067,32,1,0,1,3650,0,3650,0,0,0,0,0,0
8583811,"Stein AG, Bahnhofstrasse",,0.000077,57,1,0,1,3627,0,3627,0,0,0,0,0,0
8584675,"Martigny, ch. des Ecoliers",,0.000064,39,1,0,1,275,0,275,0,0,0,0,0,0
8586520,"Martigny-Croix, Pl. Centrale",,0.000064,39,1,0,1,192,0,192,0,0,0,0,0,0
8583895,"Avenches, EMS Marc-Aurèle",,0.000061,126,1,0,1,2814,0,2814,0,0,0,0,0,0
8584699,"Mühlebach (Goms), beim Kreuz",,0.000049,16,1,0,1,1459,0,1459,0,0,0,0,0,0
8584721,"Menznau, Obertreien",,0.000063,60,1,0,1,1431,0,1431,0,0,0,0,0,0
8584864,"Fully, Cycle d'orientation",,0.000075,39,1,0,1,291,0,291,0,0,0,0,0,0
8584842,"Les Diablerets, Lilas/Chamois",,0.000093,42,1,0,1,975,0,975,0,0,0,0,0,0
8584841,"Les Diablerets, Les Vioz",,0.000085,42,1,0,1,995,0,995,0,0,0,0,0,0
8585198,"Unterbach BE, Waldey",,0.000073,114,1,0,1,2415,0,2415,0,0,0,0,0,0
8585808,"Uetendorf, Berg",,0.000066,43,1,0,1,1066,0,1066,0,0,0,0,0,0
8586490,"Savièse, centre scolaire",,0.000053,39,1,0,1,80,0,80,0,0,0,0,0,0
8595355,"St. Niklaus VS, Feuerwehrlokal",,0.000138,6,2,0,2,894,0,894,0,0,0,0,0,0
8595511,"Dietikon, Heimstrasse",,0.000239,85,6,0,6,58138,0,58138,0,0,0,0,0.000093,0
8595708,"Spreitenbach, Glattler",,0.000065,22,3,0,3,765,0,765,0,0,0,0,0.000011,0
8587118,"Hasle LU, Schulhaus",,0.000087,92,1,0,1,944,0,944,0,0,0,0,0,0
8594947,"La Plaine, douane",,0.000022,120,1,0,1,5298,0,5298,0,0,0,0,0,0
8587131,"Melano, Posta",,0.000041,99,1,0,1,8097,0,8097,0,0,0,0,0,0
8587215,"Sommeri, Kirche",,0.000081,121,3,0,3,5873,0,5873,0,0,0,0,0,0
8587190,"Oberaach, Schlösslipark",,0.000031,121,1,0,1,4705,0,4705,0,0,0,0,0,0
8587184,"Muolen, Sonnental",,0.000052,121,1,0,1,6892,0,6892,0,0,0,0,0,0
8587206,"Romanshorn, Weitenzelg",,0.000063,121,1,0,1,14516,0,14516,0,0,0,0,0,0
8587224,"Zihlschlacht, Mitteldorf",,0.000081,121,2,0,2,20625,0,20625,0,0,0,0,0,0
8587574,"Mägenwil, Dorf",,0.000039,22,1,0,1,7274,0,7274,0,0,0,0,0,0
8587448,Trachselwald,,0.000039,45,1,0,1,3410,0,3410,0,0,0,0,0,0
8588717,"Eriswil, Altersheim",,0.000078,45,2,0,2,3159,0,3159,0,0,0,0,0,0
8588512,"Wasen i.E., Dangeli",,0.000055,45,1,0,1,9093,0,9093,0,0,0,0,0,0
8587468,"Claro, Bivio per Scubiago",,0.000099,108,1,0,1,16687,0,16687,0,0,0,0,0,0
8587473,"Giornico, Biaschina",,0.000119,108,1,0,1,12752,0,12752,0,0,0,0,0,0
8594283,"Männedorf, Zentrum Leue",,0.000092,8,2,0,2,7289,0,7289,0,0,0,0,0,0
8587703,"Bitsch, Schulhaus",,0.000064,40,1,0,1,1934,0,1934,0,0,0,0,0,0
8591543,"Cevio, Visletto",,0.000042,101,2,0,2,17582,0,17582,0,0,0,0,0,0
8591550,"Losone, ai Mulini",,0.000077,101,2,0,2,9753,0,9753,0,0,0,0,0,0
8587781,"Kirchberg SG, Remis",,0.000054,20,1,0,1,2758,0,2758,0,0,0,0,0,0
8591032,"Zürich Flughafen, Werkhof",,0.000035,85,1,0,1,3780,0,3780,0,0,0,0,0.004458,0
8591855,"Wileroltigen, Feld",,0.000076,126,2,0,2,2589,0,2589,0,0,0,0,0,0
8587897,"Cinuos-chel, Suot il Chaunt",,0.000038,30,1,0,1,1965,0,1965,0,0,0,0,0,0
8595329,"Hombrechtikon, Hofacherstrasse",,0.000075,8,2,0,2,8332,0,8332,0,0,0,0,0,0
8588531,"Oetwil am See, Beichlen",,0.000029,84,1,0,1,7423,0,7423,0,0,0,0,0,0
8595487,"Jona, Buechstrasse West",,0.000058,67,3,0,3,5044,0,5044,0,0,0,0,0,0
8587949,"Stäfa, Wässerwies",,0.000063,8,1,0,1,6761,0,6761,0,0,0,0,0,0
8588532,"Mönchaltorf, Huebstock",,0.000059,84,1,0,1,20968,0,20968,0,0,0,0,0,0
8589281,"Fischenthal, Fistel",,0.000068,67,2,0,2,1005,0,1005,0,0,0,0,0,0
8588205,"Erlenbach ZH, Allmend",,0.000059,8,1,0,1,4299,0,4299,0,0,0,0,0,0
8590718,"Meilen, Schulhaus Obermeilen",,0.000046,8,2,0,2,5959,0,5959,0,0,0,0,0,0
8588034,"Meilen, Zur Au",,0.000078,8,2,0,2,5959,0,5959,0,0,0,0,0,0
8595723,"Herrliberg-Feldmeilen, Bhf Ost",,0.000183,8,2,0,2,8263,0,8263,0,0,0,0,0,0
8588043,"Rüti ZH, Steinstrasse",,0.000082,67,1,0,1,2144,0,2144,0,0,0,0,0,0
8588429,"Uetikon am See, Brandrain",,0.000041,84,1,0,1,6581,0,6581,0,0,0,0,0,0
8591857,"Uster, Loren-Allee",,0.000044,84,1,0,1,7174,0,7174,0,0,0,0,0,0
8588059,"Uster, Weidli",,0.000096,84,2,0,2,9021,0,9021,0,0,0,0,0,0
8588089,Kleingümmenen,,0.000052,126,1,0,1,3833,0,3833,0,0,0,0,0,0
8591839,"Spiez, Krone",,0.000102,43,2,0,2,1559,0,1559,0,0,0,0,0,0
8588295,"Varen, Deliry",,0.000039,40,1,0,1,6439,0,6439,0,0,0,0,0,0
8588868,"Guttet, Abzw. Umfahrung",,0.000039,40,1,0,1,3212,0,3212,0,0,0,0,0,0
8590450,"Erschmatt, Kreuzmatten",,0.000039,40,1,0,1,3947,0,3947,0,0,0,0,0,0
8588468,"Thörishaus, Stucki",,0.000062,126,1,0,1,5275,0,5275,0,0,0,0,0,0
8593492,"Wolhusen, Tropenhaus",,0.00007,92,2,0,2,850,0,850,0,0,0,0,0,0
8591928,"Thun, Westquartier",,0.000102,43,2,0,2,5780,0,5780,0,0,0,0,0,0
8588197,"Sevelen, Post",,0.000043,73,1,0,1,1568,0,1568,0,0,0,0,0,0
8588191,"Spiez, Sodmatte",,0.000034,43,1,0,1,1493,0,1493,0,0,0,0,0,0
8593772,Gryon-Chalméry,,0.000094,4,1,0,1,7821,0,7821,0,0,0,0,0,0
8592407,"Muotathal, Stützli",,0.000154,91,3,0,3,17402,0,17402,0,0,0,0,0,0
8595677,"Saignelégier, voirie",,0.000107,1,3,0,3,3423,0,3423,0,0,0,0,0,0
8594592,"Altstätten SG, Oberkirlen",,0.000196,73,3,0,3,44454,0,44454,0,0,0,0,0,0
8594294,"Schindellegi, Chaltenboden",,0.000084,91,1,0,1,6581,0,6581,0,0,0,0,0,0
8595495,"Boudry, centre sportif",,0.000062,105,1,0,1,10238,0,10238,0,0,0,0,0,0
8588286,"Susten, Kaplaneimatte",,0.000024,40,1,0,1,4447,0,4447,0,0,0,0,0,0
8588549,"La Tzoumaz, centre",,0.000071,122,1,0,1,1524,0,1524,0,0,0,0,0,0
8593266,"Koppigen, Gemeindeverwaltung",,0.000069,45,3,0,3,8123,0,8123,0,0,0,0,0,0
8588338,"Wollerau, Ried",,0.00007,113,1,0,1,16654,0,16654,0,0,0,0,0,0
8594510,"Leukerbad, Noyerstrasse",,0.000072,40,1,0,1,5986,0,5986,0,0,0,0,0,0
8588339,"Wollerau, Chüngentobel",,0.00007,113,1,0,1,18175,0,18175,0,0,0,0,0,0
8588378,"Röthenbach i.E., Feldmatt",,0.000078,123,1,0,1,11928,0,11928,0,0,0,0,0,0
8594291,"Langnau i.E., Kehr",,0.000062,123,1,0,1,2818,0,2818,0,0,0,0,0,0
8594290,"Bärau, Bäraupark",,0.00016,123,6,0,6,17577,0,17577,0,0,0,0,0,0
8588415,"Brienzerberg, Biel",,0.000065,114,1,0,1,975,0,975,0,0,0,0,0,0
8594536,"Thun, Zollhaus",,0.000058,43,2,0,2,2247,0,2247,0,0,0,0,0,0
8595626,"Oberlangenegg, Stalden",,0.000098,43,2,0,2,810,0,810,0,0,0,0,0,0
8595169,"Wimmis, Bachtele",,0.0001,43,1,0,1,630,0,630,0,0,0,0,0,0
8596116,"Sierre, Ecoparc de Daval",,0.00007,39,1,0,1,7184,0,7184,0,0,0,0,0,0
8594337,Schleitheim Adlerstrasse,,0.000026,66,1,0,1,3780,0,3780,0,0,0,0,0,0
8590600,"Egetswil, Dorf",,0.000063,107,2,0,2,26461,0,26461,0,0,0,0,0.000079,0
8591031,"Zürich Flughafen, REGA",,0.000033,107,1,0,1,25526,0,25526,0,0,0,0,0.000078,0
8595526,"Hätzingen, Feuerwehrgebäude",,0.000036,128,1,0,1,987,0,987,0,0,0,0,0,0
8593311,"Oppligen, Gemeindehaus",,0.00006,100,1,0,1,2575,0,2575,0,0,0,0,0,0
8595392,Seedorf Dorf,,0.000134,93,3,0,3,18571,0,18571,0,0,0,0,0,0
8595252,"Wuppenau, Gemeindehaus",,0.000094,20,2,0,2,9906,0,9906,0,0,0,0,0,0
8595173,"Coppet, route de Tannay",,0.000035,120,1,0,1,4700,0,4700,0,0,0,0,0,0
8595653,"Prangins, Bénex-Dessus",,0.00008,125,2,0,2,13580,0,13580,0,0,0,0,0,0
8590129,Wankdorf Bahnhof,,0.000194,44,4,0,4,35923,0,35923,0,0,0,0,0,0
8588829,"Murten, Combette",,0.000091,126,1,0,1,4227,0,4227,0,0,0,0,0,0
8596073,"Donatyre, école",,0.000192,13,2,0,2,3715,0,3715,0,0,0,0,0,0
8595510,"Wädenswil, Campus Rothus",,0.000017,63,1,0,1,3381,0,3381,0,0,0,0,0,0
8588800,"Mülenen, Bahnhof",,0.000113,43,1,0,1,722,0,722,0,0,0,0,0,0
8595877,"La Roche FR, école",,0.000031,126,1,0,1,3855,0,3855,0,0,0,0,0,0
8595694,"Chénens, gare",,0.000059,126,1,0,1,6254,0,6254,0,0,0,0,0,0
8595908,Pratteln Zurlinden,,0.000225,2,4,0,4,30288,0,30288,0,0,0,0,0,0
8594491,"Wald ZH, Nordeck",,0.000084,67,3,0,3,2961,0,2961,0,0,0,0,0,0
8588896,"Davos Dischma, Hof",,0.00005,131,1,0,1,5914,0,5914,0,0,0,0,0,0
8590124,Belp Eissel,,0.000054,100,1,0,1,6427,0,6427,0,0,0,0,0,0
8589514,Münsingen Friedhof,,0.000097,100,2,0,2,3082,0,3082,0,0,0,0,0,0
8589056,"Burgdorf, Lerchenbühlweg",,0.000049,45,2,0,2,9736,0,9736,0,0,0,0,0,0
8589058,"Burgdorf, Gsteighof",,0.000044,45,1,0,1,13679,0,13679,0,0,0,0,0,0
8595989,"Langnau i.E., Sonnenarena",,0.000105,123,2,0,2,6091,0,6091,0,0,0,0,0,0
8588969,"Leissigen, Bahnhof",,0.000063,43,1,0,1,6232,0,6232,0,0,0,0,0,0
8590063,Elfenau,,0.000075,44,2,0,2,6324,0,6324,0,0,0,0,0,0
8589036,Grauholzstrasse,,0.000061,44,1,0,1,3539,0,3539,0,0,0,0,0,0
8595603,Moosstrasse,,0.000075,44,2,0,2,3596,0,3596,0,0,0,0,0,0
8589052,"Moosseedorf, Rest. Utiger",,0.000054,87,1,0,1,56,0,56,0,0,0,0,0,0
8589542,Worblaufen,,0.000102,44,3,0,3,1456,0,1456,0,0,0,0,0,0
8589054,Aarmattweg,,0.000073,44,1,0,1,4136,0,4136,0,0,0,0,0,0
8595456,"Amriswil, Maihalde",,0.000124,121,1,0,1,16397,0,16397,0,0,0,0,0,0
8589240,"Lenk, Litte",,0.00003,23,1,0,1,4989,0,4989,0,0,0,0,0,0
8590851,"Volketswil, Chappeli",,0.000042,84,1,0,1,6341,0,6341,0,0,0,0,0,0
8589156,"Belfaux CFF, gare",,0.000064,126,1,0,1,3957,0,3957,0,0,0,0,0,0
8589191,"Schönenwerd SO,Schenker Storen",,0.000068,94,1,0,1,11479,0,11479,0,0,0,0,0,0
8594775,"Burgdorf, Zeughausstrasse",,0.000109,45,3,0,3,28314,0,28314,0,0,0,0,0,0
8593428,"Rotkreuz, Blegi",,0.000055,91,2,0,2,4041,0,4041,0,0,0,0,0,0
8595883,"Reiden, Industrie Weiher",,0.00005,94,1,0,1,8298,0,8298,0,0,0,0,0,0
8589379,Wolfschlucht,,0.000056,2,2,0,2,11032,0,11032,0,0,0,0,0,0
8589377,Wielandplatz,,0.000061,2,2,0,2,12347,0,12347,0,0,0,0,0,0
8595517,Weil am Rhein Grenze,,0.000082,2,3,0,3,4201,0,4201,0,0,0,0,0,0
8596011,Burgfelderhof,,0.000122,2,2,0,2,11886,0,11886,0,0,0,0,0,0
8589409,Rössliplatz,,0.000079,2,1,0,1,9135,0,9135,0,0,0,0,0,0
8589417,Lausen Ronda,,0.000048,2,1,0,1,17174,0,17174,0,0,0,0,0,0
8589438,"Rheinfelden, Stadtpark",,0.000058,2,1,0,1,7221,0,7221,0,0,0,0,0,0
8592339,Riehen Bahnhof,,0.000257,2,3,0,3,8475,0,8475,0,0,0,0,0,0
8589494,"Balerna, Via Sottobisio",,0.00006,99,1,0,1,6776,0,6776,0,0,0,0,0,0
8595642,"Morbio Inferiore, Via Vela",,0.000154,99,2,0,2,14730,0,14730,0,0,0,0,0,0
8589521,"Kandersteg, Kirche",,0.000054,43,1,0,1,4786,0,4786,0,0,0,0,0,0
8589541,"St. Margrethen SG, Nebengraben",,0.000048,73,1,0,1,11402,0,11402,0,0,0,0,0,0
8589547,"Schwändi b. Schwanden GL, Güetli",,0.000057,128,1,0,1,2002,0,2002,0,0,0,0,0,0
8589630,"St. Gallen, Steingrüebli",,0.000055,71,2,0,2,44814,0,44814,0,0,0,0,0,0
8589637,"St. Gallen, Uni/Dufourstrasse",,0.000042,71,1,0,1,46361,0,46361,0,0,0,0,0,0
8589739,Kriens Sidhalde,,0.000041,90,1,0,1,7112,0,7112,0,0,0,0,0,0
8589747,Kriens Zumhofstrasse,,0.000062,90,2,0,2,7129,0,7129,0,0,0,0,0,0
8589743,Kriens  Südstrasse,,0.000069,90,1,0,1,3481,0,3481,0,0,0,0,0,0
8589815,Luzern Mühlemattstrasse,,0.00003,90,1,0,1,9575,0,9575,0,0,0,0,0,0
8591688,Luzern Klinik St. Anna,,0.000083,90,1,0,1,31072,0,31072,0,0,0,0,0,0
8589851,Luzern Zähringerstrasse,,0.000094,90,1,0,1,37017,0,37017,0,0,0,0,0,0
8589853,Luzern Zumbachhof,,0.000175,90,3,0,3,39460,0,39460,0,0,0,0,0,0
8589854,Luzern Zwyssigplatz,,0.000055,90,1,0,1,61878,0,61878,0,0,0,0,0,0
8589859,Meggen Piuskirche,,0.000046,90,1,0,1,18383,0,18383,0,0,0,0,0,0
8595906,Emmenbrücke Bahnhof Süd,,0.000063,90,1,0,1,104991,0,104991,0,0,0,0,0,0
8594172,"Gunzgen, Industrie",,0.00005,94,2,0,2,14387,0,14387,0,0,0,0,0,0
8595230,"Holziken, Hirschthalerstrasse",,0.000053,94,1,0,1,6026,0,6026,0,0,0,0,0,0
8589893,"Mels, Oberheiligkreuz",,0.000049,73,1,0,1,6849,0,6849,0,0,0,0,0,0
8595645,"Gretschins, Magletsch",,0.000048,73,1,0,1,5580,0,5580,0,0,0,0,0,0
8594989,"St. Gallen Haggen, Bahnhof",,0.000184,71,2,0,2,25276,0,25276,0,0,0,0,0,0
8589907,"St. Gallen, Oberhofstetten",,0.000072,71,1,0,1,21042,0,21042,0,0,0,0,0,0
8589927,"Wil SG, Gallusstrasse",,0.000066,20,1,0,1,13975,0,13975,0,0,0,0,0,0
8589943,"Langenthal, Waldhof",,0.000077,88,1,0,1,13897,0,13897,0,0,0,0,0,0
8595142,Weissenbühl,,0.000075,44,3,0,3,19100,0,19100,0,0,0,0,0,0
8590075,"Bern, Neufeld P+R",,0.000144,44,2,0,2,39864,0,39864,0,0,0,0,0,0
8590044,Bümpliz,,0.000036,44,1,0,1,23843,0,23843,0,0,0,0,0,0
8590077,Ramuzstrasse,,0.00005,44,1,0,1,23717,0,23717,0,0,0,0,0,0
8595932,Köniz Schliern,,0.000097,44,2,0,2,11388,0,11388,0,0,0,0,0,0
8590074,Fährstrasse,,0.00006,44,1,0,1,7618,0,7618,0,0,0,0,0,0
8590119,Neumattweg,,0.000065,44,1,0,1,7002,0,7002,0,0,0,0,0,0
8590160,"Aarau, Neue Kantonsschule",,0.000078,57,2,0,2,5829,0,5829,0,0,0,0,0,0
8590394,"Baden, Dättwil Dorf",,0.000137,22,4,0,4,23487,0,23487,0,0,0,0,0.000015,0
8590236,"Ennetbaden, Schlieren",,0.000048,22,1,0,1,10171,0,10171,0,0,0,0,0.000004,0
8591710,"Wettingen, Bushof",,0.000037,22,2,0,2,8233,0,8233,0,0,0,0,0,0
8595203,"Rieden AG, Alte Landstrasse",,0.000135,22,3,0,3,12037,0,12037,0,0,0,0,0.000001,0
8590308,"Wettingen, Stadion",,0.000046,22,1,0,1,11829,0,11829,0,0,0,0,0,0
8594972,"Wettingen, Ligusterweg",,0.000037,22,1,0,1,2388,0,2388,0,0,0,0,0,0
8590330,"Oberbüren, Unterzil",,0.000066,71,1,0,1,10657,0,10657,0,0,0,0,0,0
8590334,"Gossau SG, Vogelsangweg",,0.000055,71,1,0,1,5683,0,5683,0,0,0,0,0,0
8595415,"Herisau, Toracker",,0.000059,71,1,0,1,3954,0,3954,0,0,0,0,0,0
8595967,"Herisau, Walke",,0.000036,71,1,0,1,15984,0,15984,0,0,0,0,0,0
8590345,"Herisau, Ufem Berg",,0.000046,71,1,0,1,8385,0,8385,0,0,0,0,0,0
8590349,"Herisau, Säge",,0.000113,71,1,0,1,29569,0,29569,0,0,0,0,0,0
8595414,"Herisau, Burghalde",,0.00006,71,1,0,1,15884,0,15884,0,0,0,0,0,0
8590363,"Herisau, Rohren",,0.000073,71,1,0,1,15336,0,15336,0,0,0,0,0,0
8595479,"Hünibach, Riedstrasse",,0.000077,43,2,0,2,418,0,418,0,0,0,0,0,0
8590415,"Obergösgen, Sandacker",,0.000063,94,1,0,1,10608,0,10608,0,0,0,0,0,0
8590434,"Starrkirch, Rütli",,0.000034,94,1,0,1,32945,0,32945,0,0,0,0,0,0
8590486,"Adliswil, Wanneten-/Haldenstr.",,0.00004,130,1,0,1,20963,0,20963,0,0,0,0,0,0
8590485,"Adliswil, Tobelhof",,0.000031,130,1,0,1,10480,0,10480,0,0,0,0,0,0
8596100,"Bassersdorf, Sportanlage",,0.000063,107,2,0,2,36503,0,36503,0,0,0,0,0.000075,0
8590533,"Dietikon, Stelzenacker",,0.000051,22,3,0,3,19900,0,19900,0,0,0,0,0,0
8590528,"Dietikon, Silbern",,0.000047,22,1,0,1,36697,0,36697,0,0,0,0,0,0
8591893,"Dietikon, Gyrhalden",,0.000041,22,1,0,1,15626,0,15626,0,0,0,0,0,0
8590584,"Dübendorf, Schossacher",,0.000045,129,1,0,1,19658,0,19658,0,0,0,0,0,0
8595412,"Horgen, Bergwerk",,0.000107,63,3,0,3,9423,0,9423,0,0,0,0,0,0
8590663,"Horgen, Wannenthal",,0.000038,63,1,0,1,2654,0,2654,0,0,0,0,0,0
8590705,"Küsnacht ZH, Zentrum",,0.000082,86,3,0,3,31465,0,31465,0,0,0,0,0,0
8594254,"Kilchberg ZH, Obere Hornhalde",,0.000084,130,2,0,2,6578,0,6578,0,0,0,0,0,0
8590700,"Kloten, Wallisellenstrasse",,0.000144,107,1,0,1,15229,0,15229,0,0,0,0,0,0
8590709,"Langnau am Albis, Unterrengg",,0.000032,63,1,0,1,1328,0,1328,0,0,0,0,0,0
8595707,"Nürensdorf, Zentrum Süd",,0.000154,84,2,0,2,8800,0,8800,0,0,0,0,0,0
8590852,"Volketswil, Milandia",,0.000065,84,1,0,1,11610,0,11610,0,0,0,0,0,0
8590750,"Opfikon, Vreniker",,0.000064,107,1,0,1,20852,0,20852,0,0,0,0,0,0
8590899,"Wallisellen, Zentrum",,0.000075,107,2,0,2,30602,0,30602,0,0,0,0,0.000028,0
8595712,"Rümlang, Hofwisenunterführung",,0.000054,107,1,0,1,14981,0,14981,0,0,0,0,0,0
8590829,"Thalwil, Trotte",,0.000082,130,2,0,2,3411,0,3411,0,0,0,0,0,0
8590830,"Thalwil, Zehntenstrasse",,0.000036,130,1,0,1,1293,0,1293,0,0,0,0,0,0
8595406,"Thalwil, Sonnenberg",,0.000074,130,1,0,1,2628,0,2628,0,0,0,0,0,0
8596007,"Schlieren, Geissweid",,0.000139,85,4,0,4,63797,0,63797,0,0,0,0,0.003431,0
8595520,"Wädenswil, Hintere Rüti Ost",,0.000118,63,3,0,3,14889,0,14889,0,0,0,0,0,0
8590870,"Wädenswil, Staubeweidli",,0.000067,63,1,0,1,3814,0,3814,0,0,0,0,0,0
8590873,"Wädenswil, Tiefenhofweiher",,0.000051,63,1,0,1,3281,0,3281,0,0,0,0,0,0
8590908,"Watt, Brünigstrasse",,0.000061,107,1,0,1,9140,0,9140,0,0,0,0,0.001191,0
8595714,"Regensdorf, Allmend",,0.000061,107,1,0,1,4568,0,4568,0,0,0,0,0.001191,0
8594553,"Opfikon, Schwimmbad",,0.000065,107,2,0,2,31284,0,31284,0,0,0,0,0.000883,0
8594338,"Wangen, Neuwisen",,0.000048,107,1,0,1,14800,0,14800,0,0,0,0,0,0
8593247,"Winterthur, Schachenweg",,0.000092,68,2,0,2,5904,0,5904,0,0,0,0,0,0
8591017,"Winterthur, Zentrum Seen",,0.000124,68,2,0,2,16620,0,16620,0,0,0,0,0,0
8591021,"Winterthur, Obstgartenweg",,0.000093,68,1,0,1,12657,0,12657,0,0,0,0,0,0
8591441,"Zürich, Zielweg",,0.00004,85,2,0,2,8946,0,8946,0,0,0,0,0.002996,0
8591440,"Zürich, Wonnebergstrasse",,0.000045,85,1,0,1,34368,0,34368,0,0,0,0,0,0
8591338,"Zürich, Schauenberg",,0.00003,85,1,0,1,16385,0,16385,0,0,0,0,0,0
8594250,"Binz bei Maur, Bautacher",,0.000154,85,3,0,3,14287,0,14287,0,0,0,0,0.002429,0
8591372,"Zürich, Solidapark",,0.000062,85,2,0,2,23311,0,23311,0,0,0,0,0.000101,0
8591383,"Zürich, Stierenried",,0.000025,85,1,0,1,33015,0,33015,0,0,0,0,0.000294,0
8594185,"Glattpark, Wright-Strasse",,0.000029,85,1,0,1,50505,0,50505,0,0,0,0,0.000003,0
8594239,"Zürich, Schiffbau",,0.000513,85,11,0,11,245350,0,245350,0,0,0,0,0.026985,0
8591824,"Zürich, Binz",,0.000054,85,1,0,1,40844,0,40844,0,0,0,0,0.004672,0
8595899,"Zürich, Glaubtenstrasse Nord",,0.000166,85,3,0,3,51373,0,51373,0,0,0,0,0.001416,0
8596008,"Zürich, Hermetschloo",,0.00007,85,2,0,2,57198,0,57198,0,0,0,0,0.000333,0
8591410,"Zürich, Verenastrasse",,0.000057,85,1,0,1,57319,0,57319,0,0,0,0,0,0
8591387,"Zürich, Sukkulentensammlung",,0.000049,85,1,0,1,45182,0,45182,0,0,0,0,0,0
8591418,"Zürich, Waidhof",,0.000063,85,1,0,1,30582,0,30582,0,0,0,0,0,0
8591444,"Zürich, Zürichbergstrasse",,0.000096,85,2,0,2,48686,0,48686,0,0,0,0,0.001301,0
8591425,"Zürich, Weihersteig",,0.000039,85,1,0,1,28075,0,28075,0,0,0,0,0.000129,0
8596006,"Schlieren, Meuchwis",,0.000112,85,1,0,1,4819,0,4819,0,0,0,0,0,0
8591903,"Zollikerberg, Spital",,0.00006,129,1,0,1,13102,0,13102,0,0,0,0,0,0
8595717,"Adliswil, Grundstrasse",,0.000046,85,1,0,1,5212,0,5212,0,0,0,0,0.000837,0
8594255,"Zürich, Schanzackerstrasse",,0.000075,85,1,0,1,5036,0,5036,0,0,0,0,0.000031,0
8595977,"Buchs SG, Distelweg",,0.000109,73,3,0,3,12675,0,12675,0,0,0,0,0,0
8594969,"Cumiasca, Cortia",,0.000062,108,1,0,1,4890,0,4890,0,0,0,0,0,0
8595910,"Aquila, Cresedo",,0.000088,108,2,0,2,12517,0,12517,0,0,0,0,0,0
8594456,"Mendrisio, Asilo Sud",,0.000042,99,1,0,1,13568,0,13568,0,0,0,0,0,0
8593491,"Riva S. Vitale, Poiana (Bus)",,0.000056,99,1,0,1,8039,0,8039,0,0,0,0,0,0
8595550,"Locarno, Scuola Media",,0.000074,101,1,0,1,8783,0,8783,0,0,0,0,0,0
8591566,"Porto Ronco, Rivabella",,0.000047,101,1,0,1,13747,0,13747,0,0,0,0,0,0
8591617,"Lugano, Belvedere",,0.000043,102,1,0,1,952,0,952,0,0,0,0,0,0
8595132,"Lugano, Pista Ghiaccio",,0.000153,102,4,0,4,75229,0,75229,0,0,0,0,0,0
8591640,"Pazzallo, Senago Bassa",,0.000042,102,1,0,1,6255,0,6255,0,0,0,0,0,0
8591682,"Wil SG, Klosterwiese",,0.000108,20,2,0,2,35238,0,35238,0,0,0,0,0,0
8591676,"Wil SG, Bienenstrasse",,0.000046,20,1,0,1,13958,0,13958,0,0,0,0,0,0
8591701,Merlischachen Camping,,0.000063,90,1,0,1,135,0,135,0,0,0,0,0,0
8591858,"Jona, Hummelberg",,0.000044,67,2,0,2,9740,0,9740,0,0,0,0,0,0
8591745,"Jona, Wohnheim Balm",,0.00007,67,2,0,2,14194,0,14194,0,0,0,0,0,0
8591869,"Jona, Raineggstrasse",,0.000088,67,1,0,1,6318,0,6318,0,0,0,0,0,0
8594202,"Jona, Schachen",,0.000075,67,1,0,1,12783,0,12783,0,0,0,0,0,0
8591773,"Lenk, Ritzdole",,0.000063,23,1,0,1,1273,0,1273,0,0,0,0,0,0
8591790,"Willisau, Friedhof",,0.000099,59,1,0,1,2625,0,2625,0,0,0,0,0,0
8594468,"Wilen bei Wil, Engi",,0.00006,20,1,0,1,27650,0,27650,0,0,0,0,0,0
8591803,"Ruvigliana, Paese",,0.000057,102,1,0,1,17841,0,17841,0,0,0,0,0,0
8591804,"Pregassona, Piazza di Giro",,0.000087,102,3,0,3,49954,0,49954,0,0,0,0,0,0
8595974,"Scairolo, Posteggio Nucleo",,0.000042,102,1,0,1,3851,0,3851,0,0,0,0,0,0
8594226,"Paradiso, Via Calprino",,0.000123,102,2,0,2,40009,0,40009,0,0,0,0,0,0
8595984,"Les Paccots, Moille au Critsou",,0.000068,12,1,0,1,5647,0,5647,0,0,0,0,0,0
8595441,"Goldach, Rosenackerstrasse",,0.000048,72,1,0,1,7666,0,7666,0,0,0,0,0,0
8595494,Hergiswil Mattli,,0.00009,90,1,0,1,81,0,81,0,0,0,0,0,0
8592133,"Lausanne, Vigie",,0.000037,5,1,0,1,69093,0,69093,0,0,0,0,0,0
8594198,"Wallisellen, Glatt (Tram)",,0.000222,85,1,0,1,35271,0,35271,0,0,0,0,0,0
8596113,"Dübendorf, Hochbord Süd",,0.000099,85,2,0,2,25747,0,25747,0,0,0,0,0,0
8596005,"Binz bei Maur, Twäracher",,0.00005,85,1,0,1,18579,0,18579,0,0,0,0,0.000077,0
8595963,"Yvorne, Socrettaz",,0.000057,103,1,0,1,2709,0,2709,0,0,0,0,0,0
8591889,"Wynigen, Grüttermatt",,0.000076,88,1,0,1,8758,0,8758,0,0,0,0,0,0
8591924,"Thun, Sustenstrasse",,0.000057,43,1,0,1,5722,0,5722,0,0,0,0,0,0
8591929,"Thun, Zentrum Oberland",,0.000068,43,2,0,2,5994,0,5994,0,0,0,0,0,0
8592123,"Lausanne, Trabandan",,0.000023,10,1,0,1,19315,0,19315,0,0,0,0,0,0
8592112,"Lausanne, Rozavère",,0.000046,10,1,0,1,33369,0,33369,0,0,0,0,0,0
8593821,"Epalinges, Marcel Regamey",,0.00005,13,1,0,1,11288,0,11288,0,0,0,0,0,0
8592129,"Lausanne, Verdeil",,0.000047,10,1,0,1,31596,0,31596,0,0,0,0,0,0
8593838,"Lausanne, Maladière-Lac",,0.000036,10,1,0,1,42411,0,42411,0,0,0,0,0,0
8592135,"Lausanne, Vinet",,0.000044,10,1,0,1,39716,0,39716,0,0,0,0,0,0
8592136,"Lausanne, Virgile-Rossel",,0.00007,10,1,0,1,40681,0,40681,0,0,0,0,0,0
8593844,"Lausanne,Vallée de la Jeunesse",,0.000083,10,2,0,2,28995,0,28995,0,0,0,0,0,0
8593845,"Le Mont-s.-Laus., Coppoz-Poste",,0.000091,5,2,0,2,53513,0,53513,0,0,0,0,0,0
8593861,"Lutry, gare",,0.000115,10,3,0,3,18176,0,18176,0,0,0,0,0,0
8593849,"Cery-Fleur-de-Lys, gare",,0.000063,5,2,0,2,392,0,392,0,0,0,0,0,0
8592192,"Prilly, Perréaz",,0.000032,5,1,0,1,57522,0,57522,0,0,0,0,0,0
8592195,"Pully, Reymondin",,0.000064,10,2,0,2,49028,0,49028,0,0,0,0,0,0
8592196,"Pully, Roses",,0.000046,10,1,0,1,45737,0,45737,0,0,0,0,0,0
8592199,"Pully, Vignes",,0.000082,10,1,0,1,36900,0,36900,0,0,0,0,0,0
8592220,"Renens VD, Saugiaz",,0.00006,5,1,0,1,18047,0,18047,0,0,0,0,0,0
8592222,"Renens VD, Sur-la-Croix",,0.000058,5,1,0,1,43674,0,43674,0,0,0,0,0,0
8592234,"Savigny, St-Amour",,0.000127,13,1,0,1,5690,0,5690,0,0,0,0,0,0
8596052,"Echichens, Crêt",,0.000086,5,3,0,3,29928,0,29928,0,0,0,0,0,0
8596054,"Morges, En Bonjean",,0.000256,5,4,0,4,47966,0,47966,0,0,0,0,0,0
8594068,"Bäch SZ, Usserbäch",,0.000065,113,1,0,1,15303,0,15303,0,0,0,0,0,0
8592300,"Pfäffikon SZ, Sonnenhof",,0.000049,113,1,0,1,21237,0,21237,0,0,0,0,0,0
8592307,Niederdorf Station,,0.000044,2,1,0,1,6455,0,6455,0,0,0,0,0,0
8592318,"Adelboden, Zürcherhaus",,0.000071,43,1,0,1,3560,0,3560,0,0,0,0,0,0
8592320,"Kandersteg, Gemeindehaus",,0.000057,43,1,0,1,1114,0,1114,0,0,0,0,0,0
8592393,"Villars-sur-Glâne, Marteray",,0.000353,126,4,0,4,22924,0,22924,0,0,0,0,0,0
8592378,"Villars-sur-Glâne,Jean Paul II",,0.000083,126,1,0,1,32629,0,32629,0,0,0,0,0,0
8592387,"Fribourg, Planche-Inférieure",,0.000049,126,2,0,2,17883,0,17883,0,0,0,0,0,0
8592388,"Fribourg, Porte-de-Berne",,0.000025,126,1,0,1,18715,0,18715,0,0,0,0,0,0
8594997,"Schwyz, Riedbrücke",,0.000078,91,1,0,1,6048,0,6048,0,0,0,0,0,0
8592430,"Weggis, Paradiesweg",,0.000046,91,1,0,1,9332,0,9332,0,0,0,0,0,0
8592431,"Weggis, Post",,0.000046,91,1,0,1,9436,0,9436,0,0,0,0,0,0
8593387,"Les Prés-d'Orvin, Ch. Cernils",,0.000054,87,1,0,1,2192,0,2192,0,0,0,0,0,0
8592492,"Vauffelin, Route de Plagne",,0.000075,87,1,0,1,2981,0,2981,0,0,0,0,0,0
8592586,Waldfriedhof,,0.000095,66,3,0,3,20168,0,20168,0,0,0,0,0,0
8592559,Kinepolis,,0.000038,66,1,0,1,15117,0,15117,0,0,0,0,0,0
8595929,Kleinbuchberg,,0.000028,66,1,0,1,5008,0,5008,0,0,0,0,0,0
8595930,IWC Uhrenmanufaktur,,0.000063,66,2,0,2,4907,0,4907,0,0,0,0,0,0
8592582,Stimmerstrasse,,0.00005,66,2,0,2,9928,0,9928,0,0,0,0,0,0
8592588,Wiesli,,0.000139,66,3,0,3,35004,0,35004,0,0,0,0,0,0
8592585,Vögelingässchen,,0.000045,66,1,0,1,5823,0,5823,0,0,0,0,0,0
8595590,Ramsen Brücke,,0.000137,65,2,0,2,5288,0,5288,0,0,0,0,0,0
8592578,Sennerei,,0.000051,66,1,0,1,19518,0,19518,0,0,0,0,0,0
8592587,Wiesenweg,,0.000061,66,1,0,1,19157,0,19157,0,0,0,0,0,0
8592617,Rosenbergstrasse,,0.000092,66,1,0,1,3211,0,3211,0,0,0,0,0,0
8592613,"Davos Dorf, Dischmakreuzung",,0.000058,131,1,0,1,14491,0,14491,0,0,0,0,0,0
8595440,"Davos Dorf, Stilli Park",,0.000082,131,2,0,2,15792,0,15792,0,0,0,0,0,0
8595556,"Aire-la-Ville, croisée",,0.000059,120,2,0,2,18095,0,18095,0,0,0,0,0,0
8595953,"Avully, Bachères",,0.00005,132,2,0,2,25463,0,25463,0,0,0,0,0,0
8595021,"Genève, Palais Eynard",,0.000117,132,4,0,4,110339,0,110339,0,0,0,0,0,0
8592928,"Genève, Wendt",,0.000041,132,1,0,1,46889,0,46889,0,0,0,0,0,0
8596094,"Genève, Dancet",,0.000042,132,2,0,2,26461,0,26461,0,0,0,0,0,0
8592953,"Grand-Saconnex, Tunnel Routier",,0.000055,132,2,0,2,70293,0,70293,0,0,0,0,0,0
8595224,"Bernex, Sézenove-Ferrand",,0.00007,120,2,0,2,16702,0,16702,0,0,0,0,0,0
8595457,"Gy, Baraque-à-Cloud",,0.000053,132,1,0,1,8017,0,8017,0,0,0,0,0,0
8594933,"Meyrin, Bois-du-Lan",,0.000097,132,2,0,2,27997,0,27997,0,0,0,0,0,0
8593068,"Plan-les-Ouates, Serves",,0.00005,132,1,0,1,19394,0,19394,0,0,0,0,0,0
8595036,"Plan-les-Ouates, Manufactures",,0.000059,132,3,0,3,16661,0,16661,0,0,0,0,0,0
8595034,"Perly, Ravières",,0.000022,132,1,0,1,35196,0,35196,0,0,0,0,0,0
8593078,"Pregny, Penthes",,0.000065,132,1,0,1,25849,0,25849,0,0,0,0,0,0
8595039,"Presinge, Basselat",,0.000128,132,2,0,2,17736,0,17736,0,0,0,0,0,0
8596098,"Grand-Saconnex, Aéroport-P47",,0.000102,132,4,0,4,23010,0,23010,0,0,0,0,0,0
8595027,"Meyrin, De-Joinville",,0.000296,132,3,0,3,57014,0,57014,0,0,0,0,0,0
8595672,"Satigny, Peney-Dessus",,0.000056,132,2,0,2,11918,0,11918,0,0,0,0,0,0
8593196,"Vessy, Combettes",,0.000052,120,1,0,1,18865,0,18865,0,0,0,0,0,0
8595015,"Carouge GE, Battelle",,0.000116,133,1,0,1,9789,0,9789,0,0,0,0,0,0
8595405,"Horgen, Aamüli",,0.000077,63,1,0,1,2657,0,2657,0,0,0,0,0,0
8593254,"Scheuren, Räbhubel",,0.000045,87,1,0,1,8959,0,8959,0,0,0,0,0,0
8594774,"Burgdorf, Staldenstrasse",,0.000157,45,2,0,2,5947,0,5947,0,0,0,0,0,0
8593274,"Sumiswald, Dorfgasse",,0.000069,45,1,0,1,8825,0,8825,0,0,0,0,0,0
8593485,"Bulle, Stade",,0.000079,13,2,0,2,26701,0,26701,0,0,0,0,0,0
8593363,"Biel/Bienne, Rebenweg/Vignes",,0.000069,87,1,0,1,16318,0,16318,0,0,0,0,0,0
8596001,"Biel/Bienne, Sägefeldweg/Scie.",,0.0001,87,2,0,2,48485,0,48485,0,0,0,0,0,0
8596002,"Brügg BE, Industriestrasse",,0.00007,87,2,0,2,4974,0,4974,0,0,0,0,0,0
8595238,"Biel/Bienne, Sonnhalde",,0.000076,87,1,0,1,22685,0,22685,0,0,0,0,0,0
8596000,"Biel/Bienne, Schüsspark",,0.000056,87,1,0,1,29773,0,29773,0,0,0,0,0,0
8595071,"Biel/Bienne, Bärletweg",,0.00005,87,1,0,1,15887,0,15887,0,0,0,0,0,0
8595689,"Biel/Bienne, Dahlienweg",,0.00005,87,1,0,1,15737,0,15737,0,0,0,0,0,0
8594385,"Langenthal, Zelgligasse",,0.000066,88,1,0,1,6947,0,6947,0,0,0,0,0,0
8593539,"Orsières, La Place",,0.000052,104,1,0,1,1095,0,1095,0,0,0,0,0,0
8595612,"Champex, piscine",,0.00009,104,1,0,1,1395,0,1395,0,0,0,0,0,0
8593545,"Cortaillod, Câbles",,0.000044,105,1,0,1,2179,0,2179,0,0,0,0,0,0
8594603,"Neuchâtel, Temple Valangines",,0.000085,48,2,0,2,48113,0,48113,0,0,0,0,0,0
8593597,Fontaine-André,,0.000074,48,1,0,1,18616,0,18616,0,0,0,0,0,0
8594499,"La Chaux-de-F, Eplatures Nord",,0.000089,134,4,0,4,46299,0,46299,0,0,0,0,0,0
8593705,"La Chaux-de-Fonds, Charrière",,0.00012,134,1,0,1,44866,0,44866,0,0,0,0,0,0
8593712,"La Chaux-de-F, La Joux-Perret",,0.000088,134,2,0,2,19306,0,19306,0,0,0,0,0,0
8593710,"La Chaux-de-Fonds, Arêtes",,0.000045,134,1,0,1,46435,0,46435,0,0,0,0,0,0
8594498,Orée-du-Bois,,0.000068,134,1,0,1,21543,0,21543,0,0,0,0,0,0
8593776,Plan Morier,,0.000077,4,1,0,1,8002,0,8002,0,0,0,0,0,0
8594178,"Bussigny, Rente",,0.000119,5,2,0,2,39270,0,39270,0,0,0,0,0,0
8595978,"Villars-Ste-Croix, Colice",,0.00013,5,2,0,2,14646,0,14646,0,0,0,0,0,0
8593898,"Nyon, rte de Saint-Cergue",,0.000068,125,1,0,1,13754,0,13754,0,0,0,0,0,0
8593992,"Vevey, funiculaire",,0.000067,12,1,0,1,7623,0,7623,0,0,0,0,0,0
8595070,"Yverdon-les-Bains, Valentin",,0.000104,35,2,0,2,18994,0,18994,0,0,0,0,0,0
8596076,"Cheseaux-N., Coteau des Ifs",,0.00005,35,1,0,1,13503,0,13503,0,0,0,0,0,0
8595201,"Lyss, KUFA",,0.000062,87,1,0,1,82,0,82,0,0,0,0,0,0
8594100,"Bettlach, Sonnenrain",,0.000061,127,1,0,1,3330,0,3330,0,0,0,0,0,0
8594143,"Grenchen, Simplon",,0.000041,127,2,0,2,10859,0,10859,0,0,0,0,0,0
8594144,"Grenchen, Sportstrasse",,0.000067,127,1,0,1,4846,0,4846,0,0,0,0,0,0
8594148,"Grenchen, Waldegg",,0.000067,127,1,0,1,5236,0,5236,0,0,0,0,0,0
8596122,"Lengnau BE, Industrie",,0.000185,87,2,0,2,4074,0,4074,0,0,0,0,0,0
8594302,"Grenchen, Centralstrasse",,0.000147,127,1,0,1,7062,0,7062,0,0,0,0,0,0
8594384,"Wil SG, Quellenstrasse",,0.000111,20,1,0,1,28143,0,28143,0,0,0,0,0,0
8594170,"Orpund, Neumatt",,0.000063,87,1,0,1,17702,0,17702,0,0,0,0,0,0
8594190,"Wallisellen, Guggenbühlstrasse",,0.000074,107,1,0,1,6858,0,6858,0,0,0,0,0,0
8594297,"Seuzach, Breitestrasse",,0.00019,68,1,0,1,3609,0,3609,0,0,0,0,0,0
8594201,Anna-Seiler-Haus,,0.000077,44,1,0,1,10030,0,10030,0,0,0,0,0,0
8594282,"Bottenwil, Stäpflistrasse",,0.00005,94,1,0,1,3941,0,3941,0,0,0,0,0,0
8594216,"Breganzona, Vergiò",,0.000058,102,1,0,1,8627,0,8627,0,0,0,0,0,0
8594221,"Lugano, Conservatorio",,0.000026,102,1,0,1,4298,0,4298,0,0,0,0,0,0
8595496,"Lugano, Cà Rezzonico",,0.000179,102,3,0,3,35846,0,35846,0,0,0,0,0,0
8594223,"Lugano, Moncucco Scuole",,0.000033,102,1,0,1,4330,0,4330,0,0,0,0,0,0
8594228,"Suvigliana, Funicolare",,0.000079,102,1,0,1,11818,0,11818,0,0,0,0,0,0
8595595,"Pontresina, Gitögla",,0.000075,30,1,0,1,1421,0,1421,0,0,0,0,0,0
8594990,"Enney, village",,0.00005,13,1,0,1,440,0,440,0,0,0,0,0,0
8594310,"Würenlos, Steigass",,0.000079,22,1,0,1,5314,0,5314,0,0,0,0,0,0
8595613,"St. Gallen, Karlstor",,0.000099,71,2,0,2,21725,0,21725,0,0,0,0,0,0
8594930,"Aarau, Kettenbrücke",,0.00025,57,3,0,3,4050,0,4050,0,0,0,0,0,0
8594461,"Mendrisio, Via Morée",,0.00019,99,1,0,1,17972,0,17972,0,0,0,0,0,0
8594512,"Leukerbad, Therme/Rehazentrum",,0.000066,40,1,0,1,3169,0,3169,0,0,0,0,0,0
8594543,"Wetzikon ZH, Widum",,0.000058,84,1,0,1,2640,0,2640,0,0,0,0,0,0
8594593,"Altstätten SG, Feldstrasse",,0.000056,73,1,0,1,743,0,743,0,0,0,0,0,0
8595248,La Coudre,,0.000123,48,1,0,1,48360,0,48360,0,0,0,0,0,0
8594876,Nid-du-Crô,,0.000165,48,1,0,1,13162,0,13162,0,0,0,0,0,0
8595608,"Sierre, Rossfeld",,0.000128,39,3,0,3,17886,0,17886,0,0,0,0,0,0
8594638,"Sierre, Home Beaulieu",,0.000044,39,1,0,1,16223,0,16223,0,0,0,0,0,0
8596125,"Les Reussilles, Le Préparotte",,0.000161,1,1,0,1,2710,0,2710,0,0,0,0,0,0
8594645,"Uetikon am See, Stötzli",,0.000041,84,1,0,1,2135,0,2135,0,0,0,0,0,0
8594714,"Sierre, Le Bourgeois Nord",,0.000135,39,2,0,2,5961,0,5961,0,0,0,0,0,0
8595698,"Montana, Sur Moubra",,0.000086,39,2,0,2,5366,0,5366,0,0,0,0,0,0
8594720,"Montana, Vermala Cervin",,0.000059,39,1,0,1,4299,0,4299,0,0,0,0,0,0
8595922,"Egerkingen, Bielgraben",,0.000084,94,1,0,1,14409,0,14409,0,0,0,0,0,0
8594783,"Givisiez, rte des Fluides",,0.000077,126,1,0,1,35557,0,35557,0,0,0,0,0,0
8595662,"Oberkirch, Schule",,0.00009,92,1,0,1,875,0,875,0,0,0,0,0,0
8595146,"Lenk, Stein",,0.00007,23,2,0,2,706,0,706,0,0,0,0,0,0
8595247,"Colombier NE, Bas-des-Allées",,0.000122,48,1,0,1,12917,0,12917,0,0,0,0,0,0
8594988,"St-Sulpice VD, Venoge nord",,0.000044,5,1,0,1,30667,0,30667,0,0,0,0,0,0
8594906,"Kreuzlingen Hafen, Bahnhof",,0.000094,65,1,0,1,614,0,614,0,0,0,0,0,0
8594976,"Lenk, Flüehlistrasse",,0.00004,23,1,0,1,4271,0,4271,0,0,0,0,0,0
8594924,"Weissenbach, Dorf",,0.000063,13,1,0,1,1952,0,1952,0,0,0,0,0,0
8596016,Signalstrasse,,0.000185,2,1,0,1,8238,0,8238,0,0,0,0,0,0
8596104,"Adelboden, Mudi",,0.00004,43,1,0,1,3464,0,3464,0,0,0,0,0,0
8594987,"Chavannes-R., Mouline",,0.000057,5,1,0,1,33598,0,33598,0,0,0,0,0,0
8595231,"Ibach, Kapelle",,0.00006,91,1,0,1,2330,0,2330,0,0,0,0,0,0
8595634,"Schwyz, Bachmatt",,0.00006,91,1,0,1,5813,0,5813,0,0,0,0,0,0
8595005,"Le Mont-sur-Lausanne,Maillefer",,0.000035,10,1,0,1,26514,0,26514,0,0,0,0,0,0
8595016,"Anières, Chevrens",,0.000056,132,1,0,1,13054,0,13054,0,0,0,0,0,0
8595012,"Avusy, Moulin de la Grave",,0.000057,132,1,0,1,8709,0,8709,0,0,0,0,0,0
8595043,"Bernex, Sézenove-village",,0.000028,120,1,0,1,23502,0,23502,0,0,0,0,0,0
8595052,"Vernier, Signal",,0.000049,132,1,0,1,5391,0,5391,0,0,0,0,0,0
8595458,"Meyrin, Bugnons",,0.000052,132,1,0,1,20996,0,20996,0,0,0,0,0,0
8595139,"Vessy, Drize",,0.00011,132,1,0,1,19018,0,19018,0,0,0,0,0,0
8595038,"Plan-les-Ouates, Verbant",,0.000051,132,1,0,1,11539,0,11539,0,0,0,0,0,0
8595952,"Satigny, ZIMEYSA-Ouest",,0.000114,132,1,0,1,11921,0,11921,0,0,0,0,0,0
8595249,"Orbe, Petit-Bois",,0.000064,35,1,0,1,5255,0,5255,0,0,0,0,0,0
8595161,"Yverdon, Petits-Champs",,0.000057,35,1,0,1,8791,0,8791,0,0,0,0,0,0
8595069,"Yverdon-les-Bains, rue du Midi",,0.00006,35,1,0,1,23169,0,23169,0,0,0,0,0,0
8595656,"Chamblon, La Meunière",,0.00011,35,2,0,2,6387,0,6387,0,0,0,0,0,0
8595129,"Dietlikon, Rebackerweg",,0.000114,129,3,0,3,6355,0,6355,0,0,0,0,0,0
8595176,"Nierlet-les-Bois, Prali Simon",,0.000046,126,1,0,1,2432,0,2432,0,0,0,0,0,0
8595878,"Ponthaux, auberge",,0.000046,126,1,0,1,2897,0,2897,0,0,0,0,0,0
8595126,"Bulle, Xavier-de-Poret",,0.000071,13,1,0,1,13529,0,13529,0,0,0,0,0,0
8595135,"Lugano, Via Olgiati",,0.000207,102,1,0,1,42367,0,42367,0,0,0,0,0,0
8596103,"Frutigen, Widigasse",,0.000067,43,1,0,1,10207,0,10207,0,0,0,0,0,0
8595148,"Crissier, Chisaz",,0.000038,5,1,0,1,8368,0,8368,0,0,0,0,0,0
8595705,Schmittiplatz,,0.000043,2,1,0,1,1399,0,1399,0,0,0,0,0,0
8595168,"Teuffenthal, Halten",,0.000042,43,1,0,1,690,0,690,0,0,0,0,0,0
8595905,"Eysins, Terre-Bonne nord",,0.000059,125,1,0,1,10289,0,10289,0,0,0,0,0,0
8595189,"Sool, Untersool",,0.000039,128,1,0,1,3241,0,3241,0,0,0,0,0,0
8595625,"Belmont-sur-Lausanne, Pâquis",,0.000058,10,1,0,1,13901,0,13901,0,0,0,0,0,0
8595219,"Lonay, collège nord",,0.000068,5,3,0,3,11691,0,11691,0,0,0,0,0,0
8596053,"Ecublens VD, Blévallaire",,0.000081,5,1,0,1,33940,0,33940,0,0,0,0,0,0
8595229,"Choulex, Champ-Dollon-Sud",,0.000067,133,1,0,1,5948,0,5948,0,0,0,0,0,0
8595227,"Presinge, L'Avenir croisée",,0.00007,132,1,0,1,19158,0,19158,0,0,0,0,0,0
8595265,"Kempten, Summerau",,0.000116,84,1,0,1,1607,0,1607,0,0,0,0,0,0
8595331,"Wetzikon ZH, Robenhausen",,0.000065,84,1,0,1,2755,0,2755,0,0,0,0,0,0
8595370,"Gams, Pilgerbrunnen",,0.00012,73,1,0,1,7527,0,7527,0,0,0,0,0,0
8595404,"Flums, Laurentius",,0.000104,124,2,0,2,6428,0,6428,0,0,0,0,0,0
8595390,"Oberstetten, Dorf",,0.00007,20,1,0,1,9537,0,9537,0,0,0,0,0,0
8595482,"Les Granges (Orbe), gare",,0.00016,35,2,0,2,23172,0,23172,0,0,0,0,0,0
8596123,"Goldach, Klosterstrasse",,0.000131,72,1,0,1,13442,0,13442,0,0,0,0,0,0
8595875,"Itaslen, Alte Landstrasse",,0.00005,20,1,0,1,2747,0,2747,0,0,0,0,0,0
8595501,"Küssnacht am Rigi, Gloritobel",,0.00008,91,1,0,1,6113,0,6113,0,0,0,0,0,0
8595485,"Visp, Sportplatz",,0.000138,40,1,0,1,7039,0,7039,0,0,0,0,0,0
8596097,"Mies, gare",,0.000117,125,1,0,1,83,0,83,0,0,0,0,0,0
8595986,"Crissier, Lentillières",,0.000043,5,1,0,1,27465,0,27465,0,0,0,0,0,0
8595527,"Luchsingen, Freihof",,0.000042,128,1,0,1,1185,0,1185,0,0,0,0,0,0
8595531,Thayngen Schule,,0.000102,66,1,0,1,1203,0,1203,0,0,0,0,0,0
8595602,"Chavannes-R., Dorigny",,0.000059,5,1,0,1,39412,0,39412,0,0,0,0,0,0
8595540,"Widnau, Schlatt",,0.000067,73,1,0,1,13682,0,13682,0,0,0,0,0,0
8595565,"Steffisburg, Engerain",,0.00009,43,1,0,1,2159,0,2159,0,0,0,0,0,0
8595599,"Nyon, Usine à Gaz",,0.000056,125,1,0,1,8240,0,8240,0,0,0,0,0,0
8595598,"Nyon, Petite Prairie",,0.000089,125,2,0,2,28089,0,28089,0,0,0,0,0,0
8595605,Rütti-Hochschule,,0.000071,44,1,0,1,3264,0,3264,0,0,0,0,0,0
8595624,"Lenk, Rufeli",,0.000064,23,1,0,1,1715,0,1715,0,0,0,0,0,0
8595633,"Weggis, Under Linde",,0.000079,91,1,0,1,2260,0,2260,0,0,0,0,0,0
8595648,"Apples, gare",,0.000039,5,1,0,1,4628,0,4628,0,0,0,0,0,0
8595661,"L'Isle, Les Tigneuses",,0.000125,5,1,0,1,3750,0,3750,0,0,0,0,0,0
8595655,Neunkirch Schulstrasse,,0.000057,66,1,0,1,6441,0,6441,0,0,0,0,0,0
8595675,"Versoix, Moulin-de-Richelien",,0.000083,135,1,0,1,14255,0,14255,0,0,0,0,0,0
8595674,"Meinier, Rouelbeau",,0.000056,132,1,0,1,6095,0,6095,0,0,0,0,0,0
8595693,"Ecuvillens, Aérodrome",,0.000096,126,1,0,1,2548,0,2548,0,0,0,0,0,0
8595949,"Altstätten SG, Bleichi",,0.00009,73,1,0,1,7337,0,7337,0,0,0,0,0,0
8595704,Breiti,,0.000082,2,1,0,1,6815,0,6815,0,0,0,0,0,0
8595713,"Rümlang, Zürichweg",,0.000091,85,1,0,1,2640,0,2640,0,0,0,0,0,0
8595725,"Chur, Rheinfels",,0.000415,109,1,0,1,28742,0,28742,0,0,0,0,0,0
8595731,"Riex, Mouniaz",,0.000109,10,1,0,1,2033,0,2033,0,0,0,0,0,0
8595872,"St. Gallen, Schuppis Nord",,0.000079,71,1,0,1,19989,0,19989,0,0,0,0,0,0
8595880,"Murten, Hafen",,0.000139,126,1,0,1,3007,0,3007,0,0,0,0,0,0
8595882,"Davos Dischma, Jenatschalp",,0.000034,131,1,0,1,1145,0,1145,0,0,0,0,0,0
8595939,"Lausanne, Parc Bourget",,0.000059,10,1,0,1,29264,0,29264,0,0,0,0,0,0
8595951,"Dardagny, Malval-Centre Nature",,0.000095,120,1,0,1,11281,0,11281,0,0,0,0,0,0
8595966,"Port, Schulweg",,0.000112,87,1,0,1,32489,0,32489,0,0,0,0,0,0
8595981,"Hérémence, Cerise",,0.000153,39,1,0,1,3297,0,3297,0,0,0,0,0,0
8595988,"Olten, Leberngasse",,0.000171,94,1,0,1,14677,0,14677,0,0,0,0,0,0
8596010,"Raron, Bodmereia",,0.000052,40,1,0,1,5376,0,5376,0,0,0,0,0,0
8596066,"Châbles FR, école",,0.000052,13,1,0,1,4911,0,4911,0,0,0,0,0,0
8596074,"Billens, La Bioleyre",,0.000109,13,2,0,2,833,0,833,0,0,0,0,0,0
8596120,"Le Châtelard FR, La Perreire",,0.000087,13,1,0,1,5896,0,5896,0,0,0,0,0,0
8596071,"Villariaz, Les Brêts",,0.000141,13,3,0,3,3913,0,3913,0,0,0,0,0,0
8596102,Case à Chocs,,0.000488,134,1,0,1,54,0,54,0,0,0,0,0,0
8596108,Eggeweg,,0.000067,66,1,0,1,1785,0,1785,0,0,0,0,0,0
